,code,name,age,value,value_m,value_f
0,1000,Praha,0,14566,7382,7184
1,1000,Praha,1,14655,7502,7153
2,1000,Praha,2,15013,7704,7309
3,1000,Praha,3,14922,7749,7173
4,1000,Praha,4,14650,7439,7211
5,1000,Praha,5,14652,7585,7067
6,1000,Praha,6,14517,7360,7157
7,1000,Praha,7,13824,7140,6684
8,1000,Praha,8,14161,7181,6980
9,1000,Praha,9,13686,6974,6712
10,1000,Praha,10,14464,7455,7009
11,1000,Praha,11,14297,7334,6963
12,1000,Praha,12,14034,7233,6801
13,1000,Praha,13,13220,6843,6377
14,1000,Praha,14,12163,6200,5963
15,1000,Praha,15,10980,5494,5486
16,1000,Praha,16,10328,5324,5004
17,1000,Praha,17,9716,5010,4706
18,1000,Praha,18,10090,5184,4906
19,1000,Praha,19,11114,5703,5411
20,1000,Praha,20,10958,5522,5436
21,1000,Praha,21,10530,5333,5197
22,1000,Praha,22,10649,5473,5176
23,1000,Praha,23,11301,5683,5618
24,1000,Praha,24,11714,5839,5875
25,1000,Praha,25,12987,6540,6447
26,1000,Praha,26,14294,7109,7185
27,1000,Praha,27,16281,8263,8018
28,1000,Praha,28,17253,8746,8507
29,1000,Praha,29,19329,9722,9607
30,1000,Praha,30,20642,10408,10234
31,1000,Praha,31,20974,10650,10324
32,1000,Praha,32,22202,11115,11087
33,1000,Praha,33,22239,11346,10893
34,1000,Praha,34,22823,11615,11208
35,1000,Praha,35,22921,11654,11267
36,1000,Praha,36,22982,11719,11263
37,1000,Praha,37,22604,11375,11229
38,1000,Praha,38,23014,11734,11280
39,1000,Praha,39,22782,11829,10953
40,1000,Praha,40,23542,12193,11349
41,1000,Praha,41,25641,13163,12478
42,1000,Praha,42,25816,13204,12612
43,1000,Praha,43,25257,13052,12205
44,1000,Praha,44,24959,12930,12029
45,1000,Praha,45,24593,12586,12007
46,1000,Praha,46,24225,12437,11788
47,1000,Praha,47,22019,11416,10603
48,1000,Praha,48,19630,10297,9333
49,1000,Praha,49,18674,9575,9099
50,1000,Praha,50,17659,9078,8581
51,1000,Praha,51,16370,8340,8030
52,1000,Praha,52,15718,7984,7734
53,1000,Praha,53,15823,8035,7788
54,1000,Praha,54,15389,7620,7769
55,1000,Praha,55,16213,8108,8105
56,1000,Praha,56,16888,8428,8460
57,1000,Praha,57,16182,7890,8292
58,1000,Praha,58,14229,7006,7223
59,1000,Praha,59,13335,6401,6934
60,1000,Praha,60,12934,6427,6507
61,1000,Praha,61,12216,5892,6324
62,1000,Praha,62,13091,6202,6889
63,1000,Praha,63,13821,6489,7332
64,1000,Praha,64,14218,6537,7681
65,1000,Praha,65,14582,6713,7869
66,1000,Praha,66,14926,6799,8127
67,1000,Praha,67,14873,6764,8109
68,1000,Praha,68,14953,6637,8316
69,1000,Praha,69,14748,6552,8196
70,1000,Praha,70,13937,6109,7828
71,1000,Praha,71,13550,5887,7663
72,1000,Praha,72,13914,6009,7905
73,1000,Praha,73,14632,6199,8433
74,1000,Praha,74,14893,6186,8707
75,1000,Praha,75,11989,4899,7090
76,1000,Praha,76,12403,5100,7303
77,1000,Praha,77,11362,4687,6675
78,1000,Praha,78,9179,3654,5525
79,1000,Praha,79,7984,3252,4732
80,1000,Praha,80,7076,2839,4237
81,1000,Praha,81,5820,2341,3479
82,1000,Praha,82,5539,2067,3472
83,1000,Praha,83,4913,1789,3124
84,1000,Praha,84,4508,1590,2918
85,1000,Praha,85,4108,1477,2631
86,1000,Praha,86,3756,1298,2458
87,1000,Praha,87,3534,1199,2335
88,1000,Praha,88,3331,1059,2272
89,1000,Praha,89,2832,920,1912
90,1000,Praha,90,2496,820,1676
91,1000,Praha,91,1898,580,1318
92,1000,Praha,92,1559,454,1105
93,1000,Praha,93,1162,348,814
94,1000,Praha,94,859,232,627
95,1000,Praha,95,569,145,424
96,1000,Praha,96,464,118,346
97,1000,Praha,97,338,67,271
98,1000,Praha,98,180,36,144
99,1000,Praha,99,116,25,91
100,1000,Praha,100,128,42,86
101,2001,Benešov,0,580,268,312
102,2001,Benešov,1,660,325,335
103,2001,Benešov,2,636,333,303
104,2001,Benešov,3,713,363,350
105,2001,Benešov,4,698,349,349
106,2001,Benešov,5,739,386,353
107,2001,Benešov,6,695,354,341
108,2001,Benešov,7,644,299,345
109,2001,Benešov,8,734,359,375
110,2001,Benešov,9,741,402,339
111,2001,Benešov,10,770,409,361
112,2001,Benešov,11,787,393,394
113,2001,Benešov,12,825,417,408
114,2001,Benešov,13,720,378,342
115,2001,Benešov,14,692,371,321
116,2001,Benešov,15,625,319,306
117,2001,Benešov,16,577,299,278
118,2001,Benešov,17,555,287,268
119,2001,Benešov,18,557,283,274
120,2001,Benešov,19,553,299,254
121,2001,Benešov,20,571,299,272
122,2001,Benešov,21,528,260,268
123,2001,Benešov,22,471,271,200
124,2001,Benešov,23,514,253,261
125,2001,Benešov,24,502,274,228
126,2001,Benešov,25,548,279,269
127,2001,Benešov,26,594,299,295
128,2001,Benešov,27,646,329,317
129,2001,Benešov,28,686,341,345
130,2001,Benešov,29,765,391,374
131,2001,Benešov,30,728,350,378
132,2001,Benešov,31,704,367,337
133,2001,Benešov,32,725,338,387
134,2001,Benešov,33,749,372,377
135,2001,Benešov,34,772,400,372
136,2001,Benešov,35,820,433,387
137,2001,Benešov,36,821,431,390
138,2001,Benešov,37,867,432,435
139,2001,Benešov,38,900,445,455
140,2001,Benešov,39,877,457,420
141,2001,Benešov,40,930,480,450
142,2001,Benešov,41,1074,527,547
143,2001,Benešov,42,1072,544,528
144,2001,Benešov,43,1111,547,564
145,2001,Benešov,44,1131,593,538
146,2001,Benešov,45,1191,629,562
147,2001,Benešov,46,1133,602,531
148,2001,Benešov,47,1026,553,473
149,2001,Benešov,48,914,467,447
150,2001,Benešov,49,844,437,407
151,2001,Benešov,50,857,449,408
152,2001,Benešov,51,781,397,384
153,2001,Benešov,52,791,410,381
154,2001,Benešov,53,740,369,371
155,2001,Benešov,54,709,362,347
156,2001,Benešov,55,771,380,391
157,2001,Benešov,56,781,393,388
158,2001,Benešov,57,765,385,380
159,2001,Benešov,58,706,355,351
160,2001,Benešov,59,647,324,323
161,2001,Benešov,60,675,319,356
162,2001,Benešov,61,693,344,349
163,2001,Benešov,62,747,367,380
164,2001,Benešov,63,795,381,414
165,2001,Benešov,64,782,377,405
166,2001,Benešov,65,824,398,426
167,2001,Benešov,66,828,388,440
168,2001,Benešov,67,828,399,429
169,2001,Benešov,68,829,388,441
170,2001,Benešov,69,780,379,401
171,2001,Benešov,70,788,352,436
172,2001,Benešov,71,792,351,441
173,2001,Benešov,72,747,354,393
174,2001,Benešov,73,718,323,395
175,2001,Benešov,74,710,324,386
176,2001,Benešov,75,517,229,288
177,2001,Benešov,76,508,231,277
178,2001,Benešov,77,421,178,243
179,2001,Benešov,78,411,168,243
180,2001,Benešov,79,333,145,188
181,2001,Benešov,80,325,127,198
182,2001,Benešov,81,256,85,171
183,2001,Benešov,82,232,90,142
184,2001,Benešov,83,230,69,161
185,2001,Benešov,84,187,61,126
186,2001,Benešov,85,193,70,123
187,2001,Benešov,86,169,46,123
188,2001,Benešov,87,154,51,103
189,2001,Benešov,88,153,37,116
190,2001,Benešov,89,101,31,70
191,2001,Benešov,90,78,24,54
192,2001,Benešov,91,75,24,51
193,2001,Benešov,92,57,15,42
194,2001,Benešov,93,48,11,37
195,2001,Benešov,94,42,10,32
196,2001,Benešov,95,16,5,11
197,2001,Benešov,96,10,2,8
198,2001,Benešov,97,10,2,8
199,2001,Benešov,98,6,2,4
200,2001,Benešov,99,1,0,1
201,2001,Benešov,100,3,1,2
202,2002,Beroun,0,755,373,382
203,2002,Beroun,1,767,394,373
204,2002,Beroun,2,843,462,381
205,2002,Beroun,3,893,451,442
206,2002,Beroun,4,858,424,434
207,2002,Beroun,5,900,443,457
208,2002,Beroun,6,828,415,413
209,2002,Beroun,7,773,413,360
210,2002,Beroun,8,836,425,411
211,2002,Beroun,9,803,401,402
212,2002,Beroun,10,880,436,444
213,2002,Beroun,11,837,440,397
214,2002,Beroun,12,875,434,441
215,2002,Beroun,13,840,444,396
216,2002,Beroun,14,752,382,370
217,2002,Beroun,15,710,366,344
218,2002,Beroun,16,653,341,312
219,2002,Beroun,17,563,303,260
220,2002,Beroun,18,588,306,282
221,2002,Beroun,19,544,301,243
222,2002,Beroun,20,579,293,286
223,2002,Beroun,21,534,263,271
224,2002,Beroun,22,523,272,251
225,2002,Beroun,23,546,281,265
226,2002,Beroun,24,546,302,244
227,2002,Beroun,25,559,285,274
228,2002,Beroun,26,622,324,298
229,2002,Beroun,27,694,363,331
230,2002,Beroun,28,686,352,334
231,2002,Beroun,29,790,392,398
232,2002,Beroun,30,809,418,391
233,2002,Beroun,31,851,421,430
234,2002,Beroun,32,923,477,446
235,2002,Beroun,33,927,430,497
236,2002,Beroun,34,923,468,455
237,2002,Beroun,35,991,468,523
238,2002,Beroun,36,964,475,489
239,2002,Beroun,37,974,471,503
240,2002,Beroun,38,1105,539,566
241,2002,Beroun,39,1050,509,541
242,2002,Beroun,40,1096,536,560
243,2002,Beroun,41,1220,581,639
244,2002,Beroun,42,1267,617,650
245,2002,Beroun,43,1304,641,663
246,2002,Beroun,44,1271,667,604
247,2002,Beroun,45,1318,653,665
248,2002,Beroun,46,1328,696,632
249,2002,Beroun,47,1182,636,546
250,2002,Beroun,48,1068,546,522
251,2002,Beroun,49,959,503,456
252,2002,Beroun,50,897,460,437
253,2002,Beroun,51,840,430,410
254,2002,Beroun,52,811,427,384
255,2002,Beroun,53,777,378,399
256,2002,Beroun,54,828,433,395
257,2002,Beroun,55,792,410,382
258,2002,Beroun,56,893,464,429
259,2002,Beroun,57,809,413,396
260,2002,Beroun,58,692,345,347
261,2002,Beroun,59,641,348,293
262,2002,Beroun,60,675,330,345
263,2002,Beroun,61,620,322,298
264,2002,Beroun,62,648,292,356
265,2002,Beroun,63,675,355,320
266,2002,Beroun,64,738,356,382
267,2002,Beroun,65,741,367,374
268,2002,Beroun,66,748,338,410
269,2002,Beroun,67,743,341,402
270,2002,Beroun,68,720,324,396
271,2002,Beroun,69,689,310,379
272,2002,Beroun,70,693,328,365
273,2002,Beroun,71,651,296,355
274,2002,Beroun,72,632,266,366
275,2002,Beroun,73,727,316,411
276,2002,Beroun,74,682,288,394
277,2002,Beroun,75,546,221,325
278,2002,Beroun,76,521,211,310
279,2002,Beroun,77,515,195,320
280,2002,Beroun,78,408,172,236
281,2002,Beroun,79,324,127,197
282,2002,Beroun,80,366,141,225
283,2002,Beroun,81,281,104,177
284,2002,Beroun,82,259,87,172
285,2002,Beroun,83,216,89,127
286,2002,Beroun,84,173,70,103
287,2002,Beroun,85,162,60,102
288,2002,Beroun,86,145,45,100
289,2002,Beroun,87,130,40,90
290,2002,Beroun,88,135,37,98
291,2002,Beroun,89,94,28,66
292,2002,Beroun,90,101,27,74
293,2002,Beroun,91,73,20,53
294,2002,Beroun,92,54,15,39
295,2002,Beroun,93,31,9,22
296,2002,Beroun,94,35,6,29
297,2002,Beroun,95,17,5,12
298,2002,Beroun,96,16,2,14
299,2002,Beroun,97,7,3,4
300,2002,Beroun,98,4,0,4
301,2002,Beroun,99,1,0,1
302,2002,Beroun,100,4,1,3
303,2003,Brandýs nad Labem-Stará Boleslav,0,1356,686,670
304,2003,Brandýs nad Labem-Stará Boleslav,1,1437,761,676
305,2003,Brandýs nad Labem-Stará Boleslav,2,1544,800,744
306,2003,Brandýs nad Labem-Stará Boleslav,3,1624,831,793
307,2003,Brandýs nad Labem-Stará Boleslav,4,1680,853,827
308,2003,Brandýs nad Labem-Stará Boleslav,5,1686,865,821
309,2003,Brandýs nad Labem-Stará Boleslav,6,1705,878,827
310,2003,Brandýs nad Labem-Stará Boleslav,7,1756,909,847
311,2003,Brandýs nad Labem-Stará Boleslav,8,1703,885,818
312,2003,Brandýs nad Labem-Stará Boleslav,9,1787,929,858
313,2003,Brandýs nad Labem-Stará Boleslav,10,1779,899,880
314,2003,Brandýs nad Labem-Stará Boleslav,11,1781,933,848
315,2003,Brandýs nad Labem-Stará Boleslav,12,1718,876,842
316,2003,Brandýs nad Labem-Stará Boleslav,13,1581,808,773
317,2003,Brandýs nad Labem-Stará Boleslav,14,1480,750,730
318,2003,Brandýs nad Labem-Stará Boleslav,15,1332,688,644
319,2003,Brandýs nad Labem-Stará Boleslav,16,1282,642,640
320,2003,Brandýs nad Labem-Stará Boleslav,17,1105,595,510
321,2003,Brandýs nad Labem-Stará Boleslav,18,1082,534,548
322,2003,Brandýs nad Labem-Stará Boleslav,19,1053,563,490
323,2003,Brandýs nad Labem-Stará Boleslav,20,947,512,435
324,2003,Brandýs nad Labem-Stará Boleslav,21,929,490,439
325,2003,Brandýs nad Labem-Stará Boleslav,22,891,465,426
326,2003,Brandýs nad Labem-Stará Boleslav,23,913,469,444
327,2003,Brandýs nad Labem-Stará Boleslav,24,929,489,440
328,2003,Brandýs nad Labem-Stará Boleslav,25,914,434,480
329,2003,Brandýs nad Labem-Stará Boleslav,26,989,519,470
330,2003,Brandýs nad Labem-Stará Boleslav,27,1111,559,552
331,2003,Brandýs nad Labem-Stará Boleslav,28,1236,613,623
332,2003,Brandýs nad Labem-Stará Boleslav,29,1272,639,633
333,2003,Brandýs nad Labem-Stará Boleslav,30,1416,685,731
334,2003,Brandýs nad Labem-Stará Boleslav,31,1400,683,717
335,2003,Brandýs nad Labem-Stará Boleslav,32,1559,773,786
336,2003,Brandýs nad Labem-Stará Boleslav,33,1608,786,822
337,2003,Brandýs nad Labem-Stará Boleslav,34,1604,775,829
338,2003,Brandýs nad Labem-Stará Boleslav,35,1751,850,901
339,2003,Brandýs nad Labem-Stará Boleslav,36,1806,828,978
340,2003,Brandýs nad Labem-Stará Boleslav,37,1882,908,974
341,2003,Brandýs nad Labem-Stará Boleslav,38,1981,973,1008
342,2003,Brandýs nad Labem-Stará Boleslav,39,2004,963,1041
343,2003,Brandýs nad Labem-Stará Boleslav,40,2173,1079,1094
344,2003,Brandýs nad Labem-Stará Boleslav,41,2426,1188,1238
345,2003,Brandýs nad Labem-Stará Boleslav,42,2526,1237,1289
346,2003,Brandýs nad Labem-Stará Boleslav,43,2496,1238,1258
347,2003,Brandýs nad Labem-Stará Boleslav,44,2496,1240,1256
348,2003,Brandýs nad Labem-Stará Boleslav,45,2477,1236,1241
349,2003,Brandýs nad Labem-Stará Boleslav,46,2397,1258,1139
350,2003,Brandýs nad Labem-Stará Boleslav,47,2167,1129,1038
351,2003,Brandýs nad Labem-Stará Boleslav,48,1922,965,957
352,2003,Brandýs nad Labem-Stará Boleslav,49,1759,931,828
353,2003,Brandýs nad Labem-Stará Boleslav,50,1628,856,772
354,2003,Brandýs nad Labem-Stará Boleslav,51,1476,769,707
355,2003,Brandýs nad Labem-Stará Boleslav,52,1399,717,682
356,2003,Brandýs nad Labem-Stará Boleslav,53,1345,689,656
357,2003,Brandýs nad Labem-Stará Boleslav,54,1291,716,575
358,2003,Brandýs nad Labem-Stará Boleslav,55,1360,732,628
359,2003,Brandýs nad Labem-Stará Boleslav,56,1369,688,681
360,2003,Brandýs nad Labem-Stará Boleslav,57,1210,629,581
361,2003,Brandýs nad Labem-Stará Boleslav,58,1095,559,536
362,2003,Brandýs nad Labem-Stará Boleslav,59,1022,516,506
363,2003,Brandýs nad Labem-Stará Boleslav,60,990,492,498
364,2003,Brandýs nad Labem-Stará Boleslav,61,933,465,468
365,2003,Brandýs nad Labem-Stará Boleslav,62,970,471,499
366,2003,Brandýs nad Labem-Stará Boleslav,63,1056,492,564
367,2003,Brandýs nad Labem-Stará Boleslav,64,1077,517,560
368,2003,Brandýs nad Labem-Stará Boleslav,65,1130,559,571
369,2003,Brandýs nad Labem-Stará Boleslav,66,1105,545,560
370,2003,Brandýs nad Labem-Stará Boleslav,67,1070,510,560
371,2003,Brandýs nad Labem-Stará Boleslav,68,1054,491,563
372,2003,Brandýs nad Labem-Stará Boleslav,69,1063,495,568
373,2003,Brandýs nad Labem-Stará Boleslav,70,1014,465,549
374,2003,Brandýs nad Labem-Stará Boleslav,71,976,435,541
375,2003,Brandýs nad Labem-Stará Boleslav,72,986,436,550
376,2003,Brandýs nad Labem-Stará Boleslav,73,1007,461,546
377,2003,Brandýs nad Labem-Stará Boleslav,74,951,406,545
378,2003,Brandýs nad Labem-Stará Boleslav,75,747,341,406
379,2003,Brandýs nad Labem-Stará Boleslav,76,739,322,417
380,2003,Brandýs nad Labem-Stará Boleslav,77,690,310,380
381,2003,Brandýs nad Labem-Stará Boleslav,78,575,225,350
382,2003,Brandýs nad Labem-Stará Boleslav,79,509,217,292
383,2003,Brandýs nad Labem-Stará Boleslav,80,442,176,266
384,2003,Brandýs nad Labem-Stará Boleslav,81,375,143,232
385,2003,Brandýs nad Labem-Stará Boleslav,82,332,135,197
386,2003,Brandýs nad Labem-Stará Boleslav,83,287,110,177
387,2003,Brandýs nad Labem-Stará Boleslav,84,277,103,174
388,2003,Brandýs nad Labem-Stará Boleslav,85,249,93,156
389,2003,Brandýs nad Labem-Stará Boleslav,86,226,73,153
390,2003,Brandýs nad Labem-Stará Boleslav,87,187,55,132
391,2003,Brandýs nad Labem-Stará Boleslav,88,178,54,124
392,2003,Brandýs nad Labem-Stará Boleslav,89,160,55,105
393,2003,Brandýs nad Labem-Stará Boleslav,90,123,40,83
394,2003,Brandýs nad Labem-Stará Boleslav,91,90,22,68
395,2003,Brandýs nad Labem-Stará Boleslav,92,76,25,51
396,2003,Brandýs nad Labem-Stará Boleslav,93,50,12,38
397,2003,Brandýs nad Labem-Stará Boleslav,94,27,9,18
398,2003,Brandýs nad Labem-Stará Boleslav,95,29,6,23
399,2003,Brandýs nad Labem-Stará Boleslav,96,18,4,14
400,2003,Brandýs nad Labem-Stará Boleslav,97,12,3,9
401,2003,Brandýs nad Labem-Stará Boleslav,98,10,3,7
402,2003,Brandýs nad Labem-Stará Boleslav,99,5,2,3
403,2003,Brandýs nad Labem-Stará Boleslav,100,12,4,8
404,2004,Čáslav,0,275,132,143
405,2004,Čáslav,1,266,114,152
406,2004,Čáslav,2,302,152,150
407,2004,Čáslav,3,293,145,148
408,2004,Čáslav,4,282,138,144
409,2004,Čáslav,5,306,146,160
410,2004,Čáslav,6,282,146,136
411,2004,Čáslav,7,242,130,112
412,2004,Čáslav,8,287,155,132
413,2004,Čáslav,9,275,144,131
414,2004,Čáslav,10,281,165,116
415,2004,Čáslav,11,299,143,156
416,2004,Čáslav,12,279,139,140
417,2004,Čáslav,13,295,129,166
418,2004,Čáslav,14,244,129,115
419,2004,Čáslav,15,248,128,120
420,2004,Čáslav,16,225,131,94
421,2004,Čáslav,17,229,117,112
422,2004,Čáslav,18,235,124,111
423,2004,Čáslav,19,212,108,104
424,2004,Čáslav,20,217,109,108
425,2004,Čáslav,21,212,108,104
426,2004,Čáslav,22,246,134,112
427,2004,Čáslav,23,238,126,112
428,2004,Čáslav,24,219,113,106
429,2004,Čáslav,25,215,99,116
430,2004,Čáslav,26,276,139,137
431,2004,Čáslav,27,317,157,160
432,2004,Čáslav,28,318,174,144
433,2004,Čáslav,29,358,190,168
434,2004,Čáslav,30,346,180,166
435,2004,Čáslav,31,295,139,156
436,2004,Čáslav,32,348,180,168
437,2004,Čáslav,33,346,174,172
438,2004,Čáslav,34,349,173,176
439,2004,Čáslav,35,356,178,178
440,2004,Čáslav,36,320,168,152
441,2004,Čáslav,37,414,212,202
442,2004,Čáslav,38,366,193,173
443,2004,Čáslav,39,378,197,181
444,2004,Čáslav,40,398,222,176
445,2004,Čáslav,41,421,211,210
446,2004,Čáslav,42,400,210,190
447,2004,Čáslav,43,395,213,182
448,2004,Čáslav,44,419,216,203
449,2004,Čáslav,45,476,249,227
450,2004,Čáslav,46,471,269,202
451,2004,Čáslav,47,406,210,196
452,2004,Čáslav,48,334,174,160
453,2004,Čáslav,49,377,200,177
454,2004,Čáslav,50,329,166,163
455,2004,Čáslav,51,343,168,175
456,2004,Čáslav,52,303,145,158
457,2004,Čáslav,53,307,163,144
458,2004,Čáslav,54,330,176,154
459,2004,Čáslav,55,320,172,148
460,2004,Čáslav,56,368,187,181
461,2004,Čáslav,57,331,156,175
462,2004,Čáslav,58,292,138,154
463,2004,Čáslav,59,313,149,164
464,2004,Čáslav,60,320,165,155
465,2004,Čáslav,61,324,165,159
466,2004,Čáslav,62,326,147,179
467,2004,Čáslav,63,343,199,144
468,2004,Čáslav,64,394,198,196
469,2004,Čáslav,65,353,175,178
470,2004,Čáslav,66,326,155,171
471,2004,Čáslav,67,355,169,186
472,2004,Čáslav,68,330,154,176
473,2004,Čáslav,69,338,166,172
474,2004,Čáslav,70,312,150,162
475,2004,Čáslav,71,289,122,167
476,2004,Čáslav,72,317,153,164
477,2004,Čáslav,73,273,133,140
478,2004,Čáslav,74,281,130,151
479,2004,Čáslav,75,190,83,107
480,2004,Čáslav,76,221,90,131
481,2004,Čáslav,77,201,79,122
482,2004,Čáslav,78,183,73,110
483,2004,Čáslav,79,165,58,107
484,2004,Čáslav,80,146,52,94
485,2004,Čáslav,81,136,51,85
486,2004,Čáslav,82,129,41,88
487,2004,Čáslav,83,108,31,77
488,2004,Čáslav,84,95,24,71
489,2004,Čáslav,85,98,30,68
490,2004,Čáslav,86,95,24,71
491,2004,Čáslav,87,84,24,60
492,2004,Čáslav,88,62,17,45
493,2004,Čáslav,89,61,15,46
494,2004,Čáslav,90,56,17,39
495,2004,Čáslav,91,35,12,23
496,2004,Čáslav,92,21,7,14
497,2004,Čáslav,93,27,4,23
498,2004,Čáslav,94,12,5,7
499,2004,Čáslav,95,7,4,3
500,2004,Čáslav,96,9,3,6
501,2004,Čáslav,97,7,4,3
502,2004,Čáslav,98,5,1,4
503,2004,Čáslav,99,3,0,3
504,2004,Čáslav,100,1,0,1
505,2005,Černošice,0,1741,870,871
506,2005,Černošice,1,1870,942,928
507,2005,Černošice,2,2000,1002,998
508,2005,Černošice,3,2067,1065,1002
509,2005,Černošice,4,2146,1095,1051
510,2005,Černošice,5,2188,1162,1026
511,2005,Černošice,6,2174,1096,1078
512,2005,Černošice,7,2215,1163,1052
513,2005,Černošice,8,2191,1112,1079
514,2005,Černošice,9,2350,1200,1150
515,2005,Černošice,10,2269,1143,1126
516,2005,Černošice,11,2351,1225,1126
517,2005,Černošice,12,2296,1161,1135
518,2005,Černošice,13,2094,1111,983
519,2005,Černošice,14,1935,952,983
520,2005,Černošice,15,1875,995,880
521,2005,Černošice,16,1708,898,810
522,2005,Černošice,17,1594,840,754
523,2005,Černošice,18,1550,838,712
524,2005,Černošice,19,1413,725,688
525,2005,Černošice,20,1403,698,705
526,2005,Černošice,21,1228,613,615
527,2005,Černošice,22,1207,632,575
528,2005,Černošice,23,1204,604,600
529,2005,Černošice,24,1246,649,597
530,2005,Černošice,25,1236,613,623
531,2005,Černošice,26,1356,652,704
532,2005,Černošice,27,1539,746,793
533,2005,Černošice,28,1517,764,753
534,2005,Černošice,29,1660,807,853
535,2005,Černošice,30,1634,794,840
536,2005,Černošice,31,1730,834,896
537,2005,Černošice,32,1778,790,988
538,2005,Černošice,33,1897,888,1009
539,2005,Černošice,34,1993,913,1080
540,2005,Černošice,35,2147,987,1160
541,2005,Černošice,36,2161,1002,1159
542,2005,Černošice,37,2215,1004,1211
543,2005,Černošice,38,2300,1078,1222
544,2005,Černošice,39,2422,1101,1321
545,2005,Černošice,40,2601,1235,1366
546,2005,Černošice,41,2860,1380,1480
547,2005,Černošice,42,3122,1454,1668
548,2005,Černošice,43,3143,1488,1655
549,2005,Černošice,44,3186,1571,1615
550,2005,Černošice,45,3240,1575,1665
551,2005,Černošice,46,3096,1579,1517
552,2005,Černošice,47,2859,1460,1399
553,2005,Černošice,48,2488,1282,1206
554,2005,Černošice,49,2391,1213,1178
555,2005,Černošice,50,2309,1198,1111
556,2005,Černošice,51,2065,1059,1006
557,2005,Černošice,52,1873,957,916
558,2005,Černošice,53,1869,1007,862
559,2005,Černošice,54,1735,908,827
560,2005,Černošice,55,1825,945,880
561,2005,Černošice,56,1922,1009,913
562,2005,Černošice,57,1805,899,906
563,2005,Černošice,58,1535,797,738
564,2005,Černošice,59,1443,725,718
565,2005,Černošice,60,1278,614,664
566,2005,Černošice,61,1278,621,657
567,2005,Černošice,62,1405,713,692
568,2005,Černošice,63,1456,736,720
569,2005,Černošice,64,1571,772,799
570,2005,Černošice,65,1543,740,803
571,2005,Černošice,66,1524,701,823
572,2005,Černošice,67,1547,748,799
573,2005,Černošice,68,1626,790,836
574,2005,Černošice,69,1492,691,801
575,2005,Černošice,70,1485,714,771
576,2005,Černošice,71,1418,674,744
577,2005,Černošice,72,1431,632,799
578,2005,Černošice,73,1473,703,770
579,2005,Černošice,74,1509,703,806
580,2005,Černošice,75,1076,456,620
581,2005,Černošice,76,1098,468,630
582,2005,Černošice,77,1055,451,604
583,2005,Černošice,78,766,325,441
584,2005,Černošice,79,683,287,396
585,2005,Černošice,80,567,244,323
586,2005,Černošice,81,496,201,295
587,2005,Černošice,82,437,172,265
588,2005,Černošice,83,393,165,228
589,2005,Černošice,84,363,139,224
590,2005,Černošice,85,314,104,210
591,2005,Černošice,86,289,87,202
592,2005,Černošice,87,270,92,178
593,2005,Černošice,88,254,75,179
594,2005,Černošice,89,206,80,126
595,2005,Černošice,90,197,68,129
596,2005,Černošice,91,136,43,93
597,2005,Černošice,92,107,34,73
598,2005,Černošice,93,88,24,64
599,2005,Černošice,94,56,15,41
600,2005,Černošice,95,43,9,34
601,2005,Černošice,96,28,7,21
602,2005,Černošice,97,30,8,22
603,2005,Černošice,98,10,2,8
604,2005,Černošice,99,9,2,7
605,2005,Černošice,100,11,1,10
606,2006,Český Brod,0,246,116,130
607,2006,Český Brod,1,280,145,135
608,2006,Český Brod,2,280,148,132
609,2006,Český Brod,3,287,158,129
610,2006,Český Brod,4,279,141,138
611,2006,Český Brod,5,280,142,138
612,2006,Český Brod,6,282,139,143
613,2006,Český Brod,7,311,163,148
614,2006,Český Brod,8,254,133,121
615,2006,Český Brod,9,293,155,138
616,2006,Český Brod,10,330,172,158
617,2006,Český Brod,11,286,144,142
618,2006,Český Brod,12,286,140,146
619,2006,Český Brod,13,293,126,167
620,2006,Český Brod,14,254,128,126
621,2006,Český Brod,15,262,136,126
622,2006,Český Brod,16,225,114,111
623,2006,Český Brod,17,211,113,98
624,2006,Český Brod,18,184,93,91
625,2006,Český Brod,19,219,110,109
626,2006,Český Brod,20,158,70,88
627,2006,Český Brod,21,168,90,78
628,2006,Český Brod,22,172,85,87
629,2006,Český Brod,23,203,110,93
630,2006,Český Brod,24,161,81,80
631,2006,Český Brod,25,203,104,99
632,2006,Český Brod,26,210,110,100
633,2006,Český Brod,27,237,117,120
634,2006,Český Brod,28,212,92,120
635,2006,Český Brod,29,244,127,117
636,2006,Český Brod,30,285,142,143
637,2006,Český Brod,31,264,135,129
638,2006,Český Brod,32,303,155,148
639,2006,Český Brod,33,330,149,181
640,2006,Český Brod,34,302,142,160
641,2006,Český Brod,35,325,152,173
642,2006,Český Brod,36,313,177,136
643,2006,Český Brod,37,329,154,175
644,2006,Český Brod,38,346,180,166
645,2006,Český Brod,39,343,169,174
646,2006,Český Brod,40,396,199,197
647,2006,Český Brod,41,409,216,193
648,2006,Český Brod,42,470,245,225
649,2006,Český Brod,43,412,202,210
650,2006,Český Brod,44,446,235,211
651,2006,Český Brod,45,405,210,195
652,2006,Český Brod,46,455,231,224
653,2006,Český Brod,47,364,173,191
654,2006,Český Brod,48,351,190,161
655,2006,Český Brod,49,341,169,172
656,2006,Český Brod,50,284,159,125
657,2006,Český Brod,51,269,141,128
658,2006,Český Brod,52,287,162,125
659,2006,Český Brod,53,244,122,122
660,2006,Český Brod,54,238,128,110
661,2006,Český Brod,55,242,121,121
662,2006,Český Brod,56,251,123,128
663,2006,Český Brod,57,230,116,114
664,2006,Český Brod,58,211,112,99
665,2006,Český Brod,59,200,94,106
666,2006,Český Brod,60,212,116,96
667,2006,Český Brod,61,204,106,98
668,2006,Český Brod,62,207,113,94
669,2006,Český Brod,63,241,106,135
670,2006,Český Brod,64,264,104,160
671,2006,Český Brod,65,251,126,125
672,2006,Český Brod,66,246,123,123
673,2006,Český Brod,67,235,103,132
674,2006,Český Brod,68,249,128,121
675,2006,Český Brod,69,251,125,126
676,2006,Český Brod,70,236,113,123
677,2006,Český Brod,71,224,111,113
678,2006,Český Brod,72,233,96,137
679,2006,Český Brod,73,205,85,120
680,2006,Český Brod,74,206,90,116
681,2006,Český Brod,75,178,72,106
682,2006,Český Brod,76,159,69,90
683,2006,Český Brod,77,154,76,78
684,2006,Český Brod,78,119,53,66
685,2006,Český Brod,79,103,43,60
686,2006,Český Brod,80,98,36,62
687,2006,Český Brod,81,100,36,64
688,2006,Český Brod,82,87,36,51
689,2006,Český Brod,83,56,18,38
690,2006,Český Brod,84,65,22,43
691,2006,Český Brod,85,52,17,35
692,2006,Český Brod,86,46,20,26
693,2006,Český Brod,87,40,12,28
694,2006,Český Brod,88,37,12,25
695,2006,Český Brod,89,35,11,24
696,2006,Český Brod,90,24,9,15
697,2006,Český Brod,91,18,6,12
698,2006,Český Brod,92,15,5,10
699,2006,Český Brod,93,16,6,10
700,2006,Český Brod,94,10,3,7
701,2006,Český Brod,95,4,1,3
702,2006,Český Brod,96,5,1,4
703,2006,Český Brod,97,3,0,3
704,2006,Český Brod,98,3,2,1
705,2006,Český Brod,99,2,0,2
706,2006,Český Brod,100,4,3,1
707,2007,Dobříš,0,247,129,118
708,2007,Dobříš,1,277,139,138
709,2007,Dobříš,2,274,121,153
710,2007,Dobříš,3,272,139,133
711,2007,Dobříš,4,303,163,140
712,2007,Dobříš,5,282,149,133
713,2007,Dobříš,6,267,145,122
714,2007,Dobříš,7,325,162,163
715,2007,Dobříš,8,285,145,140
716,2007,Dobříš,9,278,145,133
717,2007,Dobříš,10,267,143,124
718,2007,Dobříš,11,295,136,159
719,2007,Dobříš,12,288,162,126
720,2007,Dobříš,13,278,148,130
721,2007,Dobříš,14,226,121,105
722,2007,Dobříš,15,227,120,107
723,2007,Dobříš,16,233,113,120
724,2007,Dobříš,17,208,109,99
725,2007,Dobříš,18,196,105,91
726,2007,Dobříš,19,219,110,109
727,2007,Dobříš,20,188,92,96
728,2007,Dobříš,21,207,107,100
729,2007,Dobříš,22,192,95,97
730,2007,Dobříš,23,205,96,109
731,2007,Dobříš,24,189,101,88
732,2007,Dobříš,25,199,89,110
733,2007,Dobříš,26,212,103,109
734,2007,Dobříš,27,279,147,132
735,2007,Dobříš,28,275,157,118
736,2007,Dobříš,29,294,153,141
737,2007,Dobříš,30,291,141,150
738,2007,Dobříš,31,305,163,142
739,2007,Dobříš,32,309,160,149
740,2007,Dobříš,33,308,144,164
741,2007,Dobříš,34,309,157,152
742,2007,Dobříš,35,321,165,156
743,2007,Dobříš,36,325,159,166
744,2007,Dobříš,37,317,162,155
745,2007,Dobříš,38,323,152,171
746,2007,Dobříš,39,336,169,167
747,2007,Dobříš,40,381,199,182
748,2007,Dobříš,41,393,200,193
749,2007,Dobříš,42,414,204,210
750,2007,Dobříš,43,432,226,206
751,2007,Dobříš,44,399,210,189
752,2007,Dobříš,45,427,230,197
753,2007,Dobříš,46,462,236,226
754,2007,Dobříš,47,383,195,188
755,2007,Dobříš,48,395,197,198
756,2007,Dobříš,49,324,167,157
757,2007,Dobříš,50,312,159,153
758,2007,Dobříš,51,300,161,139
759,2007,Dobříš,52,298,153,145
760,2007,Dobříš,53,304,149,155
761,2007,Dobříš,54,318,156,162
762,2007,Dobříš,55,272,138,134
763,2007,Dobříš,56,311,159,152
764,2007,Dobříš,57,278,151,127
765,2007,Dobříš,58,267,133,134
766,2007,Dobříš,59,252,134,118
767,2007,Dobříš,60,239,119,120
768,2007,Dobříš,61,250,144,106
769,2007,Dobříš,62,251,123,128
770,2007,Dobříš,63,281,143,138
771,2007,Dobříš,64,260,134,126
772,2007,Dobříš,65,276,127,149
773,2007,Dobříš,66,265,125,140
774,2007,Dobříš,67,252,119,133
775,2007,Dobříš,68,271,124,147
776,2007,Dobříš,69,255,121,134
777,2007,Dobříš,70,261,122,139
778,2007,Dobříš,71,276,120,156
779,2007,Dobříš,72,261,110,151
780,2007,Dobříš,73,268,128,140
781,2007,Dobříš,74,263,112,151
782,2007,Dobříš,75,203,92,111
783,2007,Dobříš,76,207,92,115
784,2007,Dobříš,77,198,86,112
785,2007,Dobříš,78,147,58,89
786,2007,Dobříš,79,104,39,65
787,2007,Dobříš,80,142,66,76
788,2007,Dobříš,81,107,35,72
789,2007,Dobříš,82,95,36,59
790,2007,Dobříš,83,74,26,48
791,2007,Dobříš,84,92,30,62
792,2007,Dobříš,85,75,20,55
793,2007,Dobříš,86,68,23,45
794,2007,Dobříš,87,61,12,49
795,2007,Dobříš,88,46,16,30
796,2007,Dobříš,89,41,11,30
797,2007,Dobříš,90,44,13,31
798,2007,Dobříš,91,19,4,15
799,2007,Dobříš,92,20,4,16
800,2007,Dobříš,93,11,6,5
801,2007,Dobříš,94,6,4,2
802,2007,Dobříš,95,4,3,1
803,2007,Dobříš,96,5,1,4
804,2007,Dobříš,97,5,3,2
805,2007,Dobříš,98,3,2,1
806,2007,Dobříš,99,1,0,1
807,2007,Dobříš,100,3,3,0
808,2008,Hořovice,0,299,148,151
809,2008,Hořovice,1,329,175,154
810,2008,Hořovice,2,292,156,136
811,2008,Hořovice,3,327,178,149
812,2008,Hořovice,4,304,145,159
813,2008,Hořovice,5,312,172,140
814,2008,Hořovice,6,353,185,168
815,2008,Hořovice,7,294,155,139
816,2008,Hořovice,8,303,152,151
817,2008,Hořovice,9,333,177,156
818,2008,Hořovice,10,322,159,163
819,2008,Hořovice,11,363,184,179
820,2008,Hořovice,12,337,170,167
821,2008,Hořovice,13,330,175,155
822,2008,Hořovice,14,329,173,156
823,2008,Hořovice,15,309,158,151
824,2008,Hořovice,16,278,130,148
825,2008,Hořovice,17,248,136,112
826,2008,Hořovice,18,263,128,135
827,2008,Hořovice,19,277,149,128
828,2008,Hořovice,20,285,126,159
829,2008,Hořovice,21,258,139,119
830,2008,Hořovice,22,264,139,125
831,2008,Hořovice,23,254,140,114
832,2008,Hořovice,24,274,148,126
833,2008,Hořovice,25,303,160,143
834,2008,Hořovice,26,308,161,147
835,2008,Hořovice,27,357,193,164
836,2008,Hořovice,28,355,189,166
837,2008,Hořovice,29,383,197,186
838,2008,Hořovice,30,349,178,171
839,2008,Hořovice,31,366,189,177
840,2008,Hořovice,32,373,214,159
841,2008,Hořovice,33,375,203,172
842,2008,Hořovice,34,400,210,190
843,2008,Hořovice,35,414,218,196
844,2008,Hořovice,36,438,226,212
845,2008,Hořovice,37,468,209,259
846,2008,Hořovice,38,430,205,225
847,2008,Hořovice,39,454,223,231
848,2008,Hořovice,40,483,267,216
849,2008,Hořovice,41,480,257,223
850,2008,Hořovice,42,520,280,240
851,2008,Hořovice,43,599,309,290
852,2008,Hořovice,44,576,282,294
853,2008,Hořovice,45,527,291,236
854,2008,Hořovice,46,619,334,285
855,2008,Hořovice,47,498,258,240
856,2008,Hořovice,48,478,264,214
857,2008,Hořovice,49,439,232,207
858,2008,Hořovice,50,464,235,229
859,2008,Hořovice,51,386,185,201
860,2008,Hořovice,52,387,198,189
861,2008,Hořovice,53,389,204,185
862,2008,Hořovice,54,387,200,187
863,2008,Hořovice,55,361,183,178
864,2008,Hořovice,56,407,227,180
865,2008,Hořovice,57,372,180,192
866,2008,Hořovice,58,363,189,174
867,2008,Hořovice,59,324,171,153
868,2008,Hořovice,60,318,162,156
869,2008,Hořovice,61,314,161,153
870,2008,Hořovice,62,326,163,163
871,2008,Hořovice,63,384,200,184
872,2008,Hořovice,64,403,214,189
873,2008,Hořovice,65,355,155,200
874,2008,Hořovice,66,405,190,215
875,2008,Hořovice,67,404,188,216
876,2008,Hořovice,68,385,195,190
877,2008,Hořovice,69,379,175,204
878,2008,Hořovice,70,365,170,195
879,2008,Hořovice,71,350,153,197
880,2008,Hořovice,72,355,168,187
881,2008,Hořovice,73,396,177,219
882,2008,Hořovice,74,346,137,209
883,2008,Hořovice,75,283,138,145
884,2008,Hořovice,76,317,125,192
885,2008,Hořovice,77,279,126,153
886,2008,Hořovice,78,183,88,95
887,2008,Hořovice,79,191,87,104
888,2008,Hořovice,80,155,58,97
889,2008,Hořovice,81,148,53,95
890,2008,Hořovice,82,118,49,69
891,2008,Hořovice,83,125,41,84
892,2008,Hořovice,84,109,37,72
893,2008,Hořovice,85,95,30,65
894,2008,Hořovice,86,107,37,70
895,2008,Hořovice,87,77,23,54
896,2008,Hořovice,88,59,15,44
897,2008,Hořovice,89,48,18,30
898,2008,Hořovice,90,39,12,27
899,2008,Hořovice,91,37,15,22
900,2008,Hořovice,92,28,4,24
901,2008,Hořovice,93,22,6,16
902,2008,Hořovice,94,13,2,11
903,2008,Hořovice,95,10,2,8
904,2008,Hořovice,96,2,1,1
905,2008,Hořovice,97,9,1,8
906,2008,Hořovice,98,2,0,2
907,2008,Hořovice,99,1,0,1
908,2008,Hořovice,100,5,3,2
909,2009,Kladno,0,1234,613,621
910,2009,Kladno,1,1346,688,658
911,2009,Kladno,2,1361,715,646
912,2009,Kladno,3,1396,723,673
913,2009,Kladno,4,1458,755,703
914,2009,Kladno,5,1334,706,628
915,2009,Kladno,6,1439,743,696
916,2009,Kladno,7,1431,737,694
917,2009,Kladno,8,1440,712,728
918,2009,Kladno,9,1403,702,701
919,2009,Kladno,10,1566,801,765
920,2009,Kladno,11,1494,718,776
921,2009,Kladno,12,1533,792,741
922,2009,Kladno,13,1529,791,738
923,2009,Kladno,14,1310,682,628
924,2009,Kladno,15,1307,658,649
925,2009,Kladno,16,1192,628,564
926,2009,Kladno,17,1137,578,559
927,2009,Kladno,18,1151,579,572
928,2009,Kladno,19,1125,592,533
929,2009,Kladno,20,1081,567,514
930,2009,Kladno,21,969,477,492
931,2009,Kladno,22,1064,522,542
932,2009,Kladno,23,1104,566,538
933,2009,Kladno,24,1121,588,533
934,2009,Kladno,25,1153,612,541
935,2009,Kladno,26,1268,632,636
936,2009,Kladno,27,1440,726,714
937,2009,Kladno,28,1472,740,732
938,2009,Kladno,29,1567,806,761
939,2009,Kladno,30,1575,782,793
940,2009,Kladno,31,1607,815,792
941,2009,Kladno,32,1702,873,829
942,2009,Kladno,33,1600,823,777
943,2009,Kladno,34,1725,880,845
944,2009,Kladno,35,1738,848,890
945,2009,Kladno,36,1815,947,868
946,2009,Kladno,37,1728,895,833
947,2009,Kladno,38,1790,878,912
948,2009,Kladno,39,1898,961,937
949,2009,Kladno,40,1986,992,994
950,2009,Kladno,41,2111,1011,1100
951,2009,Kladno,42,2144,1065,1079
952,2009,Kladno,43,2249,1098,1151
953,2009,Kladno,44,2360,1173,1187
954,2009,Kladno,45,2338,1185,1153
955,2009,Kladno,46,2371,1224,1147
956,2009,Kladno,47,2211,1134,1077
957,2009,Kladno,48,2072,1047,1025
958,2009,Kladno,49,1896,967,929
959,2009,Kladno,50,1827,930,897
960,2009,Kladno,51,1783,915,868
961,2009,Kladno,52,1664,840,824
962,2009,Kladno,53,1660,878,782
963,2009,Kladno,54,1597,827,770
964,2009,Kladno,55,1740,852,888
965,2009,Kladno,56,1754,880,874
966,2009,Kladno,57,1672,822,850
967,2009,Kladno,58,1455,726,729
968,2009,Kladno,59,1373,659,714
969,2009,Kladno,60,1279,667,612
970,2009,Kladno,61,1287,660,627
971,2009,Kladno,62,1279,605,674
972,2009,Kladno,63,1442,669,773
973,2009,Kladno,64,1474,692,782
974,2009,Kladno,65,1432,679,753
975,2009,Kladno,66,1582,735,847
976,2009,Kladno,67,1517,700,817
977,2009,Kladno,68,1586,758,828
978,2009,Kladno,69,1465,623,842
979,2009,Kladno,70,1474,652,822
980,2009,Kladno,71,1469,647,822
981,2009,Kladno,72,1410,612,798
982,2009,Kladno,73,1466,623,843
983,2009,Kladno,74,1325,556,769
984,2009,Kladno,75,1152,486,666
985,2009,Kladno,76,1121,442,679
986,2009,Kladno,77,1005,388,617
987,2009,Kladno,78,885,359,526
988,2009,Kladno,79,725,276,449
989,2009,Kladno,80,722,280,442
990,2009,Kladno,81,565,213,352
991,2009,Kladno,82,529,197,332
992,2009,Kladno,83,479,207,272
993,2009,Kladno,84,387,146,241
994,2009,Kladno,85,392,128,264
995,2009,Kladno,86,318,97,221
996,2009,Kladno,87,295,79,216
997,2009,Kladno,88,274,90,184
998,2009,Kladno,89,242,68,174
999,2009,Kladno,90,193,59,134
1000,2009,Kladno,91,133,34,99
1001,2009,Kladno,92,90,22,68
1002,2009,Kladno,93,57,13,44
1003,2009,Kladno,94,55,16,39
1004,2009,Kladno,95,33,5,28
1005,2009,Kladno,96,27,7,20
1006,2009,Kladno,97,14,3,11
1007,2009,Kladno,98,11,1,10
1008,2009,Kladno,99,1,0,1
1009,2009,Kladno,100,7,1,6
1010,2010,Kolín,0,887,456,431
1011,2010,Kolín,1,962,497,465
1012,2010,Kolín,2,951,461,490
1013,2010,Kolín,3,1045,589,456
1014,2010,Kolín,4,938,480,458
1015,2010,Kolín,5,925,454,471
1016,2010,Kolín,6,884,456,428
1017,2010,Kolín,7,916,460,456
1018,2010,Kolín,8,957,476,481
1019,2010,Kolín,9,925,483,442
1020,2010,Kolín,10,948,501,447
1021,2010,Kolín,11,985,522,463
1022,2010,Kolín,12,942,470,472
1023,2010,Kolín,13,920,495,425
1024,2010,Kolín,14,885,461,424
1025,2010,Kolín,15,801,422,379
1026,2010,Kolín,16,786,425,361
1027,2010,Kolín,17,807,407,400
1028,2010,Kolín,18,782,422,360
1029,2010,Kolín,19,686,364,322
1030,2010,Kolín,20,665,353,312
1031,2010,Kolín,21,715,370,345
1032,2010,Kolín,22,704,361,343
1033,2010,Kolín,23,740,392,348
1034,2010,Kolín,24,736,380,356
1035,2010,Kolín,25,784,411,373
1036,2010,Kolín,26,884,457,427
1037,2010,Kolín,27,1042,562,480
1038,2010,Kolín,28,1065,538,527
1039,2010,Kolín,29,1050,544,506
1040,2010,Kolín,30,1162,614,548
1041,2010,Kolín,31,1091,581,510
1042,2010,Kolín,32,1156,597,559
1043,2010,Kolín,33,1168,624,544
1044,2010,Kolín,34,1172,615,557
1045,2010,Kolín,35,1229,650,579
1046,2010,Kolín,36,1248,653,595
1047,2010,Kolín,37,1239,681,558
1048,2010,Kolín,38,1270,660,610
1049,2010,Kolín,39,1244,697,547
1050,2010,Kolín,40,1314,677,637
1051,2010,Kolín,41,1486,769,717
1052,2010,Kolín,42,1422,789,633
1053,2010,Kolín,43,1502,747,755
1054,2010,Kolín,44,1476,783,693
1055,2010,Kolín,45,1532,761,771
1056,2010,Kolín,46,1471,776,695
1057,2010,Kolín,47,1426,753,673
1058,2010,Kolín,48,1292,673,619
1059,2010,Kolín,49,1210,648,562
1060,2010,Kolín,50,1107,600,507
1061,2010,Kolín,51,1078,572,506
1062,2010,Kolín,52,986,504,482
1063,2010,Kolín,53,1012,502,510
1064,2010,Kolín,54,1035,525,510
1065,2010,Kolín,55,1069,559,510
1066,2010,Kolín,56,1107,578,529
1067,2010,Kolín,57,1011,543,468
1068,2010,Kolín,58,938,469,469
1069,2010,Kolín,59,877,444,433
1070,2010,Kolín,60,883,423,460
1071,2010,Kolín,61,873,423,450
1072,2010,Kolín,62,978,478,500
1073,2010,Kolín,63,956,451,505
1074,2010,Kolín,64,1030,491,539
1075,2010,Kolín,65,1063,479,584
1076,2010,Kolín,66,1030,470,560
1077,2010,Kolín,67,1099,502,597
1078,2010,Kolín,68,1058,474,584
1079,2010,Kolín,69,988,471,517
1080,2010,Kolín,70,1052,487,565
1081,2010,Kolín,71,921,410,511
1082,2010,Kolín,72,988,471,517
1083,2010,Kolín,73,985,384,601
1084,2010,Kolín,74,911,374,537
1085,2010,Kolín,75,710,305,405
1086,2010,Kolín,76,744,307,437
1087,2010,Kolín,77,670,279,391
1088,2010,Kolín,78,594,237,357
1089,2010,Kolín,79,535,199,336
1090,2010,Kolín,80,501,184,317
1091,2010,Kolín,81,446,174,272
1092,2010,Kolín,82,369,134,235
1093,2010,Kolín,83,347,120,227
1094,2010,Kolín,84,310,114,196
1095,2010,Kolín,85,275,99,176
1096,2010,Kolín,86,276,74,202
1097,2010,Kolín,87,260,84,176
1098,2010,Kolín,88,206,68,138
1099,2010,Kolín,89,160,51,109
1100,2010,Kolín,90,149,55,94
1101,2010,Kolín,91,104,30,74
1102,2010,Kolín,92,76,21,55
1103,2010,Kolín,93,62,15,47
1104,2010,Kolín,94,41,13,28
1105,2010,Kolín,95,34,3,31
1106,2010,Kolín,96,27,8,19
1107,2010,Kolín,97,20,5,15
1108,2010,Kolín,98,12,2,10
1109,2010,Kolín,99,4,0,4
1110,2010,Kolín,100,10,1,9
1111,2011,Kralupy nad Vltavou,0,362,175,187
1112,2011,Kralupy nad Vltavou,1,386,195,191
1113,2011,Kralupy nad Vltavou,2,376,202,174
1114,2011,Kralupy nad Vltavou,3,438,225,213
1115,2011,Kralupy nad Vltavou,4,376,184,192
1116,2011,Kralupy nad Vltavou,5,381,197,184
1117,2011,Kralupy nad Vltavou,6,391,217,174
1118,2011,Kralupy nad Vltavou,7,329,148,181
1119,2011,Kralupy nad Vltavou,8,358,187,171
1120,2011,Kralupy nad Vltavou,9,411,205,206
1121,2011,Kralupy nad Vltavou,10,390,193,197
1122,2011,Kralupy nad Vltavou,11,407,214,193
1123,2011,Kralupy nad Vltavou,12,442,221,221
1124,2011,Kralupy nad Vltavou,13,363,193,170
1125,2011,Kralupy nad Vltavou,14,325,169,156
1126,2011,Kralupy nad Vltavou,15,323,175,148
1127,2011,Kralupy nad Vltavou,16,329,152,177
1128,2011,Kralupy nad Vltavou,17,266,129,137
1129,2011,Kralupy nad Vltavou,18,301,156,145
1130,2011,Kralupy nad Vltavou,19,294,173,121
1131,2011,Kralupy nad Vltavou,20,275,152,123
1132,2011,Kralupy nad Vltavou,21,284,153,131
1133,2011,Kralupy nad Vltavou,22,286,159,127
1134,2011,Kralupy nad Vltavou,23,281,149,132
1135,2011,Kralupy nad Vltavou,24,283,129,154
1136,2011,Kralupy nad Vltavou,25,309,166,143
1137,2011,Kralupy nad Vltavou,26,323,173,150
1138,2011,Kralupy nad Vltavou,27,407,206,201
1139,2011,Kralupy nad Vltavou,28,418,194,224
1140,2011,Kralupy nad Vltavou,29,469,240,229
1141,2011,Kralupy nad Vltavou,30,449,228,221
1142,2011,Kralupy nad Vltavou,31,433,216,217
1143,2011,Kralupy nad Vltavou,32,493,262,231
1144,2011,Kralupy nad Vltavou,33,493,256,237
1145,2011,Kralupy nad Vltavou,34,505,266,239
1146,2011,Kralupy nad Vltavou,35,500,263,237
1147,2011,Kralupy nad Vltavou,36,484,251,233
1148,2011,Kralupy nad Vltavou,37,512,273,239
1149,2011,Kralupy nad Vltavou,38,509,270,239
1150,2011,Kralupy nad Vltavou,39,503,251,252
1151,2011,Kralupy nad Vltavou,40,518,291,227
1152,2011,Kralupy nad Vltavou,41,567,297,270
1153,2011,Kralupy nad Vltavou,42,575,280,295
1154,2011,Kralupy nad Vltavou,43,582,302,280
1155,2011,Kralupy nad Vltavou,44,614,331,283
1156,2011,Kralupy nad Vltavou,45,635,313,322
1157,2011,Kralupy nad Vltavou,46,630,334,296
1158,2011,Kralupy nad Vltavou,47,582,301,281
1159,2011,Kralupy nad Vltavou,48,521,251,270
1160,2011,Kralupy nad Vltavou,49,482,251,231
1161,2011,Kralupy nad Vltavou,50,464,252,212
1162,2011,Kralupy nad Vltavou,51,445,234,211
1163,2011,Kralupy nad Vltavou,52,427,221,206
1164,2011,Kralupy nad Vltavou,53,432,237,195
1165,2011,Kralupy nad Vltavou,54,405,210,195
1166,2011,Kralupy nad Vltavou,55,412,228,184
1167,2011,Kralupy nad Vltavou,56,424,198,226
1168,2011,Kralupy nad Vltavou,57,394,215,179
1169,2011,Kralupy nad Vltavou,58,399,217,182
1170,2011,Kralupy nad Vltavou,59,325,162,163
1171,2011,Kralupy nad Vltavou,60,316,163,153
1172,2011,Kralupy nad Vltavou,61,299,142,157
1173,2011,Kralupy nad Vltavou,62,344,172,172
1174,2011,Kralupy nad Vltavou,63,338,149,189
1175,2011,Kralupy nad Vltavou,64,359,172,187
1176,2011,Kralupy nad Vltavou,65,354,175,179
1177,2011,Kralupy nad Vltavou,66,353,179,174
1178,2011,Kralupy nad Vltavou,67,354,173,181
1179,2011,Kralupy nad Vltavou,68,351,144,207
1180,2011,Kralupy nad Vltavou,69,353,148,205
1181,2011,Kralupy nad Vltavou,70,347,153,194
1182,2011,Kralupy nad Vltavou,71,346,143,203
1183,2011,Kralupy nad Vltavou,72,366,154,212
1184,2011,Kralupy nad Vltavou,73,391,182,209
1185,2011,Kralupy nad Vltavou,74,319,160,159
1186,2011,Kralupy nad Vltavou,75,264,88,176
1187,2011,Kralupy nad Vltavou,76,310,132,178
1188,2011,Kralupy nad Vltavou,77,237,102,135
1189,2011,Kralupy nad Vltavou,78,212,89,123
1190,2011,Kralupy nad Vltavou,79,186,67,119
1191,2011,Kralupy nad Vltavou,80,166,58,108
1192,2011,Kralupy nad Vltavou,81,166,61,105
1193,2011,Kralupy nad Vltavou,82,143,59,84
1194,2011,Kralupy nad Vltavou,83,110,38,72
1195,2011,Kralupy nad Vltavou,84,108,39,69
1196,2011,Kralupy nad Vltavou,85,93,32,61
1197,2011,Kralupy nad Vltavou,86,89,36,53
1198,2011,Kralupy nad Vltavou,87,71,29,42
1199,2011,Kralupy nad Vltavou,88,61,23,38
1200,2011,Kralupy nad Vltavou,89,48,20,28
1201,2011,Kralupy nad Vltavou,90,47,13,34
1202,2011,Kralupy nad Vltavou,91,30,9,21
1203,2011,Kralupy nad Vltavou,92,38,10,28
1204,2011,Kralupy nad Vltavou,93,23,6,17
1205,2011,Kralupy nad Vltavou,94,14,1,13
1206,2011,Kralupy nad Vltavou,95,9,1,8
1207,2011,Kralupy nad Vltavou,96,3,0,3
1208,2011,Kralupy nad Vltavou,97,2,1,1
1209,2011,Kralupy nad Vltavou,98,4,0,4
1210,2011,Kralupy nad Vltavou,99,2,0,2
1211,2011,Kralupy nad Vltavou,100,1,1,0
1212,2012,Kutná Hora,0,493,265,228
1213,2012,Kutná Hora,1,479,248,231
1214,2012,Kutná Hora,2,518,259,259
1215,2012,Kutná Hora,3,541,265,276
1216,2012,Kutná Hora,4,522,257,265
1217,2012,Kutná Hora,5,541,268,273
1218,2012,Kutná Hora,6,473,237,236
1219,2012,Kutná Hora,7,470,238,232
1220,2012,Kutná Hora,8,496,269,227
1221,2012,Kutná Hora,9,529,268,261
1222,2012,Kutná Hora,10,533,268,265
1223,2012,Kutná Hora,11,507,251,256
1224,2012,Kutná Hora,12,559,283,276
1225,2012,Kutná Hora,13,535,254,281
1226,2012,Kutná Hora,14,479,247,232
1227,2012,Kutná Hora,15,477,256,221
1228,2012,Kutná Hora,16,452,238,214
1229,2012,Kutná Hora,17,408,214,194
1230,2012,Kutná Hora,18,433,208,225
1231,2012,Kutná Hora,19,440,239,201
1232,2012,Kutná Hora,20,434,229,205
1233,2012,Kutná Hora,21,455,222,233
1234,2012,Kutná Hora,22,465,243,222
1235,2012,Kutná Hora,23,439,215,224
1236,2012,Kutná Hora,24,437,233,204
1237,2012,Kutná Hora,25,533,262,271
1238,2012,Kutná Hora,26,581,314,267
1239,2012,Kutná Hora,27,636,322,314
1240,2012,Kutná Hora,28,626,343,283
1241,2012,Kutná Hora,29,671,374,297
1242,2012,Kutná Hora,30,621,324,297
1243,2012,Kutná Hora,31,636,328,308
1244,2012,Kutná Hora,32,695,371,324
1245,2012,Kutná Hora,33,620,343,277
1246,2012,Kutná Hora,34,653,349,304
1247,2012,Kutná Hora,35,699,378,321
1248,2012,Kutná Hora,36,660,355,305
1249,2012,Kutná Hora,37,649,344,305
1250,2012,Kutná Hora,38,685,367,318
1251,2012,Kutná Hora,39,673,335,338
1252,2012,Kutná Hora,40,666,350,316
1253,2012,Kutná Hora,41,793,411,382
1254,2012,Kutná Hora,42,778,395,383
1255,2012,Kutná Hora,43,835,473,362
1256,2012,Kutná Hora,44,839,436,403
1257,2012,Kutná Hora,45,881,453,428
1258,2012,Kutná Hora,46,883,469,414
1259,2012,Kutná Hora,47,829,421,408
1260,2012,Kutná Hora,48,763,399,364
1261,2012,Kutná Hora,49,738,361,377
1262,2012,Kutná Hora,50,744,388,356
1263,2012,Kutná Hora,51,682,358,324
1264,2012,Kutná Hora,52,610,293,317
1265,2012,Kutná Hora,53,700,377,323
1266,2012,Kutná Hora,54,647,342,305
1267,2012,Kutná Hora,55,687,350,337
1268,2012,Kutná Hora,56,671,340,331
1269,2012,Kutná Hora,57,678,341,337
1270,2012,Kutná Hora,58,615,320,295
1271,2012,Kutná Hora,59,595,329,266
1272,2012,Kutná Hora,60,572,279,293
1273,2012,Kutná Hora,61,573,287,286
1274,2012,Kutná Hora,62,621,292,329
1275,2012,Kutná Hora,63,702,324,378
1276,2012,Kutná Hora,64,720,356,364
1277,2012,Kutná Hora,65,686,355,331
1278,2012,Kutná Hora,66,672,329,343
1279,2012,Kutná Hora,67,717,354,363
1280,2012,Kutná Hora,68,661,314,347
1281,2012,Kutná Hora,69,660,314,346
1282,2012,Kutná Hora,70,634,276,358
1283,2012,Kutná Hora,71,641,306,335
1284,2012,Kutná Hora,72,638,299,339
1285,2012,Kutná Hora,73,652,301,351
1286,2012,Kutná Hora,74,621,266,355
1287,2012,Kutná Hora,75,461,202,259
1288,2012,Kutná Hora,76,462,195,267
1289,2012,Kutná Hora,77,467,192,275
1290,2012,Kutná Hora,78,361,135,226
1291,2012,Kutná Hora,79,352,143,209
1292,2012,Kutná Hora,80,298,115,183
1293,2012,Kutná Hora,81,228,94,134
1294,2012,Kutná Hora,82,254,92,162
1295,2012,Kutná Hora,83,205,73,132
1296,2012,Kutná Hora,84,168,56,112
1297,2012,Kutná Hora,85,187,53,134
1298,2012,Kutná Hora,86,156,44,112
1299,2012,Kutná Hora,87,141,36,105
1300,2012,Kutná Hora,88,131,22,109
1301,2012,Kutná Hora,89,123,41,82
1302,2012,Kutná Hora,90,75,16,59
1303,2012,Kutná Hora,91,61,21,40
1304,2012,Kutná Hora,92,53,6,47
1305,2012,Kutná Hora,93,40,9,31
1306,2012,Kutná Hora,94,20,5,15
1307,2012,Kutná Hora,95,15,4,11
1308,2012,Kutná Hora,96,9,4,5
1309,2012,Kutná Hora,97,7,3,4
1310,2012,Kutná Hora,98,4,0,4
1311,2012,Kutná Hora,99,5,0,5
1312,2012,Kutná Hora,100,8,4,4
1313,2013,Lysá nad Labem,0,264,137,127
1314,2013,Lysá nad Labem,1,360,187,173
1315,2013,Lysá nad Labem,2,348,178,170
1316,2013,Lysá nad Labem,3,359,181,178
1317,2013,Lysá nad Labem,4,355,180,175
1318,2013,Lysá nad Labem,5,351,178,173
1319,2013,Lysá nad Labem,6,423,193,230
1320,2013,Lysá nad Labem,7,369,175,194
1321,2013,Lysá nad Labem,8,384,210,174
1322,2013,Lysá nad Labem,9,370,178,192
1323,2013,Lysá nad Labem,10,416,225,191
1324,2013,Lysá nad Labem,11,431,211,220
1325,2013,Lysá nad Labem,12,389,199,190
1326,2013,Lysá nad Labem,13,378,202,176
1327,2013,Lysá nad Labem,14,319,163,156
1328,2013,Lysá nad Labem,15,352,174,178
1329,2013,Lysá nad Labem,16,314,170,144
1330,2013,Lysá nad Labem,17,283,147,136
1331,2013,Lysá nad Labem,18,259,137,122
1332,2013,Lysá nad Labem,19,240,121,119
1333,2013,Lysá nad Labem,20,284,150,134
1334,2013,Lysá nad Labem,21,243,112,131
1335,2013,Lysá nad Labem,22,239,119,120
1336,2013,Lysá nad Labem,23,248,139,109
1337,2013,Lysá nad Labem,24,228,117,111
1338,2013,Lysá nad Labem,25,233,113,120
1339,2013,Lysá nad Labem,26,268,131,137
1340,2013,Lysá nad Labem,27,341,178,163
1341,2013,Lysá nad Labem,28,327,170,157
1342,2013,Lysá nad Labem,29,365,179,186
1343,2013,Lysá nad Labem,30,346,178,168
1344,2013,Lysá nad Labem,31,373,166,207
1345,2013,Lysá nad Labem,32,392,202,190
1346,2013,Lysá nad Labem,33,401,196,205
1347,2013,Lysá nad Labem,34,373,176,197
1348,2013,Lysá nad Labem,35,452,203,249
1349,2013,Lysá nad Labem,36,433,207,226
1350,2013,Lysá nad Labem,37,414,219,195
1351,2013,Lysá nad Labem,38,476,225,251
1352,2013,Lysá nad Labem,39,504,252,252
1353,2013,Lysá nad Labem,40,568,253,315
1354,2013,Lysá nad Labem,41,572,302,270
1355,2013,Lysá nad Labem,42,637,320,317
1356,2013,Lysá nad Labem,43,611,298,313
1357,2013,Lysá nad Labem,44,599,293,306
1358,2013,Lysá nad Labem,45,589,315,274
1359,2013,Lysá nad Labem,46,608,318,290
1360,2013,Lysá nad Labem,47,484,245,239
1361,2013,Lysá nad Labem,48,468,242,226
1362,2013,Lysá nad Labem,49,434,221,213
1363,2013,Lysá nad Labem,50,377,183,194
1364,2013,Lysá nad Labem,51,340,162,178
1365,2013,Lysá nad Labem,52,325,168,157
1366,2013,Lysá nad Labem,53,323,171,152
1367,2013,Lysá nad Labem,54,287,154,133
1368,2013,Lysá nad Labem,55,283,156,127
1369,2013,Lysá nad Labem,56,293,169,124
1370,2013,Lysá nad Labem,57,282,136,146
1371,2013,Lysá nad Labem,58,241,124,117
1372,2013,Lysá nad Labem,59,226,108,118
1373,2013,Lysá nad Labem,60,211,95,116
1374,2013,Lysá nad Labem,61,202,85,117
1375,2013,Lysá nad Labem,62,229,115,114
1376,2013,Lysá nad Labem,63,253,122,131
1377,2013,Lysá nad Labem,64,235,112,123
1378,2013,Lysá nad Labem,65,273,126,147
1379,2013,Lysá nad Labem,66,253,114,139
1380,2013,Lysá nad Labem,67,242,117,125
1381,2013,Lysá nad Labem,68,243,110,133
1382,2013,Lysá nad Labem,69,210,94,116
1383,2013,Lysá nad Labem,70,223,92,131
1384,2013,Lysá nad Labem,71,219,107,112
1385,2013,Lysá nad Labem,72,205,90,115
1386,2013,Lysá nad Labem,73,189,85,104
1387,2013,Lysá nad Labem,74,206,86,120
1388,2013,Lysá nad Labem,75,148,64,84
1389,2013,Lysá nad Labem,76,157,70,87
1390,2013,Lysá nad Labem,77,151,63,88
1391,2013,Lysá nad Labem,78,117,53,64
1392,2013,Lysá nad Labem,79,95,37,58
1393,2013,Lysá nad Labem,80,94,36,58
1394,2013,Lysá nad Labem,81,69,18,51
1395,2013,Lysá nad Labem,82,67,26,41
1396,2013,Lysá nad Labem,83,62,17,45
1397,2013,Lysá nad Labem,84,47,9,38
1398,2013,Lysá nad Labem,85,55,13,42
1399,2013,Lysá nad Labem,86,56,22,34
1400,2013,Lysá nad Labem,87,33,6,27
1401,2013,Lysá nad Labem,88,37,8,29
1402,2013,Lysá nad Labem,89,35,11,24
1403,2013,Lysá nad Labem,90,25,7,18
1404,2013,Lysá nad Labem,91,8,0,8
1405,2013,Lysá nad Labem,92,14,5,9
1406,2013,Lysá nad Labem,93,8,2,6
1407,2013,Lysá nad Labem,94,11,5,6
1408,2013,Lysá nad Labem,95,3,1,2
1409,2013,Lysá nad Labem,96,5,1,4
1410,2013,Lysá nad Labem,97,2,0,2
1411,2013,Lysá nad Labem,98,1,0,1
1412,2013,Lysá nad Labem,99,1,0,1
1413,2013,Lysá nad Labem,100,0,0,0
1414,2014,Mělník,0,494,268,226
1415,2014,Mělník,1,482,245,237
1416,2014,Mělník,2,535,258,277
1417,2014,Mělník,3,485,253,232
1418,2014,Mělník,4,531,288,243
1419,2014,Mělník,5,495,257,238
1420,2014,Mělník,6,514,256,258
1421,2014,Mělník,7,455,238,217
1422,2014,Mělník,8,480,237,243
1423,2014,Mělník,9,487,242,245
1424,2014,Mělník,10,560,300,260
1425,2014,Mělník,11,571,307,264
1426,2014,Mělník,12,524,266,258
1427,2014,Mělník,13,560,306,254
1428,2014,Mělník,14,458,249,209
1429,2014,Mělník,15,479,255,224
1430,2014,Mělník,16,445,206,239
1431,2014,Mělník,17,426,214,212
1432,2014,Mělník,18,469,242,227
1433,2014,Mělník,19,403,209,194
1434,2014,Mělník,20,358,176,182
1435,2014,Mělník,21,392,200,192
1436,2014,Mělník,22,382,192,190
1437,2014,Mělník,23,391,215,176
1438,2014,Mělník,24,409,219,190
1439,2014,Mělník,25,441,231,210
1440,2014,Mělník,26,481,248,233
1441,2014,Mělník,27,561,287,274
1442,2014,Mělník,28,545,270,275
1443,2014,Mělník,29,597,307,290
1444,2014,Mělník,30,591,296,295
1445,2014,Mělník,31,589,305,284
1446,2014,Mělník,32,560,273,287
1447,2014,Mělník,33,555,280,275
1448,2014,Mělník,34,636,334,302
1449,2014,Mělník,35,581,301,280
1450,2014,Mělník,36,635,341,294
1451,2014,Mělník,37,622,320,302
1452,2014,Mělník,38,581,315,266
1453,2014,Mělník,39,629,322,307
1454,2014,Mělník,40,672,356,316
1455,2014,Mělník,41,761,400,361
1456,2014,Mělník,42,778,406,372
1457,2014,Mělník,43,798,382,416
1458,2014,Mělník,44,761,390,371
1459,2014,Mělník,45,801,402,399
1460,2014,Mělník,46,818,408,410
1461,2014,Mělník,47,828,413,415
1462,2014,Mělník,48,713,365,348
1463,2014,Mělník,49,668,320,348
1464,2014,Mělník,50,653,348,305
1465,2014,Mělník,51,594,321,273
1466,2014,Mělník,52,560,286,274
1467,2014,Mělník,53,592,291,301
1468,2014,Mělník,54,548,273,275
1469,2014,Mělník,55,624,322,302
1470,2014,Mělník,56,607,314,293
1471,2014,Mělník,57,569,306,263
1472,2014,Mělník,58,508,268,240
1473,2014,Mělník,59,479,242,237
1474,2014,Mělník,60,429,232,197
1475,2014,Mělník,61,425,205,220
1476,2014,Mělník,62,504,244,260
1477,2014,Mělník,63,495,239,256
1478,2014,Mělník,64,545,275,270
1479,2014,Mělník,65,505,238,267
1480,2014,Mělník,66,485,235,250
1481,2014,Mělník,67,504,243,261
1482,2014,Mělník,68,567,247,320
1483,2014,Mělník,69,534,233,301
1484,2014,Mělník,70,541,240,301
1485,2014,Mělník,71,520,234,286
1486,2014,Mělník,72,510,235,275
1487,2014,Mělník,73,512,229,283
1488,2014,Mělník,74,524,237,287
1489,2014,Mělník,75,421,192,229
1490,2014,Mělník,76,384,170,214
1491,2014,Mělník,77,384,152,232
1492,2014,Mělník,78,307,128,179
1493,2014,Mělník,79,249,91,158
1494,2014,Mělník,80,228,96,132
1495,2014,Mělník,81,214,73,141
1496,2014,Mělník,82,178,62,116
1497,2014,Mělník,83,160,50,110
1498,2014,Mělník,84,161,65,96
1499,2014,Mělník,85,145,47,98
1500,2014,Mělník,86,137,40,97
1501,2014,Mělník,87,94,31,63
1502,2014,Mělník,88,89,21,68
1503,2014,Mělník,89,74,22,52
1504,2014,Mělník,90,65,22,43
1505,2014,Mělník,91,49,16,33
1506,2014,Mělník,92,38,12,26
1507,2014,Mělník,93,33,11,22
1508,2014,Mělník,94,17,2,15
1509,2014,Mělník,95,23,4,19
1510,2014,Mělník,96,8,2,6
1511,2014,Mělník,97,9,4,5
1512,2014,Mělník,98,4,1,3
1513,2014,Mělník,99,4,0,4
1514,2014,Mělník,100,2,0,2
1515,2015,Mladá Boleslav,0,1181,609,572
1516,2015,Mladá Boleslav,1,1156,594,562
1517,2015,Mladá Boleslav,2,1209,601,608
1518,2015,Mladá Boleslav,3,1247,658,589
1519,2015,Mladá Boleslav,4,1216,593,623
1520,2015,Mladá Boleslav,5,1146,570,576
1521,2015,Mladá Boleslav,6,1216,613,603
1522,2015,Mladá Boleslav,7,1152,563,589
1523,2015,Mladá Boleslav,8,1196,635,561
1524,2015,Mladá Boleslav,9,1239,628,611
1525,2015,Mladá Boleslav,10,1371,720,651
1526,2015,Mladá Boleslav,11,1359,697,662
1527,2015,Mladá Boleslav,12,1452,778,674
1528,2015,Mladá Boleslav,13,1262,637,625
1529,2015,Mladá Boleslav,14,1144,587,557
1530,2015,Mladá Boleslav,15,1046,553,493
1531,2015,Mladá Boleslav,16,1035,530,505
1532,2015,Mladá Boleslav,17,951,497,454
1533,2015,Mladá Boleslav,18,990,527,463
1534,2015,Mladá Boleslav,19,984,520,464
1535,2015,Mladá Boleslav,20,982,528,454
1536,2015,Mladá Boleslav,21,923,485,438
1537,2015,Mladá Boleslav,22,985,528,457
1538,2015,Mladá Boleslav,23,988,482,506
1539,2015,Mladá Boleslav,24,1037,559,478
1540,2015,Mladá Boleslav,25,1118,587,531
1541,2015,Mladá Boleslav,26,1227,622,605
1542,2015,Mladá Boleslav,27,1401,776,625
1543,2015,Mladá Boleslav,28,1532,826,706
1544,2015,Mladá Boleslav,29,1469,789,680
1545,2015,Mladá Boleslav,30,1522,772,750
1546,2015,Mladá Boleslav,31,1582,843,739
1547,2015,Mladá Boleslav,32,1601,852,749
1548,2015,Mladá Boleslav,33,1542,823,719
1549,2015,Mladá Boleslav,34,1706,899,807
1550,2015,Mladá Boleslav,35,1662,904,758
1551,2015,Mladá Boleslav,36,1738,915,823
1552,2015,Mladá Boleslav,37,1750,959,791
1553,2015,Mladá Boleslav,38,1658,911,747
1554,2015,Mladá Boleslav,39,1766,964,802
1555,2015,Mladá Boleslav,40,1811,957,854
1556,2015,Mladá Boleslav,41,2099,1123,976
1557,2015,Mladá Boleslav,42,2209,1201,1008
1558,2015,Mladá Boleslav,43,2201,1149,1052
1559,2015,Mladá Boleslav,44,2142,1168,974
1560,2015,Mladá Boleslav,45,2193,1182,1011
1561,2015,Mladá Boleslav,46,2118,1169,949
1562,2015,Mladá Boleslav,47,2039,1061,978
1563,2015,Mladá Boleslav,48,1853,994,859
1564,2015,Mladá Boleslav,49,1598,839,759
1565,2015,Mladá Boleslav,50,1652,907,745
1566,2015,Mladá Boleslav,51,1531,791,740
1567,2015,Mladá Boleslav,52,1436,754,682
1568,2015,Mladá Boleslav,53,1397,751,646
1569,2015,Mladá Boleslav,54,1392,721,671
1570,2015,Mladá Boleslav,55,1358,675,683
1571,2015,Mladá Boleslav,56,1402,716,686
1572,2015,Mladá Boleslav,57,1363,698,665
1573,2015,Mladá Boleslav,58,1195,642,553
1574,2015,Mladá Boleslav,59,1165,603,562
1575,2015,Mladá Boleslav,60,1185,608,577
1576,2015,Mladá Boleslav,61,1087,556,531
1577,2015,Mladá Boleslav,62,1261,635,626
1578,2015,Mladá Boleslav,63,1326,651,675
1579,2015,Mladá Boleslav,64,1357,661,696
1580,2015,Mladá Boleslav,65,1320,646,674
1581,2015,Mladá Boleslav,66,1374,676,698
1582,2015,Mladá Boleslav,67,1351,615,736
1583,2015,Mladá Boleslav,68,1464,712,752
1584,2015,Mladá Boleslav,69,1347,640,707
1585,2015,Mladá Boleslav,70,1299,585,714
1586,2015,Mladá Boleslav,71,1177,530,647
1587,2015,Mladá Boleslav,72,1194,544,650
1588,2015,Mladá Boleslav,73,1221,557,664
1589,2015,Mladá Boleslav,74,1185,523,662
1590,2015,Mladá Boleslav,75,964,408,556
1591,2015,Mladá Boleslav,76,876,371,505
1592,2015,Mladá Boleslav,77,820,342,478
1593,2015,Mladá Boleslav,78,657,265,392
1594,2015,Mladá Boleslav,79,565,236,329
1595,2015,Mladá Boleslav,80,551,230,321
1596,2015,Mladá Boleslav,81,488,179,309
1597,2015,Mladá Boleslav,82,435,179,256
1598,2015,Mladá Boleslav,83,390,135,255
1599,2015,Mladá Boleslav,84,358,134,224
1600,2015,Mladá Boleslav,85,311,102,209
1601,2015,Mladá Boleslav,86,283,106,177
1602,2015,Mladá Boleslav,87,261,77,184
1603,2015,Mladá Boleslav,88,216,69,147
1604,2015,Mladá Boleslav,89,188,59,129
1605,2015,Mladá Boleslav,90,183,52,131
1606,2015,Mladá Boleslav,91,111,38,73
1607,2015,Mladá Boleslav,92,87,27,60
1608,2015,Mladá Boleslav,93,51,16,35
1609,2015,Mladá Boleslav,94,62,18,44
1610,2015,Mladá Boleslav,95,31,7,24
1611,2015,Mladá Boleslav,96,31,4,27
1612,2015,Mladá Boleslav,97,16,4,12
1613,2015,Mladá Boleslav,98,4,0,4
1614,2015,Mladá Boleslav,99,9,3,6
1615,2015,Mladá Boleslav,100,14,3,11
1616,2016,Mnichovo Hradiště,0,210,110,100
1617,2016,Mnichovo Hradiště,1,195,101,94
1618,2016,Mnichovo Hradiště,2,216,119,97
1619,2016,Mnichovo Hradiště,3,219,107,112
1620,2016,Mnichovo Hradiště,4,210,99,111
1621,2016,Mnichovo Hradiště,5,224,105,119
1622,2016,Mnichovo Hradiště,6,207,102,105
1623,2016,Mnichovo Hradiště,7,216,114,102
1624,2016,Mnichovo Hradiště,8,226,109,117
1625,2016,Mnichovo Hradiště,9,216,105,111
1626,2016,Mnichovo Hradiště,10,207,105,102
1627,2016,Mnichovo Hradiště,11,218,116,102
1628,2016,Mnichovo Hradiště,12,190,99,91
1629,2016,Mnichovo Hradiště,13,202,111,91
1630,2016,Mnichovo Hradiště,14,179,95,84
1631,2016,Mnichovo Hradiště,15,183,97,86
1632,2016,Mnichovo Hradiště,16,161,84,77
1633,2016,Mnichovo Hradiště,17,150,86,64
1634,2016,Mnichovo Hradiště,18,161,87,74
1635,2016,Mnichovo Hradiště,19,159,77,82
1636,2016,Mnichovo Hradiště,20,139,66,73
1637,2016,Mnichovo Hradiště,21,137,78,59
1638,2016,Mnichovo Hradiště,22,127,68,59
1639,2016,Mnichovo Hradiště,23,155,88,67
1640,2016,Mnichovo Hradiště,24,152,89,63
1641,2016,Mnichovo Hradiště,25,181,85,96
1642,2016,Mnichovo Hradiště,26,183,100,83
1643,2016,Mnichovo Hradiště,27,209,110,99
1644,2016,Mnichovo Hradiště,28,221,112,109
1645,2016,Mnichovo Hradiště,29,237,119,118
1646,2016,Mnichovo Hradiště,30,226,127,99
1647,2016,Mnichovo Hradiště,31,245,131,114
1648,2016,Mnichovo Hradiště,32,217,104,113
1649,2016,Mnichovo Hradiště,33,244,108,136
1650,2016,Mnichovo Hradiště,34,269,157,112
1651,2016,Mnichovo Hradiště,35,251,124,127
1652,2016,Mnichovo Hradiště,36,272,133,139
1653,2016,Mnichovo Hradiště,37,280,155,125
1654,2016,Mnichovo Hradiště,38,272,140,132
1655,2016,Mnichovo Hradiště,39,271,127,144
1656,2016,Mnichovo Hradiště,40,268,135,133
1657,2016,Mnichovo Hradiště,41,336,172,164
1658,2016,Mnichovo Hradiště,42,350,186,164
1659,2016,Mnichovo Hradiště,43,326,188,138
1660,2016,Mnichovo Hradiště,44,326,171,155
1661,2016,Mnichovo Hradiště,45,332,174,158
1662,2016,Mnichovo Hradiště,46,342,173,169
1663,2016,Mnichovo Hradiště,47,320,178,142
1664,2016,Mnichovo Hradiště,48,287,151,136
1665,2016,Mnichovo Hradiště,49,246,135,111
1666,2016,Mnichovo Hradiště,50,232,107,125
1667,2016,Mnichovo Hradiště,51,251,141,110
1668,2016,Mnichovo Hradiště,52,208,110,98
1669,2016,Mnichovo Hradiště,53,210,103,107
1670,2016,Mnichovo Hradiště,54,208,113,95
1671,2016,Mnichovo Hradiště,55,207,108,99
1672,2016,Mnichovo Hradiště,56,256,134,122
1673,2016,Mnichovo Hradiště,57,185,84,101
1674,2016,Mnichovo Hradiště,58,189,107,82
1675,2016,Mnichovo Hradiště,59,205,104,101
1676,2016,Mnichovo Hradiště,60,201,96,105
1677,2016,Mnichovo Hradiště,61,207,103,104
1678,2016,Mnichovo Hradiště,62,185,96,89
1679,2016,Mnichovo Hradiště,63,222,105,117
1680,2016,Mnichovo Hradiště,64,252,129,123
1681,2016,Mnichovo Hradiště,65,249,125,124
1682,2016,Mnichovo Hradiště,66,246,139,107
1683,2016,Mnichovo Hradiště,67,215,101,114
1684,2016,Mnichovo Hradiště,68,212,84,128
1685,2016,Mnichovo Hradiště,69,205,95,110
1686,2016,Mnichovo Hradiště,70,202,95,107
1687,2016,Mnichovo Hradiště,71,202,94,108
1688,2016,Mnichovo Hradiště,72,209,95,114
1689,2016,Mnichovo Hradiště,73,191,97,94
1690,2016,Mnichovo Hradiště,74,183,73,110
1691,2016,Mnichovo Hradiště,75,125,53,72
1692,2016,Mnichovo Hradiště,76,150,63,87
1693,2016,Mnichovo Hradiště,77,130,46,84
1694,2016,Mnichovo Hradiště,78,100,41,59
1695,2016,Mnichovo Hradiště,79,97,40,57
1696,2016,Mnichovo Hradiště,80,89,29,60
1697,2016,Mnichovo Hradiště,81,72,30,42
1698,2016,Mnichovo Hradiště,82,78,36,42
1699,2016,Mnichovo Hradiště,83,69,18,51
1700,2016,Mnichovo Hradiště,84,63,16,47
1701,2016,Mnichovo Hradiště,85,59,16,43
1702,2016,Mnichovo Hradiště,86,53,17,36
1703,2016,Mnichovo Hradiště,87,41,14,27
1704,2016,Mnichovo Hradiště,88,56,18,38
1705,2016,Mnichovo Hradiště,89,40,6,34
1706,2016,Mnichovo Hradiště,90,35,8,27
1707,2016,Mnichovo Hradiště,91,18,6,12
1708,2016,Mnichovo Hradiště,92,20,4,16
1709,2016,Mnichovo Hradiště,93,9,1,8
1710,2016,Mnichovo Hradiště,94,12,4,8
1711,2016,Mnichovo Hradiště,95,8,3,5
1712,2016,Mnichovo Hradiště,96,4,1,3
1713,2016,Mnichovo Hradiště,97,6,4,2
1714,2016,Mnichovo Hradiště,98,0,0,0
1715,2016,Mnichovo Hradiště,99,1,1,0
1716,2016,Mnichovo Hradiště,100,0,0,0
1717,2017,Neratovice,0,309,156,153
1718,2017,Neratovice,1,341,172,169
1719,2017,Neratovice,2,340,175,165
1720,2017,Neratovice,3,390,195,195
1721,2017,Neratovice,4,356,179,177
1722,2017,Neratovice,5,408,221,187
1723,2017,Neratovice,6,377,199,178
1724,2017,Neratovice,7,348,177,171
1725,2017,Neratovice,8,341,183,158
1726,2017,Neratovice,9,352,185,167
1727,2017,Neratovice,10,382,196,186
1728,2017,Neratovice,11,375,190,185
1729,2017,Neratovice,12,423,222,201
1730,2017,Neratovice,13,382,186,196
1731,2017,Neratovice,14,361,205,156
1732,2017,Neratovice,15,310,163,147
1733,2017,Neratovice,16,319,174,145
1734,2017,Neratovice,17,331,158,173
1735,2017,Neratovice,18,318,142,176
1736,2017,Neratovice,19,293,164,129
1737,2017,Neratovice,20,288,162,126
1738,2017,Neratovice,21,259,129,130
1739,2017,Neratovice,22,280,145,135
1740,2017,Neratovice,23,282,142,140
1741,2017,Neratovice,24,300,146,154
1742,2017,Neratovice,25,298,154,144
1743,2017,Neratovice,26,348,174,174
1744,2017,Neratovice,27,403,219,184
1745,2017,Neratovice,28,368,188,180
1746,2017,Neratovice,29,410,224,186
1747,2017,Neratovice,30,391,190,201
1748,2017,Neratovice,31,410,198,212
1749,2017,Neratovice,32,431,221,210
1750,2017,Neratovice,33,441,210,231
1751,2017,Neratovice,34,455,236,219
1752,2017,Neratovice,35,437,231,206
1753,2017,Neratovice,36,466,241,225
1754,2017,Neratovice,37,442,230,212
1755,2017,Neratovice,38,454,221,233
1756,2017,Neratovice,39,487,239,248
1757,2017,Neratovice,40,517,267,250
1758,2017,Neratovice,41,547,277,270
1759,2017,Neratovice,42,590,309,281
1760,2017,Neratovice,43,600,307,293
1761,2017,Neratovice,44,627,327,300
1762,2017,Neratovice,45,644,316,328
1763,2017,Neratovice,46,611,307,304
1764,2017,Neratovice,47,605,311,294
1765,2017,Neratovice,48,556,281,275
1766,2017,Neratovice,49,455,234,221
1767,2017,Neratovice,50,489,217,272
1768,2017,Neratovice,51,428,232,196
1769,2017,Neratovice,52,433,213,220
1770,2017,Neratovice,53,387,197,190
1771,2017,Neratovice,54,411,202,209
1772,2017,Neratovice,55,388,202,186
1773,2017,Neratovice,56,405,191,214
1774,2017,Neratovice,57,403,194,209
1775,2017,Neratovice,58,370,198,172
1776,2017,Neratovice,59,352,184,168
1777,2017,Neratovice,60,304,142,162
1778,2017,Neratovice,61,352,170,182
1779,2017,Neratovice,62,310,151,159
1780,2017,Neratovice,63,399,190,209
1781,2017,Neratovice,64,381,181,200
1782,2017,Neratovice,65,358,168,190
1783,2017,Neratovice,66,436,196,240
1784,2017,Neratovice,67,426,195,231
1785,2017,Neratovice,68,452,197,255
1786,2017,Neratovice,69,400,174,226
1787,2017,Neratovice,70,404,186,218
1788,2017,Neratovice,71,373,172,201
1789,2017,Neratovice,72,367,179,188
1790,2017,Neratovice,73,332,149,183
1791,2017,Neratovice,74,319,144,175
1792,2017,Neratovice,75,313,125,188
1793,2017,Neratovice,76,248,123,125
1794,2017,Neratovice,77,205,87,118
1795,2017,Neratovice,78,174,78,96
1796,2017,Neratovice,79,150,59,91
1797,2017,Neratovice,80,128,56,72
1798,2017,Neratovice,81,122,43,79
1799,2017,Neratovice,82,130,45,85
1800,2017,Neratovice,83,112,37,75
1801,2017,Neratovice,84,87,30,57
1802,2017,Neratovice,85,67,19,48
1803,2017,Neratovice,86,66,20,46
1804,2017,Neratovice,87,61,16,45
1805,2017,Neratovice,88,68,19,49
1806,2017,Neratovice,89,51,17,34
1807,2017,Neratovice,90,33,9,24
1808,2017,Neratovice,91,25,6,19
1809,2017,Neratovice,92,19,5,14
1810,2017,Neratovice,93,21,7,14
1811,2017,Neratovice,94,16,4,12
1812,2017,Neratovice,95,11,3,8
1813,2017,Neratovice,96,9,2,7
1814,2017,Neratovice,97,5,1,4
1815,2017,Neratovice,98,5,4,1
1816,2017,Neratovice,99,0,0,0
1817,2017,Neratovice,100,2,1,1
1818,2018,Nymburk,0,421,204,217
1819,2018,Nymburk,1,414,204,210
1820,2018,Nymburk,2,448,223,225
1821,2018,Nymburk,3,459,252,207
1822,2018,Nymburk,4,419,197,222
1823,2018,Nymburk,5,398,213,185
1824,2018,Nymburk,6,458,240,218
1825,2018,Nymburk,7,405,202,203
1826,2018,Nymburk,8,387,192,195
1827,2018,Nymburk,9,445,233,212
1828,2018,Nymburk,10,518,273,245
1829,2018,Nymburk,11,470,235,235
1830,2018,Nymburk,12,527,249,278
1831,2018,Nymburk,13,500,246,254
1832,2018,Nymburk,14,475,232,243
1833,2018,Nymburk,15,427,227,200
1834,2018,Nymburk,16,405,213,192
1835,2018,Nymburk,17,371,195,176
1836,2018,Nymburk,18,427,219,208
1837,2018,Nymburk,19,359,187,172
1838,2018,Nymburk,20,379,205,174
1839,2018,Nymburk,21,295,149,146
1840,2018,Nymburk,22,330,185,145
1841,2018,Nymburk,23,364,172,192
1842,2018,Nymburk,24,337,178,159
1843,2018,Nymburk,25,423,206,217
1844,2018,Nymburk,26,411,207,204
1845,2018,Nymburk,27,418,203,215
1846,2018,Nymburk,28,445,240,205
1847,2018,Nymburk,29,498,264,234
1848,2018,Nymburk,30,540,282,258
1849,2018,Nymburk,31,522,267,255
1850,2018,Nymburk,32,483,241,242
1851,2018,Nymburk,33,493,251,242
1852,2018,Nymburk,34,511,271,240
1853,2018,Nymburk,35,486,233,253
1854,2018,Nymburk,36,489,260,229
1855,2018,Nymburk,37,551,262,289
1856,2018,Nymburk,38,540,281,259
1857,2018,Nymburk,39,574,285,289
1858,2018,Nymburk,40,613,317,296
1859,2018,Nymburk,41,710,370,340
1860,2018,Nymburk,42,755,372,383
1861,2018,Nymburk,43,749,380,369
1862,2018,Nymburk,44,722,392,330
1863,2018,Nymburk,45,814,397,417
1864,2018,Nymburk,46,775,385,390
1865,2018,Nymburk,47,682,357,325
1866,2018,Nymburk,48,594,306,288
1867,2018,Nymburk,49,618,322,296
1868,2018,Nymburk,50,558,279,279
1869,2018,Nymburk,51,492,253,239
1870,2018,Nymburk,52,521,268,253
1871,2018,Nymburk,53,500,264,236
1872,2018,Nymburk,54,502,267,235
1873,2018,Nymburk,55,491,223,268
1874,2018,Nymburk,56,522,277,245
1875,2018,Nymburk,57,497,235,262
1876,2018,Nymburk,58,439,227,212
1877,2018,Nymburk,59,440,213,227
1878,2018,Nymburk,60,426,193,233
1879,2018,Nymburk,61,426,193,233
1880,2018,Nymburk,62,524,257,267
1881,2018,Nymburk,63,537,264,273
1882,2018,Nymburk,64,516,265,251
1883,2018,Nymburk,65,538,246,292
1884,2018,Nymburk,66,547,262,285
1885,2018,Nymburk,67,530,267,263
1886,2018,Nymburk,68,572,275,297
1887,2018,Nymburk,69,545,245,300
1888,2018,Nymburk,70,509,214,295
1889,2018,Nymburk,71,505,232,273
1890,2018,Nymburk,72,470,223,247
1891,2018,Nymburk,73,483,222,261
1892,2018,Nymburk,74,469,193,276
1893,2018,Nymburk,75,395,175,220
1894,2018,Nymburk,76,353,164,189
1895,2018,Nymburk,77,327,125,202
1896,2018,Nymburk,78,282,99,183
1897,2018,Nymburk,79,241,92,149
1898,2018,Nymburk,80,220,87,133
1899,2018,Nymburk,81,163,63,100
1900,2018,Nymburk,82,166,55,111
1901,2018,Nymburk,83,138,50,88
1902,2018,Nymburk,84,137,55,82
1903,2018,Nymburk,85,125,46,79
1904,2018,Nymburk,86,94,34,60
1905,2018,Nymburk,87,92,32,60
1906,2018,Nymburk,88,82,25,57
1907,2018,Nymburk,89,72,24,48
1908,2018,Nymburk,90,62,18,44
1909,2018,Nymburk,91,39,14,25
1910,2018,Nymburk,92,31,9,22
1911,2018,Nymburk,93,16,2,14
1912,2018,Nymburk,94,13,4,9
1913,2018,Nymburk,95,8,0,8
1914,2018,Nymburk,96,11,2,9
1915,2018,Nymburk,97,6,2,4
1916,2018,Nymburk,98,6,2,4
1917,2018,Nymburk,99,1,0,1
1918,2018,Nymburk,100,2,1,1
1919,2019,Poděbrady,0,332,166,166
1920,2019,Poděbrady,1,352,170,182
1921,2019,Poděbrady,2,313,165,148
1922,2019,Poděbrady,3,325,174,151
1923,2019,Poděbrady,4,317,167,150
1924,2019,Poděbrady,5,352,185,167
1925,2019,Poděbrady,6,326,161,165
1926,2019,Poděbrady,7,321,173,148
1927,2019,Poděbrady,8,360,180,180
1928,2019,Poděbrady,9,345,178,167
1929,2019,Poděbrady,10,387,197,190
1930,2019,Poděbrady,11,345,173,172
1931,2019,Poděbrady,12,386,206,180
1932,2019,Poděbrady,13,381,192,189
1933,2019,Poděbrady,14,311,171,140
1934,2019,Poděbrady,15,304,159,145
1935,2019,Poděbrady,16,267,128,139
1936,2019,Poděbrady,17,305,158,147
1937,2019,Poděbrady,18,323,180,143
1938,2019,Poděbrady,19,288,152,136
1939,2019,Poděbrady,20,251,130,121
1940,2019,Poděbrady,21,277,148,129
1941,2019,Poděbrady,22,270,145,125
1942,2019,Poděbrady,23,281,146,135
1943,2019,Poděbrady,24,295,154,141
1944,2019,Poděbrady,25,293,145,148
1945,2019,Poděbrady,26,275,134,141
1946,2019,Poděbrady,27,346,183,163
1947,2019,Poděbrady,28,350,176,174
1948,2019,Poděbrady,29,401,201,200
1949,2019,Poděbrady,30,396,183,213
1950,2019,Poděbrady,31,362,184,178
1951,2019,Poděbrady,32,360,181,179
1952,2019,Poděbrady,33,366,204,162
1953,2019,Poděbrady,34,400,192,208
1954,2019,Poděbrady,35,425,233,192
1955,2019,Poděbrady,36,404,201,203
1956,2019,Poděbrady,37,427,230,197
1957,2019,Poděbrady,38,414,192,222
1958,2019,Poděbrady,39,424,212,212
1959,2019,Poděbrady,40,473,237,236
1960,2019,Poděbrady,41,542,279,263
1961,2019,Poděbrady,42,536,289,247
1962,2019,Poděbrady,43,509,250,259
1963,2019,Poděbrady,44,538,264,274
1964,2019,Poděbrady,45,551,260,291
1965,2019,Poděbrady,46,594,314,280
1966,2019,Poděbrady,47,528,281,247
1967,2019,Poděbrady,48,469,244,225
1968,2019,Poděbrady,49,421,205,216
1969,2019,Poděbrady,50,404,203,201
1970,2019,Poděbrady,51,436,227,209
1971,2019,Poděbrady,52,396,206,190
1972,2019,Poděbrady,53,400,205,195
1973,2019,Poděbrady,54,397,187,210
1974,2019,Poděbrady,55,363,172,191
1975,2019,Poděbrady,56,434,227,207
1976,2019,Poděbrady,57,360,178,182
1977,2019,Poděbrady,58,352,180,172
1978,2019,Poděbrady,59,378,186,192
1979,2019,Poděbrady,60,319,159,160
1980,2019,Poděbrady,61,368,191,177
1981,2019,Poděbrady,62,373,184,189
1982,2019,Poděbrady,63,414,185,229
1983,2019,Poděbrady,64,409,191,218
1984,2019,Poděbrady,65,407,188,219
1985,2019,Poděbrady,66,406,205,201
1986,2019,Poděbrady,67,411,182,229
1987,2019,Poděbrady,68,419,181,238
1988,2019,Poděbrady,69,406,196,210
1989,2019,Poděbrady,70,407,183,224
1990,2019,Poděbrady,71,437,200,237
1991,2019,Poděbrady,72,414,189,225
1992,2019,Poděbrady,73,429,194,235
1993,2019,Poděbrady,74,409,180,229
1994,2019,Poděbrady,75,299,122,177
1995,2019,Poděbrady,76,317,123,194
1996,2019,Poděbrady,77,259,124,135
1997,2019,Poděbrady,78,239,102,137
1998,2019,Poděbrady,79,201,73,128
1999,2019,Poděbrady,80,208,89,119
2000,2019,Poděbrady,81,176,67,109
2001,2019,Poděbrady,82,163,57,106
2002,2019,Poděbrady,83,142,41,101
2003,2019,Poděbrady,84,120,42,78
2004,2019,Poděbrady,85,118,37,81
2005,2019,Poděbrady,86,111,38,73
2006,2019,Poděbrady,87,96,36,60
2007,2019,Poděbrady,88,89,32,57
2008,2019,Poděbrady,89,71,24,47
2009,2019,Poděbrady,90,59,18,41
2010,2019,Poděbrady,91,33,5,28
2011,2019,Poděbrady,92,21,5,16
2012,2019,Poděbrady,93,32,7,25
2013,2019,Poděbrady,94,18,6,12
2014,2019,Poděbrady,95,9,1,8
2015,2019,Poděbrady,96,15,6,9
2016,2019,Poděbrady,97,5,0,5
2017,2019,Poděbrady,98,6,0,6
2018,2019,Poděbrady,99,1,0,1
2019,2019,Poděbrady,100,1,0,1
2020,2020,Příbram,0,653,336,317
2021,2020,Příbram,1,731,372,359
2022,2020,Příbram,2,681,338,343
2023,2020,Příbram,3,763,391,372
2024,2020,Příbram,4,716,378,338
2025,2020,Příbram,5,703,362,341
2026,2020,Příbram,6,720,385,335
2027,2020,Příbram,7,696,346,350
2028,2020,Příbram,8,680,352,328
2029,2020,Příbram,9,671,330,341
2030,2020,Příbram,10,739,379,360
2031,2020,Příbram,11,745,379,366
2032,2020,Příbram,12,747,393,354
2033,2020,Příbram,13,775,379,396
2034,2020,Příbram,14,696,357,339
2035,2020,Příbram,15,665,338,327
2036,2020,Příbram,16,675,336,339
2037,2020,Příbram,17,678,349,329
2038,2020,Příbram,18,630,319,311
2039,2020,Příbram,19,618,297,321
2040,2020,Příbram,20,593,322,271
2041,2020,Příbram,21,602,311,291
2042,2020,Příbram,22,602,294,308
2043,2020,Příbram,23,628,316,312
2044,2020,Příbram,24,650,334,316
2045,2020,Příbram,25,626,332,294
2046,2020,Příbram,26,690,381,309
2047,2020,Příbram,27,790,408,382
2048,2020,Příbram,28,816,408,408
2049,2020,Příbram,29,873,468,405
2050,2020,Příbram,30,834,439,395
2051,2020,Příbram,31,874,454,420
2052,2020,Příbram,32,895,457,438
2053,2020,Příbram,33,866,439,427
2054,2020,Příbram,34,918,451,467
2055,2020,Příbram,35,913,460,453
2056,2020,Příbram,36,906,465,441
2057,2020,Příbram,37,935,491,444
2058,2020,Příbram,38,907,487,420
2059,2020,Příbram,39,914,464,450
2060,2020,Příbram,40,1015,526,489
2061,2020,Příbram,41,1189,603,586
2062,2020,Příbram,42,1225,649,576
2063,2020,Příbram,43,1196,623,573
2064,2020,Příbram,44,1206,591,615
2065,2020,Příbram,45,1269,647,622
2066,2020,Příbram,46,1242,630,612
2067,2020,Příbram,47,1214,614,600
2068,2020,Příbram,48,1026,529,497
2069,2020,Příbram,49,1049,560,489
2070,2020,Příbram,50,900,480,420
2071,2020,Příbram,51,953,496,457
2072,2020,Příbram,52,851,424,427
2073,2020,Příbram,53,906,473,433
2074,2020,Příbram,54,854,407,447
2075,2020,Příbram,55,947,466,481
2076,2020,Příbram,56,1035,499,536
2077,2020,Příbram,57,1003,507,496
2078,2020,Příbram,58,886,443,443
2079,2020,Příbram,59,825,413,412
2080,2020,Příbram,60,813,411,402
2081,2020,Příbram,61,837,410,427
2082,2020,Příbram,62,901,438,463
2083,2020,Příbram,63,969,479,490
2084,2020,Příbram,64,997,459,538
2085,2020,Příbram,65,996,498,498
2086,2020,Příbram,66,997,478,519
2087,2020,Příbram,67,990,458,532
2088,2020,Příbram,68,981,449,532
2089,2020,Příbram,69,945,420,525
2090,2020,Příbram,70,901,412,489
2091,2020,Příbram,71,912,419,493
2092,2020,Příbram,72,848,403,445
2093,2020,Příbram,73,848,377,471
2094,2020,Příbram,74,771,324,447
2095,2020,Příbram,75,592,265,327
2096,2020,Příbram,76,639,265,374
2097,2020,Příbram,77,558,228,330
2098,2020,Příbram,78,446,155,291
2099,2020,Příbram,79,441,149,292
2100,2020,Příbram,80,436,174,262
2101,2020,Příbram,81,334,117,217
2102,2020,Příbram,82,332,104,228
2103,2020,Příbram,83,289,103,186
2104,2020,Příbram,84,251,75,176
2105,2020,Příbram,85,237,72,165
2106,2020,Příbram,86,236,68,168
2107,2020,Příbram,87,191,65,126
2108,2020,Příbram,88,156,43,113
2109,2020,Příbram,89,118,30,88
2110,2020,Příbram,90,114,32,82
2111,2020,Příbram,91,97,26,71
2112,2020,Příbram,92,65,15,50
2113,2020,Příbram,93,50,13,37
2114,2020,Příbram,94,37,5,32
2115,2020,Příbram,95,33,10,23
2116,2020,Příbram,96,12,6,6
2117,2020,Příbram,97,6,2,4
2118,2020,Příbram,98,7,0,7
2119,2020,Příbram,99,2,1,1
2120,2020,Příbram,100,5,1,4
2121,2021,Rakovník,0,546,269,277
2122,2021,Rakovník,1,565,286,279
2123,2021,Rakovník,2,599,320,279
2124,2021,Rakovník,3,584,291,293
2125,2021,Rakovník,4,548,285,263
2126,2021,Rakovník,5,611,292,319
2127,2021,Rakovník,6,578,298,280
2128,2021,Rakovník,7,599,312,287
2129,2021,Rakovník,8,550,299,251
2130,2021,Rakovník,9,572,296,276
2131,2021,Rakovník,10,615,303,312
2132,2021,Rakovník,11,614,338,276
2133,2021,Rakovník,12,668,353,315
2134,2021,Rakovník,13,597,324,273
2135,2021,Rakovník,14,607,315,292
2136,2021,Rakovník,15,506,256,250
2137,2021,Rakovník,16,512,262,250
2138,2021,Rakovník,17,521,267,254
2139,2021,Rakovník,18,482,261,221
2140,2021,Rakovník,19,497,254,243
2141,2021,Rakovník,20,482,262,220
2142,2021,Rakovník,21,444,202,242
2143,2021,Rakovník,22,480,253,227
2144,2021,Rakovník,23,534,283,251
2145,2021,Rakovník,24,490,274,216
2146,2021,Rakovník,25,513,244,269
2147,2021,Rakovník,26,539,261,278
2148,2021,Rakovník,27,640,325,315
2149,2021,Rakovník,28,669,350,319
2150,2021,Rakovník,29,665,348,317
2151,2021,Rakovník,30,681,352,329
2152,2021,Rakovník,31,693,338,355
2153,2021,Rakovník,32,687,363,324
2154,2021,Rakovník,33,717,344,373
2155,2021,Rakovník,34,748,403,345
2156,2021,Rakovník,35,749,378,371
2157,2021,Rakovník,36,760,409,351
2158,2021,Rakovník,37,734,391,343
2159,2021,Rakovník,38,765,371,394
2160,2021,Rakovník,39,791,443,348
2161,2021,Rakovník,40,802,423,379
2162,2021,Rakovník,41,963,493,470
2163,2021,Rakovník,42,920,483,437
2164,2021,Rakovník,43,934,493,441
2165,2021,Rakovník,44,1011,522,489
2166,2021,Rakovník,45,970,526,444
2167,2021,Rakovník,46,983,527,456
2168,2021,Rakovník,47,952,510,442
2169,2021,Rakovník,48,873,458,415
2170,2021,Rakovník,49,811,425,386
2171,2021,Rakovník,50,745,403,342
2172,2021,Rakovník,51,716,361,355
2173,2021,Rakovník,52,699,357,342
2174,2021,Rakovník,53,698,350,348
2175,2021,Rakovník,54,705,351,354
2176,2021,Rakovník,55,719,364,355
2177,2021,Rakovník,56,784,404,380
2178,2021,Rakovník,57,728,383,345
2179,2021,Rakovník,58,669,351,318
2180,2021,Rakovník,59,651,306,345
2181,2021,Rakovník,60,649,320,329
2182,2021,Rakovník,61,594,303,291
2183,2021,Rakovník,62,657,319,338
2184,2021,Rakovník,63,760,364,396
2185,2021,Rakovník,64,738,353,385
2186,2021,Rakovník,65,793,385,408
2187,2021,Rakovník,66,792,372,420
2188,2021,Rakovník,67,734,343,391
2189,2021,Rakovník,68,768,355,413
2190,2021,Rakovník,69,771,365,406
2191,2021,Rakovník,70,726,341,385
2192,2021,Rakovník,71,707,323,384
2193,2021,Rakovník,72,697,320,377
2194,2021,Rakovník,73,749,344,405
2195,2021,Rakovník,74,642,269,373
2196,2021,Rakovník,75,456,198,258
2197,2021,Rakovník,76,483,195,288
2198,2021,Rakovník,77,446,177,269
2199,2021,Rakovník,78,422,175,247
2200,2021,Rakovník,79,364,152,212
2201,2021,Rakovník,80,337,111,226
2202,2021,Rakovník,81,260,100,160
2203,2021,Rakovník,82,254,95,159
2204,2021,Rakovník,83,217,85,132
2205,2021,Rakovník,84,227,81,146
2206,2021,Rakovník,85,167,60,107
2207,2021,Rakovník,86,171,59,112
2208,2021,Rakovník,87,132,39,93
2209,2021,Rakovník,88,135,40,95
2210,2021,Rakovník,89,95,25,70
2211,2021,Rakovník,90,85,25,60
2212,2021,Rakovník,91,62,16,46
2213,2021,Rakovník,92,49,16,33
2214,2021,Rakovník,93,31,7,24
2215,2021,Rakovník,94,22,5,17
2216,2021,Rakovník,95,25,6,19
2217,2021,Rakovník,96,12,3,9
2218,2021,Rakovník,97,13,5,8
2219,2021,Rakovník,98,7,1,6
2220,2021,Rakovník,99,1,0,1
2221,2021,Rakovník,100,2,2,0
2222,2022,Říčany,0,763,399,364
2223,2022,Říčany,1,847,453,394
2224,2022,Říčany,2,862,443,419
2225,2022,Říčany,3,1028,519,509
2226,2022,Říčany,4,1054,544,510
2227,2022,Říčany,5,1086,549,537
2228,2022,Říčany,6,1127,597,530
2229,2022,Říčany,7,1129,589,540
2230,2022,Říčany,8,1126,561,565
2231,2022,Říčany,9,1039,506,533
2232,2022,Říčany,10,1152,593,559
2233,2022,Říčany,11,1145,585,560
2234,2022,Říčany,12,1126,564,562
2235,2022,Říčany,13,1022,534,488
2236,2022,Říčany,14,910,493,417
2237,2022,Říčany,15,952,490,462
2238,2022,Říčany,16,799,395,404
2239,2022,Říčany,17,767,408,359
2240,2022,Říčany,18,660,333,327
2241,2022,Říčany,19,702,352,350
2242,2022,Říčany,20,626,315,311
2243,2022,Říčany,21,604,321,283
2244,2022,Říčany,22,593,313,280
2245,2022,Říčany,23,593,310,283
2246,2022,Říčany,24,597,296,301
2247,2022,Říčany,25,570,296,274
2248,2022,Říčany,26,658,327,331
2249,2022,Říčany,27,711,351,360
2250,2022,Říčany,28,737,372,365
2251,2022,Říčany,29,766,393,373
2252,2022,Říčany,30,843,399,444
2253,2022,Říčany,31,850,415,435
2254,2022,Říčany,32,937,438,499
2255,2022,Říčany,33,920,443,477
2256,2022,Říčany,34,926,470,456
2257,2022,Říčany,35,1006,496,510
2258,2022,Říčany,36,1080,512,568
2259,2022,Říčany,37,1082,498,584
2260,2022,Říčany,38,1172,563,609
2261,2022,Říčany,39,1189,529,660
2262,2022,Říčany,40,1346,626,720
2263,2022,Říčany,41,1426,708,718
2264,2022,Říčany,42,1478,721,757
2265,2022,Říčany,43,1556,745,811
2266,2022,Říčany,44,1497,743,754
2267,2022,Říčany,45,1527,785,742
2268,2022,Říčany,46,1474,771,703
2269,2022,Říčany,47,1362,680,682
2270,2022,Říčany,48,1147,594,553
2271,2022,Říčany,49,1105,570,535
2272,2022,Říčany,50,1046,533,513
2273,2022,Říčany,51,920,458,462
2274,2022,Říčany,52,866,452,414
2275,2022,Říčany,53,878,430,448
2276,2022,Říčany,54,868,448,420
2277,2022,Říčany,55,878,481,397
2278,2022,Říčany,56,885,453,432
2279,2022,Říčany,57,832,400,432
2280,2022,Říčany,58,708,368,340
2281,2022,Říčany,59,677,335,342
2282,2022,Říčany,60,637,289,348
2283,2022,Říčany,61,642,312,330
2284,2022,Říčany,62,709,326,383
2285,2022,Říčany,63,727,371,356
2286,2022,Říčany,64,772,401,371
2287,2022,Říčany,65,782,397,385
2288,2022,Říčany,66,778,380,398
2289,2022,Říčany,67,758,373,385
2290,2022,Říčany,68,752,344,408
2291,2022,Říčany,69,767,372,395
2292,2022,Říčany,70,701,319,382
2293,2022,Říčany,71,683,308,375
2294,2022,Říčany,72,769,357,412
2295,2022,Říčany,73,735,326,409
2296,2022,Říčany,74,654,288,366
2297,2022,Říčany,75,520,223,297
2298,2022,Říčany,76,513,240,273
2299,2022,Říčany,77,490,233,257
2300,2022,Říčany,78,358,160,198
2301,2022,Říčany,79,345,138,207
2302,2022,Říčany,80,298,129,169
2303,2022,Říčany,81,231,105,126
2304,2022,Říčany,82,254,92,162
2305,2022,Říčany,83,187,70,117
2306,2022,Říčany,84,191,68,123
2307,2022,Říčany,85,154,60,94
2308,2022,Říčany,86,165,54,111
2309,2022,Říčany,87,133,44,89
2310,2022,Říčany,88,115,37,78
2311,2022,Říčany,89,104,32,72
2312,2022,Říčany,90,71,15,56
2313,2022,Říčany,91,74,19,55
2314,2022,Říčany,92,59,14,45
2315,2022,Říčany,93,32,8,24
2316,2022,Říčany,94,27,8,19
2317,2022,Říčany,95,24,11,13
2318,2022,Říčany,96,8,1,7
2319,2022,Říčany,97,12,4,8
2320,2022,Říčany,98,10,3,7
2321,2022,Říčany,99,3,1,2
2322,2022,Říčany,100,9,1,8
2323,2023,Sedlčany,0,223,128,95
2324,2023,Sedlčany,1,245,126,119
2325,2023,Sedlčany,2,218,99,119
2326,2023,Sedlčany,3,232,124,108
2327,2023,Sedlčany,4,202,103,99
2328,2023,Sedlčany,5,213,115,98
2329,2023,Sedlčany,6,231,133,98
2330,2023,Sedlčany,7,177,93,84
2331,2023,Sedlčany,8,198,96,102
2332,2023,Sedlčany,9,204,115,89
2333,2023,Sedlčany,10,229,123,106
2334,2023,Sedlčany,11,249,122,127
2335,2023,Sedlčany,12,242,124,118
2336,2023,Sedlčany,13,204,100,104
2337,2023,Sedlčany,14,226,114,112
2338,2023,Sedlčany,15,209,112,97
2339,2023,Sedlčany,16,210,100,110
2340,2023,Sedlčany,17,211,103,108
2341,2023,Sedlčany,18,226,125,101
2342,2023,Sedlčany,19,205,110,95
2343,2023,Sedlčany,20,227,126,101
2344,2023,Sedlčany,21,198,96,102
2345,2023,Sedlčany,22,215,113,102
2346,2023,Sedlčany,23,222,114,108
2347,2023,Sedlčany,24,218,100,118
2348,2023,Sedlčany,25,241,132,109
2349,2023,Sedlčany,26,247,134,113
2350,2023,Sedlčany,27,254,133,121
2351,2023,Sedlčany,28,252,141,111
2352,2023,Sedlčany,29,273,140,133
2353,2023,Sedlčany,30,279,140,139
2354,2023,Sedlčany,31,258,134,124
2355,2023,Sedlčany,32,253,142,111
2356,2023,Sedlčany,33,264,146,118
2357,2023,Sedlčany,34,272,132,140
2358,2023,Sedlčany,35,289,152,137
2359,2023,Sedlčany,36,287,144,143
2360,2023,Sedlčany,37,300,166,134
2361,2023,Sedlčany,38,292,146,146
2362,2023,Sedlčany,39,284,144,140
2363,2023,Sedlčany,40,304,164,140
2364,2023,Sedlčany,41,329,174,155
2365,2023,Sedlčany,42,379,187,192
2366,2023,Sedlčany,43,345,173,172
2367,2023,Sedlčany,44,349,193,156
2368,2023,Sedlčany,45,366,193,173
2369,2023,Sedlčany,46,413,206,207
2370,2023,Sedlčany,47,370,187,183
2371,2023,Sedlčany,48,298,159,139
2372,2023,Sedlčany,49,318,176,142
2373,2023,Sedlčany,50,299,153,146
2374,2023,Sedlčany,51,302,162,140
2375,2023,Sedlčany,52,268,130,138
2376,2023,Sedlčany,53,267,133,134
2377,2023,Sedlčany,54,267,136,131
2378,2023,Sedlčany,55,268,140,128
2379,2023,Sedlčany,56,290,154,136
2380,2023,Sedlčany,57,304,141,163
2381,2023,Sedlčany,58,284,152,132
2382,2023,Sedlčany,59,255,126,129
2383,2023,Sedlčany,60,262,131,131
2384,2023,Sedlčany,61,250,123,127
2385,2023,Sedlčany,62,309,164,145
2386,2023,Sedlčany,63,289,130,159
2387,2023,Sedlčany,64,346,163,183
2388,2023,Sedlčany,65,307,150,157
2389,2023,Sedlčany,66,309,137,172
2390,2023,Sedlčany,67,297,140,157
2391,2023,Sedlčany,68,286,142,144
2392,2023,Sedlčany,69,294,134,160
2393,2023,Sedlčany,70,313,156,157
2394,2023,Sedlčany,71,277,137,140
2395,2023,Sedlčany,72,298,147,151
2396,2023,Sedlčany,73,313,149,164
2397,2023,Sedlčany,74,255,113,142
2398,2023,Sedlčany,75,240,105,135
2399,2023,Sedlčany,76,166,70,96
2400,2023,Sedlčany,77,187,87,100
2401,2023,Sedlčany,78,128,53,75
2402,2023,Sedlčany,79,137,56,81
2403,2023,Sedlčany,80,135,40,95
2404,2023,Sedlčany,81,115,39,76
2405,2023,Sedlčany,82,97,32,65
2406,2023,Sedlčany,83,72,28,44
2407,2023,Sedlčany,84,81,23,58
2408,2023,Sedlčany,85,78,32,46
2409,2023,Sedlčany,86,65,19,46
2410,2023,Sedlčany,87,56,17,39
2411,2023,Sedlčany,88,57,15,42
2412,2023,Sedlčany,89,50,20,30
2413,2023,Sedlčany,90,34,9,25
2414,2023,Sedlčany,91,38,11,27
2415,2023,Sedlčany,92,22,3,19
2416,2023,Sedlčany,93,17,4,13
2417,2023,Sedlčany,94,19,3,16
2418,2023,Sedlčany,95,6,2,4
2419,2023,Sedlčany,96,9,1,8
2420,2023,Sedlčany,97,3,1,2
2421,2023,Sedlčany,98,3,0,3
2422,2023,Sedlčany,99,0,0,0
2423,2023,Sedlčany,100,4,2,2
2424,2024,Slaný,0,437,236,201
2425,2024,Slaný,1,420,224,196
2426,2024,Slaný,2,429,226,203
2427,2024,Slaný,3,453,221,232
2428,2024,Slaný,4,455,240,215
2429,2024,Slaný,5,452,228,224
2430,2024,Slaný,6,465,225,240
2431,2024,Slaný,7,490,269,221
2432,2024,Slaný,8,443,216,227
2433,2024,Slaný,9,475,231,244
2434,2024,Slaný,10,465,239,226
2435,2024,Slaný,11,458,227,231
2436,2024,Slaný,12,498,241,257
2437,2024,Slaný,13,541,291,250
2438,2024,Slaný,14,417,228,189
2439,2024,Slaný,15,433,217,216
2440,2024,Slaný,16,419,230,189
2441,2024,Slaný,17,383,201,182
2442,2024,Slaný,18,376,186,190
2443,2024,Slaný,19,409,215,194
2444,2024,Slaný,20,336,180,156
2445,2024,Slaný,21,336,162,174
2446,2024,Slaný,22,376,201,175
2447,2024,Slaný,23,343,168,175
2448,2024,Slaný,24,342,185,157
2449,2024,Slaný,25,440,222,218
2450,2024,Slaný,26,449,235,214
2451,2024,Slaný,27,528,260,268
2452,2024,Slaný,28,476,248,228
2453,2024,Slaný,29,505,246,259
2454,2024,Slaný,30,546,283,263
2455,2024,Slaný,31,496,258,238
2456,2024,Slaný,32,548,268,280
2457,2024,Slaný,33,538,263,275
2458,2024,Slaný,34,509,281,228
2459,2024,Slaný,35,548,287,261
2460,2024,Slaný,36,539,299,240
2461,2024,Slaný,37,566,278,288
2462,2024,Slaný,38,558,273,285
2463,2024,Slaný,39,611,303,308
2464,2024,Slaný,40,582,308,274
2465,2024,Slaný,41,663,346,317
2466,2024,Slaný,42,733,360,373
2467,2024,Slaný,43,744,382,362
2468,2024,Slaný,44,743,399,344
2469,2024,Slaný,45,764,398,366
2470,2024,Slaný,46,757,389,368
2471,2024,Slaný,47,716,374,342
2472,2024,Slaný,48,673,349,324
2473,2024,Slaný,49,628,313,315
2474,2024,Slaný,50,550,293,257
2475,2024,Slaný,51,565,286,279
2476,2024,Slaný,52,526,276,250
2477,2024,Slaný,53,518,275,243
2478,2024,Slaný,54,499,260,239
2479,2024,Slaný,55,536,252,284
2480,2024,Slaný,56,551,269,282
2481,2024,Slaný,57,524,281,243
2482,2024,Slaný,58,472,244,228
2483,2024,Slaný,59,435,218,217
2484,2024,Slaný,60,414,208,206
2485,2024,Slaný,61,376,198,178
2486,2024,Slaný,62,471,239,232
2487,2024,Slaný,63,447,218,229
2488,2024,Slaný,64,500,231,269
2489,2024,Slaný,65,534,246,288
2490,2024,Slaný,66,509,248,261
2491,2024,Slaný,67,505,214,291
2492,2024,Slaný,68,470,225,245
2493,2024,Slaný,69,512,261,251
2494,2024,Slaný,70,480,226,254
2495,2024,Slaný,71,493,216,277
2496,2024,Slaný,72,463,218,245
2497,2024,Slaný,73,481,198,283
2498,2024,Slaný,74,414,191,223
2499,2024,Slaný,75,366,151,215
2500,2024,Slaný,76,340,141,199
2501,2024,Slaný,77,298,131,167
2502,2024,Slaný,78,269,118,151
2503,2024,Slaný,79,234,79,155
2504,2024,Slaný,80,231,94,137
2505,2024,Slaný,81,167,64,103
2506,2024,Slaný,82,160,65,95
2507,2024,Slaný,83,148,44,104
2508,2024,Slaný,84,121,38,83
2509,2024,Slaný,85,128,43,85
2510,2024,Slaný,86,101,41,60
2511,2024,Slaný,87,100,35,65
2512,2024,Slaný,88,81,29,52
2513,2024,Slaný,89,68,14,54
2514,2024,Slaný,90,56,17,39
2515,2024,Slaný,91,52,14,38
2516,2024,Slaný,92,38,16,22
2517,2024,Slaný,93,18,3,15
2518,2024,Slaný,94,20,7,13
2519,2024,Slaný,95,10,2,8
2520,2024,Slaný,96,5,0,5
2521,2024,Slaný,97,7,3,4
2522,2024,Slaný,98,2,1,1
2523,2024,Slaný,99,3,2,1
2524,2024,Slaný,100,1,1,0
2525,2025,Vlašim,0,256,144,112
2526,2025,Vlašim,1,277,137,140
2527,2025,Vlašim,2,300,151,149
2528,2025,Vlašim,3,336,169,167
2529,2025,Vlašim,4,278,133,145
2530,2025,Vlašim,5,284,142,142
2531,2025,Vlašim,6,268,126,142
2532,2025,Vlašim,7,277,148,129
2533,2025,Vlašim,8,273,150,123
2534,2025,Vlašim,9,218,108,110
2535,2025,Vlašim,10,269,147,122
2536,2025,Vlašim,11,268,126,142
2537,2025,Vlašim,12,254,129,125
2538,2025,Vlašim,13,254,119,135
2539,2025,Vlašim,14,268,136,132
2540,2025,Vlašim,15,248,128,120
2541,2025,Vlašim,16,237,111,126
2542,2025,Vlašim,17,201,102,99
2543,2025,Vlašim,18,246,119,127
2544,2025,Vlašim,19,245,120,125
2545,2025,Vlašim,20,216,93,123
2546,2025,Vlašim,21,232,118,114
2547,2025,Vlašim,22,261,144,117
2548,2025,Vlašim,23,227,119,108
2549,2025,Vlašim,24,246,132,114
2550,2025,Vlašim,25,276,144,132
2551,2025,Vlašim,26,281,148,133
2552,2025,Vlašim,27,289,155,134
2553,2025,Vlašim,28,309,155,154
2554,2025,Vlašim,29,329,174,155
2555,2025,Vlašim,30,310,159,151
2556,2025,Vlašim,31,320,176,144
2557,2025,Vlašim,32,328,180,148
2558,2025,Vlašim,33,325,170,155
2559,2025,Vlašim,34,324,176,148
2560,2025,Vlašim,35,342,179,163
2561,2025,Vlašim,36,341,182,159
2562,2025,Vlašim,37,346,198,148
2563,2025,Vlašim,38,348,163,185
2564,2025,Vlašim,39,340,180,160
2565,2025,Vlašim,40,363,194,169
2566,2025,Vlašim,41,379,219,160
2567,2025,Vlašim,42,447,233,214
2568,2025,Vlašim,43,424,215,209
2569,2025,Vlašim,44,426,228,198
2570,2025,Vlašim,45,417,217,200
2571,2025,Vlašim,46,439,234,205
2572,2025,Vlašim,47,439,247,192
2573,2025,Vlašim,48,404,215,189
2574,2025,Vlašim,49,365,179,186
2575,2025,Vlašim,50,339,164,175
2576,2025,Vlašim,51,329,165,164
2577,2025,Vlašim,52,336,196,140
2578,2025,Vlašim,53,318,162,156
2579,2025,Vlašim,54,321,166,155
2580,2025,Vlašim,55,309,151,158
2581,2025,Vlašim,56,333,168,165
2582,2025,Vlašim,57,366,189,177
2583,2025,Vlašim,58,320,167,153
2584,2025,Vlašim,59,312,161,151
2585,2025,Vlašim,60,292,149,143
2586,2025,Vlašim,61,294,136,158
2587,2025,Vlašim,62,324,162,162
2588,2025,Vlašim,63,362,179,183
2589,2025,Vlašim,64,339,164,175
2590,2025,Vlašim,65,340,163,177
2591,2025,Vlašim,66,377,173,204
2592,2025,Vlašim,67,368,178,190
2593,2025,Vlašim,68,351,173,178
2594,2025,Vlašim,69,378,182,196
2595,2025,Vlašim,70,341,151,190
2596,2025,Vlašim,71,377,170,207
2597,2025,Vlašim,72,323,145,178
2598,2025,Vlašim,73,334,160,174
2599,2025,Vlašim,74,330,138,192
2600,2025,Vlašim,75,264,102,162
2601,2025,Vlašim,76,206,94,112
2602,2025,Vlašim,77,232,86,146
2603,2025,Vlašim,78,190,81,109
2604,2025,Vlašim,79,168,71,97
2605,2025,Vlašim,80,180,64,116
2606,2025,Vlašim,81,141,48,93
2607,2025,Vlašim,82,125,49,76
2608,2025,Vlašim,83,111,24,87
2609,2025,Vlašim,84,103,37,66
2610,2025,Vlašim,85,99,39,60
2611,2025,Vlašim,86,71,23,48
2612,2025,Vlašim,87,71,27,44
2613,2025,Vlašim,88,59,20,39
2614,2025,Vlašim,89,53,14,39
2615,2025,Vlašim,90,34,6,28
2616,2025,Vlašim,91,21,5,16
2617,2025,Vlašim,92,19,3,16
2618,2025,Vlašim,93,13,6,7
2619,2025,Vlašim,94,11,4,7
2620,2025,Vlašim,95,6,0,6
2621,2025,Vlašim,96,1,1,0
2622,2025,Vlašim,97,1,0,1
2623,2025,Vlašim,98,2,0,2
2624,2025,Vlašim,99,2,0,2
2625,2025,Vlašim,100,1,1,0
2626,2026,Votice,0,120,63,57
2627,2026,Votice,1,108,56,52
2628,2026,Votice,2,111,59,52
2629,2026,Votice,3,127,76,51
2630,2026,Votice,4,125,69,56
2631,2026,Votice,5,134,67,67
2632,2026,Votice,6,127,61,66
2633,2026,Votice,7,148,79,69
2634,2026,Votice,8,138,72,66
2635,2026,Votice,9,151,74,77
2636,2026,Votice,10,158,74,84
2637,2026,Votice,11,150,85,65
2638,2026,Votice,12,153,82,71
2639,2026,Votice,13,157,84,73
2640,2026,Votice,14,136,62,74
2641,2026,Votice,15,122,55,67
2642,2026,Votice,16,131,65,66
2643,2026,Votice,17,126,56,70
2644,2026,Votice,18,105,54,51
2645,2026,Votice,19,92,46,46
2646,2026,Votice,20,110,60,50
2647,2026,Votice,21,99,53,46
2648,2026,Votice,22,121,56,65
2649,2026,Votice,23,112,49,63
2650,2026,Votice,24,98,49,49
2651,2026,Votice,25,109,58,51
2652,2026,Votice,26,131,68,63
2653,2026,Votice,27,137,67,70
2654,2026,Votice,28,150,73,77
2655,2026,Votice,29,144,72,72
2656,2026,Votice,30,131,70,61
2657,2026,Votice,31,133,63,70
2658,2026,Votice,32,143,71,72
2659,2026,Votice,33,139,77,62
2660,2026,Votice,34,147,64,83
2661,2026,Votice,35,174,89,85
2662,2026,Votice,36,148,80,68
2663,2026,Votice,37,150,69,81
2664,2026,Votice,38,178,95,83
2665,2026,Votice,39,202,118,84
2666,2026,Votice,40,208,97,111
2667,2026,Votice,41,216,117,99
2668,2026,Votice,42,225,121,104
2669,2026,Votice,43,236,130,106
2670,2026,Votice,44,199,108,91
2671,2026,Votice,45,238,135,103
2672,2026,Votice,46,190,104,86
2673,2026,Votice,47,219,123,96
2674,2026,Votice,48,178,87,91
2675,2026,Votice,49,191,95,96
2676,2026,Votice,50,154,66,88
2677,2026,Votice,51,165,84,81
2678,2026,Votice,52,159,83,76
2679,2026,Votice,53,149,76,73
2680,2026,Votice,54,148,73,75
2681,2026,Votice,55,169,86,83
2682,2026,Votice,56,144,75,69
2683,2026,Votice,57,144,74,70
2684,2026,Votice,58,162,87,75
2685,2026,Votice,59,139,73,66
2686,2026,Votice,60,128,66,62
2687,2026,Votice,61,146,69,77
2688,2026,Votice,62,182,89,93
2689,2026,Votice,63,160,75,85
2690,2026,Votice,64,177,95,82
2691,2026,Votice,65,163,86,77
2692,2026,Votice,66,174,90,84
2693,2026,Votice,67,154,79,75
2694,2026,Votice,68,174,82,92
2695,2026,Votice,69,153,68,85
2696,2026,Votice,70,166,76,90
2697,2026,Votice,71,169,73,96
2698,2026,Votice,72,165,72,93
2699,2026,Votice,73,152,72,80
2700,2026,Votice,74,156,64,92
2701,2026,Votice,75,117,58,59
2702,2026,Votice,76,109,53,56
2703,2026,Votice,77,96,43,53
2704,2026,Votice,78,92,44,48
2705,2026,Votice,79,67,18,49
2706,2026,Votice,80,83,33,50
2707,2026,Votice,81,56,20,36
2708,2026,Votice,82,64,21,43
2709,2026,Votice,83,36,13,23
2710,2026,Votice,84,42,16,26
2711,2026,Votice,85,45,13,32
2712,2026,Votice,86,35,4,31
2713,2026,Votice,87,37,9,28
2714,2026,Votice,88,38,11,27
2715,2026,Votice,89,23,7,16
2716,2026,Votice,90,21,7,14
2717,2026,Votice,91,15,3,12
2718,2026,Votice,92,23,5,18
2719,2026,Votice,93,11,2,9
2720,2026,Votice,94,8,1,7
2721,2026,Votice,95,5,2,3
2722,2026,Votice,96,4,0,4
2723,2026,Votice,97,2,0,2
2724,2026,Votice,98,2,0,2
2725,2026,Votice,99,1,0,1
2726,2026,Votice,100,1,0,1
2727,3101,Blatná,0,113,63,50
2728,3101,Blatná,1,131,66,65
2729,3101,Blatná,2,121,70,51
2730,3101,Blatná,3,132,66,66
2731,3101,Blatná,4,123,61,62
2732,3101,Blatná,5,133,69,64
2733,3101,Blatná,6,133,64,69
2734,3101,Blatná,7,116,57,59
2735,3101,Blatná,8,129,69,60
2736,3101,Blatná,9,112,65,47
2737,3101,Blatná,10,147,85,62
2738,3101,Blatná,11,143,74,69
2739,3101,Blatná,12,167,94,73
2740,3101,Blatná,13,133,77,56
2741,3101,Blatná,14,137,80,57
2742,3101,Blatná,15,112,60,52
2743,3101,Blatná,16,133,69,64
2744,3101,Blatná,17,127,67,60
2745,3101,Blatná,18,119,61,58
2746,3101,Blatná,19,134,75,59
2747,3101,Blatná,20,109,56,53
2748,3101,Blatná,21,126,73,53
2749,3101,Blatná,22,115,62,53
2750,3101,Blatná,23,117,66,51
2751,3101,Blatná,24,114,55,59
2752,3101,Blatná,25,137,72,65
2753,3101,Blatná,26,155,88,67
2754,3101,Blatná,27,166,82,84
2755,3101,Blatná,28,158,87,71
2756,3101,Blatná,29,161,78,83
2757,3101,Blatná,30,192,106,86
2758,3101,Blatná,31,167,87,80
2759,3101,Blatná,32,161,82,79
2760,3101,Blatná,33,179,88,91
2761,3101,Blatná,34,149,85,64
2762,3101,Blatná,35,155,87,68
2763,3101,Blatná,36,177,104,73
2764,3101,Blatná,37,166,86,80
2765,3101,Blatná,38,167,86,81
2766,3101,Blatná,39,193,95,98
2767,3101,Blatná,40,225,114,111
2768,3101,Blatná,41,206,112,94
2769,3101,Blatná,42,210,97,113
2770,3101,Blatná,43,242,130,112
2771,3101,Blatná,44,211,111,100
2772,3101,Blatná,45,228,108,120
2773,3101,Blatná,46,237,129,108
2774,3101,Blatná,47,229,125,104
2775,3101,Blatná,48,189,93,96
2776,3101,Blatná,49,190,97,93
2777,3101,Blatná,50,178,95,83
2778,3101,Blatná,51,190,97,93
2779,3101,Blatná,52,169,79,90
2780,3101,Blatná,53,163,93,70
2781,3101,Blatná,54,187,83,104
2782,3101,Blatná,55,176,86,90
2783,3101,Blatná,56,164,77,87
2784,3101,Blatná,57,169,86,83
2785,3101,Blatná,58,167,88,79
2786,3101,Blatná,59,156,61,95
2787,3101,Blatná,60,161,75,86
2788,3101,Blatná,61,180,99,81
2789,3101,Blatná,62,183,88,95
2790,3101,Blatná,63,185,89,96
2791,3101,Blatná,64,197,97,100
2792,3101,Blatná,65,196,98,98
2793,3101,Blatná,66,208,94,114
2794,3101,Blatná,67,183,84,99
2795,3101,Blatná,68,211,105,106
2796,3101,Blatná,69,180,88,92
2797,3101,Blatná,70,168,65,103
2798,3101,Blatná,71,171,80,91
2799,3101,Blatná,72,176,80,96
2800,3101,Blatná,73,201,83,118
2801,3101,Blatná,74,186,84,102
2802,3101,Blatná,75,153,67,86
2803,3101,Blatná,76,140,66,74
2804,3101,Blatná,77,135,57,78
2805,3101,Blatná,78,107,51,56
2806,3101,Blatná,79,91,36,55
2807,3101,Blatná,80,84,30,54
2808,3101,Blatná,81,82,34,48
2809,3101,Blatná,82,76,30,46
2810,3101,Blatná,83,72,31,41
2811,3101,Blatná,84,57,15,42
2812,3101,Blatná,85,47,16,31
2813,3101,Blatná,86,39,14,25
2814,3101,Blatná,87,41,13,28
2815,3101,Blatná,88,33,12,21
2816,3101,Blatná,89,32,10,22
2817,3101,Blatná,90,21,5,16
2818,3101,Blatná,91,21,6,15
2819,3101,Blatná,92,13,3,10
2820,3101,Blatná,93,12,4,8
2821,3101,Blatná,94,5,0,5
2822,3101,Blatná,95,7,3,4
2823,3101,Blatná,96,1,1,0
2824,3101,Blatná,97,1,0,1
2825,3101,Blatná,98,1,0,1
2826,3101,Blatná,99,1,0,1
2827,3101,Blatná,100,1,0,1
2828,3102,České Budějovice,0,1855,979,876
2829,3102,České Budějovice,1,1826,955,871
2830,3102,České Budějovice,2,1836,918,918
2831,3102,České Budějovice,3,1861,955,906
2832,3102,České Budějovice,4,1891,951,940
2833,3102,České Budějovice,5,1847,968,879
2834,3102,České Budějovice,6,1816,923,893
2835,3102,České Budějovice,7,1721,902,819
2836,3102,České Budějovice,8,1882,967,915
2837,3102,České Budějovice,9,1702,862,840
2838,3102,České Budějovice,10,1940,969,971
2839,3102,České Budějovice,11,1863,937,926
2840,3102,České Budějovice,12,1922,982,940
2841,3102,České Budějovice,13,1848,935,913
2842,3102,České Budějovice,14,1667,839,828
2843,3102,České Budějovice,15,1577,813,764
2844,3102,České Budějovice,16,1510,748,762
2845,3102,České Budějovice,17,1413,732,681
2846,3102,České Budějovice,18,1396,741,655
2847,3102,České Budějovice,19,1382,742,640
2848,3102,České Budějovice,20,1410,722,688
2849,3102,České Budějovice,21,1343,690,653
2850,3102,České Budějovice,22,1377,706,671
2851,3102,České Budějovice,23,1399,709,690
2852,3102,České Budějovice,24,1341,670,671
2853,3102,České Budějovice,25,1533,779,754
2854,3102,České Budějovice,26,1694,865,829
2855,3102,České Budějovice,27,1954,989,965
2856,3102,České Budějovice,28,2105,1049,1056
2857,3102,České Budějovice,29,2168,1104,1064
2858,3102,České Budějovice,30,2274,1147,1127
2859,3102,České Budějovice,31,2169,1067,1102
2860,3102,České Budějovice,32,2309,1156,1153
2861,3102,České Budějovice,33,2295,1179,1116
2862,3102,České Budějovice,34,2269,1131,1138
2863,3102,České Budějovice,35,2278,1161,1117
2864,3102,České Budějovice,36,2385,1188,1197
2865,3102,České Budějovice,37,2243,1121,1122
2866,3102,České Budějovice,38,2216,1104,1112
2867,3102,České Budějovice,39,2311,1171,1140
2868,3102,České Budějovice,40,2459,1236,1223
2869,3102,České Budějovice,41,2747,1397,1350
2870,3102,České Budějovice,42,2907,1462,1445
2871,3102,České Budějovice,43,2772,1418,1354
2872,3102,České Budějovice,44,2886,1443,1443
2873,3102,České Budějovice,45,2845,1438,1407
2874,3102,České Budějovice,46,2888,1425,1463
2875,3102,České Budějovice,47,2778,1322,1456
2876,3102,České Budějovice,48,2431,1211,1220
2877,3102,České Budějovice,49,2247,1088,1159
2878,3102,České Budějovice,50,2192,1077,1115
2879,3102,České Budějovice,51,2045,1024,1021
2880,3102,České Budějovice,52,1998,963,1035
2881,3102,České Budějovice,53,2003,984,1019
2882,3102,České Budějovice,54,2128,1058,1070
2883,3102,České Budějovice,55,2122,1057,1065
2884,3102,České Budějovice,56,2235,1115,1120
2885,3102,České Budějovice,57,2094,1041,1053
2886,3102,České Budějovice,58,1917,915,1002
2887,3102,České Budějovice,59,1833,931,902
2888,3102,České Budějovice,60,1802,910,892
2889,3102,České Budějovice,61,1724,836,888
2890,3102,České Budějovice,62,1799,882,917
2891,3102,České Budějovice,63,2088,986,1102
2892,3102,České Budějovice,64,2100,1036,1064
2893,3102,České Budějovice,65,2042,965,1077
2894,3102,České Budějovice,66,2025,972,1053
2895,3102,České Budějovice,67,1985,943,1042
2896,3102,České Budějovice,68,1987,943,1044
2897,3102,České Budějovice,69,2012,936,1076
2898,3102,České Budějovice,70,1820,824,996
2899,3102,České Budějovice,71,1747,792,955
2900,3102,České Budějovice,72,1774,781,993
2901,3102,České Budějovice,73,1848,828,1020
2902,3102,České Budějovice,74,1852,783,1069
2903,3102,České Budějovice,75,1397,573,824
2904,3102,České Budějovice,76,1387,591,796
2905,3102,České Budějovice,77,1355,548,807
2906,3102,České Budějovice,78,1159,501,658
2907,3102,České Budějovice,79,1035,422,613
2908,3102,České Budějovice,80,944,366,578
2909,3102,České Budějovice,81,770,292,478
2910,3102,České Budějovice,82,683,266,417
2911,3102,České Budějovice,83,612,236,376
2912,3102,České Budějovice,84,555,195,360
2913,3102,České Budějovice,85,560,174,386
2914,3102,České Budějovice,86,517,160,357
2915,3102,České Budějovice,87,474,165,309
2916,3102,České Budějovice,88,400,136,264
2917,3102,České Budějovice,89,347,127,220
2918,3102,České Budějovice,90,272,80,192
2919,3102,České Budějovice,91,214,67,147
2920,3102,České Budějovice,92,150,44,106
2921,3102,České Budějovice,93,113,32,81
2922,3102,České Budějovice,94,89,28,61
2923,3102,České Budějovice,95,51,11,40
2924,3102,České Budějovice,96,39,8,31
2925,3102,České Budějovice,97,23,3,20
2926,3102,České Budějovice,98,22,4,18
2927,3102,České Budějovice,99,14,2,12
2928,3102,České Budějovice,100,18,3,15
2929,3103,Český Krumlov,0,398,194,204
2930,3103,Český Krumlov,1,406,202,204
2931,3103,Český Krumlov,2,492,245,247
2932,3103,Český Krumlov,3,437,213,224
2933,3103,Český Krumlov,4,465,252,213
2934,3103,Český Krumlov,5,425,228,197
2935,3103,Český Krumlov,6,423,233,190
2936,3103,Český Krumlov,7,428,235,193
2937,3103,Český Krumlov,8,434,224,210
2938,3103,Český Krumlov,9,445,223,222
2939,3103,Český Krumlov,10,473,238,235
2940,3103,Český Krumlov,11,497,251,246
2941,3103,Český Krumlov,12,529,256,273
2942,3103,Český Krumlov,13,565,299,266
2943,3103,Český Krumlov,14,467,247,220
2944,3103,Český Krumlov,15,450,236,214
2945,3103,Český Krumlov,16,409,213,196
2946,3103,Český Krumlov,17,411,194,217
2947,3103,Český Krumlov,18,461,236,225
2948,3103,Český Krumlov,19,369,187,182
2949,3103,Český Krumlov,20,393,194,199
2950,3103,Český Krumlov,21,392,195,197
2951,3103,Český Krumlov,22,374,188,186
2952,3103,Český Krumlov,23,399,210,189
2953,3103,Český Krumlov,24,385,196,189
2954,3103,Český Krumlov,25,393,199,194
2955,3103,Český Krumlov,26,470,243,227
2956,3103,Český Krumlov,27,510,267,243
2957,3103,Český Krumlov,28,488,251,237
2958,3103,Český Krumlov,29,540,267,273
2959,3103,Český Krumlov,30,490,280,210
2960,3103,Český Krumlov,31,542,282,260
2961,3103,Český Krumlov,32,562,292,270
2962,3103,Český Krumlov,33,550,272,278
2963,3103,Český Krumlov,34,514,248,266
2964,3103,Český Krumlov,35,529,277,252
2965,3103,Český Krumlov,36,542,271,271
2966,3103,Český Krumlov,37,507,255,252
2967,3103,Český Krumlov,38,510,257,253
2968,3103,Český Krumlov,39,570,284,286
2969,3103,Český Krumlov,40,579,295,284
2970,3103,Český Krumlov,41,696,341,355
2971,3103,Český Krumlov,42,679,345,334
2972,3103,Český Krumlov,43,707,373,334
2973,3103,Český Krumlov,44,705,374,331
2974,3103,Český Krumlov,45,721,366,355
2975,3103,Český Krumlov,46,680,330,350
2976,3103,Český Krumlov,47,682,338,344
2977,3103,Český Krumlov,48,715,352,363
2978,3103,Český Krumlov,49,594,313,281
2979,3103,Český Krumlov,50,606,320,286
2980,3103,Český Krumlov,51,564,305,259
2981,3103,Český Krumlov,52,541,294,247
2982,3103,Český Krumlov,53,508,270,238
2983,3103,Český Krumlov,54,558,270,288
2984,3103,Český Krumlov,55,552,285,267
2985,3103,Český Krumlov,56,585,308,277
2986,3103,Český Krumlov,57,544,297,247
2987,3103,Český Krumlov,58,460,247,213
2988,3103,Český Krumlov,59,460,232,228
2989,3103,Český Krumlov,60,487,238,249
2990,3103,Český Krumlov,61,440,216,224
2991,3103,Český Krumlov,62,501,248,253
2992,3103,Český Krumlov,63,566,282,284
2993,3103,Český Krumlov,64,548,266,282
2994,3103,Český Krumlov,65,571,285,286
2995,3103,Český Krumlov,66,544,277,267
2996,3103,Český Krumlov,67,515,241,274
2997,3103,Český Krumlov,68,543,259,284
2998,3103,Český Krumlov,69,555,263,292
2999,3103,Český Krumlov,70,477,234,243
3000,3103,Český Krumlov,71,538,262,276
3001,3103,Český Krumlov,72,529,236,293
3002,3103,Český Krumlov,73,489,205,284
3003,3103,Český Krumlov,74,462,222,240
3004,3103,Český Krumlov,75,336,156,180
3005,3103,Český Krumlov,76,331,135,196
3006,3103,Český Krumlov,77,283,112,171
3007,3103,Český Krumlov,78,262,123,139
3008,3103,Český Krumlov,79,248,110,138
3009,3103,Český Krumlov,80,218,93,125
3010,3103,Český Krumlov,81,182,77,105
3011,3103,Český Krumlov,82,142,54,88
3012,3103,Český Krumlov,83,136,49,87
3013,3103,Český Krumlov,84,120,41,79
3014,3103,Český Krumlov,85,111,45,66
3015,3103,Český Krumlov,86,106,33,73
3016,3103,Český Krumlov,87,85,30,55
3017,3103,Český Krumlov,88,68,30,38
3018,3103,Český Krumlov,89,64,20,44
3019,3103,Český Krumlov,90,58,18,40
3020,3103,Český Krumlov,91,40,10,30
3021,3103,Český Krumlov,92,36,12,24
3022,3103,Český Krumlov,93,23,3,20
3023,3103,Český Krumlov,94,5,2,3
3024,3103,Český Krumlov,95,15,5,10
3025,3103,Český Krumlov,96,14,3,11
3026,3103,Český Krumlov,97,7,4,3
3027,3103,Český Krumlov,98,3,2,1
3028,3103,Český Krumlov,99,2,0,2
3029,3103,Český Krumlov,100,7,2,5
3030,3104,Dačice,0,179,83,96
3031,3104,Dačice,1,175,71,104
3032,3104,Dačice,2,179,82,97
3033,3104,Dačice,3,173,90,83
3034,3104,Dačice,4,172,83,89
3035,3104,Dačice,5,194,105,89
3036,3104,Dačice,6,181,90,91
3037,3104,Dačice,7,145,62,83
3038,3104,Dačice,8,202,99,103
3039,3104,Dačice,9,173,88,85
3040,3104,Dačice,10,216,116,100
3041,3104,Dačice,11,194,102,92
3042,3104,Dačice,12,190,92,98
3043,3104,Dačice,13,179,95,84
3044,3104,Dačice,14,193,109,84
3045,3104,Dačice,15,183,93,90
3046,3104,Dačice,16,159,83,76
3047,3104,Dačice,17,197,101,96
3048,3104,Dačice,18,191,106,85
3049,3104,Dačice,19,187,99,88
3050,3104,Dačice,20,178,107,71
3051,3104,Dačice,21,183,88,95
3052,3104,Dačice,22,199,96,103
3053,3104,Dačice,23,187,97,90
3054,3104,Dačice,24,177,92,85
3055,3104,Dačice,25,180,101,79
3056,3104,Dačice,26,220,112,108
3057,3104,Dačice,27,208,110,98
3058,3104,Dačice,28,223,125,98
3059,3104,Dačice,29,226,126,100
3060,3104,Dačice,30,210,111,99
3061,3104,Dačice,31,231,122,109
3062,3104,Dačice,32,224,124,100
3063,3104,Dačice,33,203,125,78
3064,3104,Dačice,34,207,101,106
3065,3104,Dačice,35,244,130,114
3066,3104,Dačice,36,201,112,89
3067,3104,Dačice,37,239,133,106
3068,3104,Dačice,38,240,136,104
3069,3104,Dačice,39,244,115,129
3070,3104,Dačice,40,263,142,121
3071,3104,Dačice,41,273,151,122
3072,3104,Dačice,42,310,160,150
3073,3104,Dačice,43,293,138,155
3074,3104,Dačice,44,307,169,138
3075,3104,Dačice,45,303,162,141
3076,3104,Dačice,46,312,154,158
3077,3104,Dačice,47,307,165,142
3078,3104,Dačice,48,281,137,144
3079,3104,Dačice,49,246,135,111
3080,3104,Dačice,50,253,130,123
3081,3104,Dačice,51,262,126,136
3082,3104,Dačice,52,246,130,116
3083,3104,Dačice,53,249,136,113
3084,3104,Dačice,54,220,113,107
3085,3104,Dačice,55,255,126,129
3086,3104,Dačice,56,265,142,123
3087,3104,Dačice,57,274,145,129
3088,3104,Dačice,58,205,109,96
3089,3104,Dačice,59,236,106,130
3090,3104,Dačice,60,282,136,146
3091,3104,Dačice,61,252,120,132
3092,3104,Dačice,62,276,159,117
3093,3104,Dačice,63,276,140,136
3094,3104,Dačice,64,299,163,136
3095,3104,Dačice,65,288,133,155
3096,3104,Dačice,66,270,131,139
3097,3104,Dačice,67,244,115,129
3098,3104,Dačice,68,227,113,114
3099,3104,Dačice,69,271,120,151
3100,3104,Dačice,70,259,133,126
3101,3104,Dačice,71,225,112,113
3102,3104,Dačice,72,235,106,129
3103,3104,Dačice,73,272,126,146
3104,3104,Dačice,74,212,89,123
3105,3104,Dačice,75,160,80,80
3106,3104,Dačice,76,174,62,112
3107,3104,Dačice,77,143,54,89
3108,3104,Dačice,78,133,57,76
3109,3104,Dačice,79,136,53,83
3110,3104,Dačice,80,109,39,70
3111,3104,Dačice,81,92,30,62
3112,3104,Dačice,82,71,26,45
3113,3104,Dačice,83,74,25,49
3114,3104,Dačice,84,76,24,52
3115,3104,Dačice,85,81,31,50
3116,3104,Dačice,86,56,20,36
3117,3104,Dačice,87,54,14,40
3118,3104,Dačice,88,36,7,29
3119,3104,Dačice,89,40,13,27
3120,3104,Dačice,90,30,7,23
3121,3104,Dačice,91,25,3,22
3122,3104,Dačice,92,12,1,11
3123,3104,Dačice,93,8,2,6
3124,3104,Dačice,94,7,0,7
3125,3104,Dačice,95,6,1,5
3126,3104,Dačice,96,5,0,5
3127,3104,Dačice,97,3,0,3
3128,3104,Dačice,98,2,0,2
3129,3104,Dačice,99,2,1,1
3130,3104,Dačice,100,3,0,3
3131,3105,Jindřichův Hradec,0,471,241,230
3132,3105,Jindřichův Hradec,1,511,270,241
3133,3105,Jindřichův Hradec,2,446,239,207
3134,3105,Jindřichův Hradec,3,482,248,234
3135,3105,Jindřichův Hradec,4,449,225,224
3136,3105,Jindřichův Hradec,5,470,242,228
3137,3105,Jindřichův Hradec,6,473,246,227
3138,3105,Jindřichův Hradec,7,448,220,228
3139,3105,Jindřichův Hradec,8,443,233,210
3140,3105,Jindřichův Hradec,9,444,248,196
3141,3105,Jindřichův Hradec,10,474,213,261
3142,3105,Jindřichův Hradec,11,519,274,245
3143,3105,Jindřichův Hradec,12,557,287,270
3144,3105,Jindřichův Hradec,13,551,274,277
3145,3105,Jindřichův Hradec,14,471,237,234
3146,3105,Jindřichův Hradec,15,471,229,242
3147,3105,Jindřichův Hradec,16,445,228,217
3148,3105,Jindřichův Hradec,17,454,222,232
3149,3105,Jindřichův Hradec,18,462,231,231
3150,3105,Jindřichův Hradec,19,481,239,242
3151,3105,Jindřichův Hradec,20,434,228,206
3152,3105,Jindřichův Hradec,21,417,211,206
3153,3105,Jindřichův Hradec,22,434,223,211
3154,3105,Jindřichův Hradec,23,445,232,213
3155,3105,Jindřichův Hradec,24,452,225,227
3156,3105,Jindřichův Hradec,25,498,238,260
3157,3105,Jindřichův Hradec,26,533,283,250
3158,3105,Jindřichův Hradec,27,633,333,300
3159,3105,Jindřichův Hradec,28,578,302,276
3160,3105,Jindřichův Hradec,29,582,313,269
3161,3105,Jindřichův Hradec,30,548,284,264
3162,3105,Jindřichův Hradec,31,529,271,258
3163,3105,Jindřichův Hradec,32,542,288,254
3164,3105,Jindřichův Hradec,33,559,296,263
3165,3105,Jindřichův Hradec,34,529,268,261
3166,3105,Jindřichův Hradec,35,492,273,219
3167,3105,Jindřichův Hradec,36,596,292,304
3168,3105,Jindřichův Hradec,37,573,304,269
3169,3105,Jindřichův Hradec,38,600,307,293
3170,3105,Jindřichův Hradec,39,613,299,314
3171,3105,Jindřichův Hradec,40,679,358,321
3172,3105,Jindřichův Hradec,41,752,386,366
3173,3105,Jindřichův Hradec,42,748,368,380
3174,3105,Jindřichův Hradec,43,755,391,364
3175,3105,Jindřichův Hradec,44,800,420,380
3176,3105,Jindřichův Hradec,45,821,406,415
3177,3105,Jindřichův Hradec,46,844,418,426
3178,3105,Jindřichův Hradec,47,814,419,395
3179,3105,Jindřichův Hradec,48,717,361,356
3180,3105,Jindřichův Hradec,49,650,325,325
3181,3105,Jindřichův Hradec,50,704,357,347
3182,3105,Jindřichův Hradec,51,625,311,314
3183,3105,Jindřichův Hradec,52,590,297,293
3184,3105,Jindřichův Hradec,53,613,323,290
3185,3105,Jindřichův Hradec,54,573,292,281
3186,3105,Jindřichův Hradec,55,552,279,273
3187,3105,Jindřichův Hradec,56,567,276,291
3188,3105,Jindřichův Hradec,57,558,290,268
3189,3105,Jindřichův Hradec,58,579,286,293
3190,3105,Jindřichův Hradec,59,549,251,298
3191,3105,Jindřichův Hradec,60,493,242,251
3192,3105,Jindřichův Hradec,61,547,261,286
3193,3105,Jindřichův Hradec,62,619,282,337
3194,3105,Jindřichův Hradec,63,682,346,336
3195,3105,Jindřichův Hradec,64,686,339,347
3196,3105,Jindřichův Hradec,65,689,340,349
3197,3105,Jindřichův Hradec,66,683,351,332
3198,3105,Jindřichův Hradec,67,676,311,365
3199,3105,Jindřichův Hradec,68,646,310,336
3200,3105,Jindřichův Hradec,69,649,294,355
3201,3105,Jindřichův Hradec,70,678,283,395
3202,3105,Jindřichův Hradec,71,640,286,354
3203,3105,Jindřichův Hradec,72,631,287,344
3204,3105,Jindřichův Hradec,73,655,296,359
3205,3105,Jindřichův Hradec,74,593,267,326
3206,3105,Jindřichův Hradec,75,419,187,232
3207,3105,Jindřichův Hradec,76,388,174,214
3208,3105,Jindřichův Hradec,77,389,178,211
3209,3105,Jindřichův Hradec,78,315,133,182
3210,3105,Jindřichův Hradec,79,271,106,165
3211,3105,Jindřichův Hradec,80,291,125,166
3212,3105,Jindřichův Hradec,81,241,94,147
3213,3105,Jindřichův Hradec,82,194,69,125
3214,3105,Jindřichův Hradec,83,194,59,135
3215,3105,Jindřichův Hradec,84,185,54,131
3216,3105,Jindřichův Hradec,85,140,34,106
3217,3105,Jindřichův Hradec,86,115,39,76
3218,3105,Jindřichův Hradec,87,121,43,78
3219,3105,Jindřichův Hradec,88,133,44,89
3220,3105,Jindřichův Hradec,89,104,26,78
3221,3105,Jindřichův Hradec,90,79,26,53
3222,3105,Jindřichův Hradec,91,47,12,35
3223,3105,Jindřichův Hradec,92,40,12,28
3224,3105,Jindřichův Hradec,93,27,11,16
3225,3105,Jindřichův Hradec,94,26,5,21
3226,3105,Jindřichův Hradec,95,19,5,14
3227,3105,Jindřichův Hradec,96,13,2,11
3228,3105,Jindřichův Hradec,97,4,0,4
3229,3105,Jindřichův Hradec,98,8,1,7
3230,3105,Jindřichův Hradec,99,3,0,3
3231,3105,Jindřichův Hradec,100,6,2,4
3232,3106,Kaplice,0,229,122,107
3233,3106,Kaplice,1,215,108,107
3234,3106,Kaplice,2,212,117,95
3235,3106,Kaplice,3,204,103,101
3236,3106,Kaplice,4,178,89,89
3237,3106,Kaplice,5,236,127,109
3238,3106,Kaplice,6,201,112,89
3239,3106,Kaplice,7,190,117,73
3240,3106,Kaplice,8,203,107,96
3241,3106,Kaplice,9,191,105,86
3242,3106,Kaplice,10,208,104,104
3243,3106,Kaplice,11,250,131,119
3244,3106,Kaplice,12,226,124,102
3245,3106,Kaplice,13,210,99,111
3246,3106,Kaplice,14,223,113,110
3247,3106,Kaplice,15,206,114,92
3248,3106,Kaplice,16,199,97,102
3249,3106,Kaplice,17,186,106,80
3250,3106,Kaplice,18,184,112,72
3251,3106,Kaplice,19,188,92,96
3252,3106,Kaplice,20,175,99,76
3253,3106,Kaplice,21,208,125,83
3254,3106,Kaplice,22,188,113,75
3255,3106,Kaplice,23,227,129,98
3256,3106,Kaplice,24,184,94,90
3257,3106,Kaplice,25,219,122,97
3258,3106,Kaplice,26,233,125,108
3259,3106,Kaplice,27,271,154,117
3260,3106,Kaplice,28,258,138,120
3261,3106,Kaplice,29,255,131,124
3262,3106,Kaplice,30,260,159,101
3263,3106,Kaplice,31,257,124,133
3264,3106,Kaplice,32,267,149,118
3265,3106,Kaplice,33,272,140,132
3266,3106,Kaplice,34,260,153,107
3267,3106,Kaplice,35,259,133,126
3268,3106,Kaplice,36,328,188,140
3269,3106,Kaplice,37,300,146,154
3270,3106,Kaplice,38,318,177,141
3271,3106,Kaplice,39,305,175,130
3272,3106,Kaplice,40,296,171,125
3273,3106,Kaplice,41,326,176,150
3274,3106,Kaplice,42,324,166,158
3275,3106,Kaplice,43,323,186,137
3276,3106,Kaplice,44,357,189,168
3277,3106,Kaplice,45,345,169,176
3278,3106,Kaplice,46,348,170,178
3279,3106,Kaplice,47,367,181,186
3280,3106,Kaplice,48,290,142,148
3281,3106,Kaplice,49,272,142,130
3282,3106,Kaplice,50,280,136,144
3283,3106,Kaplice,51,265,135,130
3284,3106,Kaplice,52,245,135,110
3285,3106,Kaplice,53,250,129,121
3286,3106,Kaplice,54,214,117,97
3287,3106,Kaplice,55,265,134,131
3288,3106,Kaplice,56,279,131,148
3289,3106,Kaplice,57,280,146,134
3290,3106,Kaplice,58,235,126,109
3291,3106,Kaplice,59,256,134,122
3292,3106,Kaplice,60,260,126,134
3293,3106,Kaplice,61,272,126,146
3294,3106,Kaplice,62,261,139,122
3295,3106,Kaplice,63,282,151,131
3296,3106,Kaplice,64,266,125,141
3297,3106,Kaplice,65,254,140,114
3298,3106,Kaplice,66,274,145,129
3299,3106,Kaplice,67,245,104,141
3300,3106,Kaplice,68,223,105,118
3301,3106,Kaplice,69,259,112,147
3302,3106,Kaplice,70,234,116,118
3303,3106,Kaplice,71,224,107,117
3304,3106,Kaplice,72,208,105,103
3305,3106,Kaplice,73,200,99,101
3306,3106,Kaplice,74,207,94,113
3307,3106,Kaplice,75,127,64,63
3308,3106,Kaplice,76,123,53,70
3309,3106,Kaplice,77,117,47,70
3310,3106,Kaplice,78,114,39,75
3311,3106,Kaplice,79,90,35,55
3312,3106,Kaplice,80,102,41,61
3313,3106,Kaplice,81,83,30,53
3314,3106,Kaplice,82,76,22,54
3315,3106,Kaplice,83,61,20,41
3316,3106,Kaplice,84,58,22,36
3317,3106,Kaplice,85,40,15,25
3318,3106,Kaplice,86,44,23,21
3319,3106,Kaplice,87,34,10,24
3320,3106,Kaplice,88,34,12,22
3321,3106,Kaplice,89,33,14,19
3322,3106,Kaplice,90,15,6,9
3323,3106,Kaplice,91,15,5,10
3324,3106,Kaplice,92,13,4,9
3325,3106,Kaplice,93,12,4,8
3326,3106,Kaplice,94,5,2,3
3327,3106,Kaplice,95,3,0,3
3328,3106,Kaplice,96,3,1,2
3329,3106,Kaplice,97,1,0,1
3330,3106,Kaplice,98,1,0,1
3331,3106,Kaplice,99,0,0,0
3332,3106,Kaplice,100,0,0,0
3333,3107,Milevsko,0,159,84,75
3334,3107,Milevsko,1,177,91,86
3335,3107,Milevsko,2,155,85,70
3336,3107,Milevsko,3,162,75,87
3337,3107,Milevsko,4,144,75,69
3338,3107,Milevsko,5,161,85,76
3339,3107,Milevsko,6,165,89,76
3340,3107,Milevsko,7,189,100,89
3341,3107,Milevsko,8,156,78,78
3342,3107,Milevsko,9,177,83,94
3343,3107,Milevsko,10,173,90,83
3344,3107,Milevsko,11,203,103,100
3345,3107,Milevsko,12,187,92,95
3346,3107,Milevsko,13,158,71,87
3347,3107,Milevsko,14,153,76,77
3348,3107,Milevsko,15,160,75,85
3349,3107,Milevsko,16,140,65,75
3350,3107,Milevsko,17,177,95,82
3351,3107,Milevsko,18,161,86,75
3352,3107,Milevsko,19,146,75,71
3353,3107,Milevsko,20,151,67,84
3354,3107,Milevsko,21,152,88,64
3355,3107,Milevsko,22,168,84,84
3356,3107,Milevsko,23,171,98,73
3357,3107,Milevsko,24,167,91,76
3358,3107,Milevsko,25,183,97,86
3359,3107,Milevsko,26,195,96,99
3360,3107,Milevsko,27,210,110,100
3361,3107,Milevsko,28,197,104,93
3362,3107,Milevsko,29,206,118,88
3363,3107,Milevsko,30,237,122,115
3364,3107,Milevsko,31,218,98,120
3365,3107,Milevsko,32,228,132,96
3366,3107,Milevsko,33,199,93,106
3367,3107,Milevsko,34,212,114,98
3368,3107,Milevsko,35,210,119,91
3369,3107,Milevsko,36,217,116,101
3370,3107,Milevsko,37,209,118,91
3371,3107,Milevsko,38,239,118,121
3372,3107,Milevsko,39,212,114,98
3373,3107,Milevsko,40,231,116,115
3374,3107,Milevsko,41,243,123,120
3375,3107,Milevsko,42,263,145,118
3376,3107,Milevsko,43,301,164,137
3377,3107,Milevsko,44,277,149,128
3378,3107,Milevsko,45,292,154,138
3379,3107,Milevsko,46,303,157,146
3380,3107,Milevsko,47,286,151,135
3381,3107,Milevsko,48,289,143,146
3382,3107,Milevsko,49,238,112,126
3383,3107,Milevsko,50,249,128,121
3384,3107,Milevsko,51,253,127,126
3385,3107,Milevsko,52,239,113,126
3386,3107,Milevsko,53,257,130,127
3387,3107,Milevsko,54,251,138,113
3388,3107,Milevsko,55,269,142,127
3389,3107,Milevsko,56,266,139,127
3390,3107,Milevsko,57,279,153,126
3391,3107,Milevsko,58,228,119,109
3392,3107,Milevsko,59,225,110,115
3393,3107,Milevsko,60,207,105,102
3394,3107,Milevsko,61,226,112,114
3395,3107,Milevsko,62,252,134,118
3396,3107,Milevsko,63,256,121,135
3397,3107,Milevsko,64,234,104,130
3398,3107,Milevsko,65,272,145,127
3399,3107,Milevsko,66,271,138,133
3400,3107,Milevsko,67,265,125,140
3401,3107,Milevsko,68,280,131,149
3402,3107,Milevsko,69,235,106,129
3403,3107,Milevsko,70,255,120,135
3404,3107,Milevsko,71,209,95,114
3405,3107,Milevsko,72,248,126,122
3406,3107,Milevsko,73,256,107,149
3407,3107,Milevsko,74,265,127,138
3408,3107,Milevsko,75,199,72,127
3409,3107,Milevsko,76,175,68,107
3410,3107,Milevsko,77,177,81,96
3411,3107,Milevsko,78,172,75,97
3412,3107,Milevsko,79,130,55,75
3413,3107,Milevsko,80,152,63,89
3414,3107,Milevsko,81,114,38,76
3415,3107,Milevsko,82,110,45,65
3416,3107,Milevsko,83,108,47,61
3417,3107,Milevsko,84,129,47,82
3418,3107,Milevsko,85,88,29,59
3419,3107,Milevsko,86,72,28,44
3420,3107,Milevsko,87,52,15,37
3421,3107,Milevsko,88,50,11,39
3422,3107,Milevsko,89,49,13,36
3423,3107,Milevsko,90,40,10,30
3424,3107,Milevsko,91,26,9,17
3425,3107,Milevsko,92,25,4,21
3426,3107,Milevsko,93,14,3,11
3427,3107,Milevsko,94,10,1,9
3428,3107,Milevsko,95,8,3,5
3429,3107,Milevsko,96,10,3,7
3430,3107,Milevsko,97,5,2,3
3431,3107,Milevsko,98,3,1,2
3432,3107,Milevsko,99,0,0,0
3433,3107,Milevsko,100,3,1,2
3434,3108,Písek,0,519,251,268
3435,3108,Písek,1,555,278,277
3436,3108,Písek,2,545,277,268
3437,3108,Písek,3,567,296,271
3438,3108,Písek,4,591,307,284
3439,3108,Písek,5,550,286,264
3440,3108,Písek,6,560,280,280
3441,3108,Písek,7,530,274,256
3442,3108,Písek,8,521,280,241
3443,3108,Písek,9,532,264,268
3444,3108,Písek,10,569,292,277
3445,3108,Písek,11,593,333,260
3446,3108,Písek,12,642,332,310
3447,3108,Písek,13,606,298,308
3448,3108,Písek,14,533,276,257
3449,3108,Písek,15,526,271,255
3450,3108,Písek,16,474,249,225
3451,3108,Písek,17,514,262,252
3452,3108,Písek,18,501,244,257
3453,3108,Písek,19,482,243,239
3454,3108,Písek,20,473,237,236
3455,3108,Písek,21,521,263,258
3456,3108,Písek,22,495,264,231
3457,3108,Písek,23,517,253,264
3458,3108,Písek,24,531,283,248
3459,3108,Písek,25,520,281,239
3460,3108,Písek,26,564,285,279
3461,3108,Písek,27,655,324,331
3462,3108,Písek,28,647,341,306
3463,3108,Písek,29,690,374,316
3464,3108,Písek,30,682,349,333
3465,3108,Písek,31,679,346,333
3466,3108,Písek,32,679,369,310
3467,3108,Písek,33,621,305,316
3468,3108,Písek,34,661,321,340
3469,3108,Písek,35,649,312,337
3470,3108,Písek,36,676,375,301
3471,3108,Písek,37,664,351,313
3472,3108,Písek,38,698,361,337
3473,3108,Písek,39,687,353,334
3474,3108,Písek,40,732,365,367
3475,3108,Písek,41,829,432,397
3476,3108,Písek,42,886,451,435
3477,3108,Písek,43,914,461,453
3478,3108,Písek,44,926,455,471
3479,3108,Písek,45,910,428,482
3480,3108,Písek,46,972,512,460
3481,3108,Písek,47,892,463,429
3482,3108,Písek,48,808,395,413
3483,3108,Písek,49,791,409,382
3484,3108,Písek,50,760,378,382
3485,3108,Písek,51,648,333,315
3486,3108,Písek,52,670,368,302
3487,3108,Písek,53,660,332,328
3488,3108,Písek,54,627,311,316
3489,3108,Písek,55,705,351,354
3490,3108,Písek,56,707,363,344
3491,3108,Písek,57,693,331,362
3492,3108,Písek,58,653,323,330
3493,3108,Písek,59,573,289,284
3494,3108,Písek,60,625,283,342
3495,3108,Písek,61,582,286,296
3496,3108,Písek,62,627,295,332
3497,3108,Písek,63,672,335,337
3498,3108,Písek,64,743,347,396
3499,3108,Písek,65,748,386,362
3500,3108,Písek,66,722,357,365
3501,3108,Písek,67,772,383,389
3502,3108,Písek,68,668,328,340
3503,3108,Písek,69,704,318,386
3504,3108,Písek,70,703,330,373
3505,3108,Písek,71,664,307,357
3506,3108,Písek,72,659,326,333
3507,3108,Písek,73,687,318,369
3508,3108,Písek,74,609,292,317
3509,3108,Písek,75,490,218,272
3510,3108,Písek,76,492,191,301
3511,3108,Písek,77,458,183,275
3512,3108,Písek,78,401,149,252
3513,3108,Písek,79,361,146,215
3514,3108,Písek,80,296,123,173
3515,3108,Písek,81,284,105,179
3516,3108,Písek,82,258,89,169
3517,3108,Písek,83,242,86,156
3518,3108,Písek,84,208,81,127
3519,3108,Písek,85,197,74,123
3520,3108,Písek,86,166,62,104
3521,3108,Písek,87,163,42,121
3522,3108,Písek,88,127,41,86
3523,3108,Písek,89,129,40,89
3524,3108,Písek,90,95,30,65
3525,3108,Písek,91,91,29,62
3526,3108,Písek,92,65,19,46
3527,3108,Písek,93,44,12,32
3528,3108,Písek,94,34,13,21
3529,3108,Písek,95,16,4,12
3530,3108,Písek,96,13,0,13
3531,3108,Písek,97,8,3,5
3532,3108,Písek,98,5,1,4
3533,3108,Písek,99,4,0,4
3534,3108,Písek,100,6,2,4
3535,3109,Prachatice,0,300,161,139
3536,3109,Prachatice,1,347,181,166
3537,3109,Prachatice,2,350,182,168
3538,3109,Prachatice,3,357,187,170
3539,3109,Prachatice,4,355,192,163
3540,3109,Prachatice,5,322,157,165
3541,3109,Prachatice,6,305,157,148
3542,3109,Prachatice,7,355,189,166
3543,3109,Prachatice,8,347,179,168
3544,3109,Prachatice,9,333,166,167
3545,3109,Prachatice,10,378,187,191
3546,3109,Prachatice,11,368,186,182
3547,3109,Prachatice,12,394,187,207
3548,3109,Prachatice,13,381,199,182
3549,3109,Prachatice,14,341,164,177
3550,3109,Prachatice,15,325,164,161
3551,3109,Prachatice,16,343,177,166
3552,3109,Prachatice,17,309,167,142
3553,3109,Prachatice,18,331,164,167
3554,3109,Prachatice,19,329,169,160
3555,3109,Prachatice,20,327,167,160
3556,3109,Prachatice,21,336,179,157
3557,3109,Prachatice,22,316,157,159
3558,3109,Prachatice,23,319,165,154
3559,3109,Prachatice,24,313,177,136
3560,3109,Prachatice,25,346,197,149
3561,3109,Prachatice,26,410,217,193
3562,3109,Prachatice,27,406,224,182
3563,3109,Prachatice,28,423,225,198
3564,3109,Prachatice,29,431,214,217
3565,3109,Prachatice,30,450,238,212
3566,3109,Prachatice,31,437,236,201
3567,3109,Prachatice,32,417,219,198
3568,3109,Prachatice,33,418,239,179
3569,3109,Prachatice,34,381,187,194
3570,3109,Prachatice,35,426,229,197
3571,3109,Prachatice,36,408,230,178
3572,3109,Prachatice,37,405,195,210
3573,3109,Prachatice,38,444,244,200
3574,3109,Prachatice,39,454,240,214
3575,3109,Prachatice,40,516,262,254
3576,3109,Prachatice,41,527,288,239
3577,3109,Prachatice,42,536,283,253
3578,3109,Prachatice,43,566,287,279
3579,3109,Prachatice,44,547,284,263
3580,3109,Prachatice,45,551,290,261
3581,3109,Prachatice,46,598,309,289
3582,3109,Prachatice,47,526,283,243
3583,3109,Prachatice,48,508,263,245
3584,3109,Prachatice,49,477,231,246
3585,3109,Prachatice,50,489,249,240
3586,3109,Prachatice,51,483,259,224
3587,3109,Prachatice,52,438,223,215
3588,3109,Prachatice,53,444,240,204
3589,3109,Prachatice,54,442,211,231
3590,3109,Prachatice,55,470,252,218
3591,3109,Prachatice,56,438,208,230
3592,3109,Prachatice,57,468,254,214
3593,3109,Prachatice,58,434,217,217
3594,3109,Prachatice,59,381,195,186
3595,3109,Prachatice,60,374,171,203
3596,3109,Prachatice,61,395,204,191
3597,3109,Prachatice,62,451,209,242
3598,3109,Prachatice,63,425,206,219
3599,3109,Prachatice,64,481,256,225
3600,3109,Prachatice,65,470,223,247
3601,3109,Prachatice,66,442,221,221
3602,3109,Prachatice,67,455,225,230
3603,3109,Prachatice,68,428,207,221
3604,3109,Prachatice,69,447,218,229
3605,3109,Prachatice,70,428,207,221
3606,3109,Prachatice,71,399,176,223
3607,3109,Prachatice,72,407,182,225
3608,3109,Prachatice,73,380,166,214
3609,3109,Prachatice,74,351,160,191
3610,3109,Prachatice,75,277,130,147
3611,3109,Prachatice,76,243,127,116
3612,3109,Prachatice,77,239,106,133
3613,3109,Prachatice,78,245,102,143
3614,3109,Prachatice,79,170,65,105
3615,3109,Prachatice,80,190,74,116
3616,3109,Prachatice,81,149,57,92
3617,3109,Prachatice,82,136,41,95
3618,3109,Prachatice,83,112,33,79
3619,3109,Prachatice,84,113,31,82
3620,3109,Prachatice,85,92,29,63
3621,3109,Prachatice,86,81,26,55
3622,3109,Prachatice,87,62,17,45
3623,3109,Prachatice,88,75,22,53
3624,3109,Prachatice,89,52,14,38
3625,3109,Prachatice,90,43,14,29
3626,3109,Prachatice,91,26,4,22
3627,3109,Prachatice,92,25,5,20
3628,3109,Prachatice,93,20,6,14
3629,3109,Prachatice,94,15,2,13
3630,3109,Prachatice,95,12,1,11
3631,3109,Prachatice,96,7,2,5
3632,3109,Prachatice,97,8,0,8
3633,3109,Prachatice,98,4,1,3
3634,3109,Prachatice,99,2,1,1
3635,3109,Prachatice,100,0,0,0
3636,3110,Soběslav,0,213,115,98
3637,3110,Soběslav,1,224,110,114
3638,3110,Soběslav,2,228,106,122
3639,3110,Soběslav,3,221,117,104
3640,3110,Soběslav,4,235,134,101
3641,3110,Soběslav,5,215,108,107
3642,3110,Soběslav,6,196,88,108
3643,3110,Soběslav,7,241,122,119
3644,3110,Soběslav,8,201,107,94
3645,3110,Soběslav,9,222,121,101
3646,3110,Soběslav,10,236,114,122
3647,3110,Soběslav,11,230,120,110
3648,3110,Soběslav,12,252,124,128
3649,3110,Soběslav,13,253,128,125
3650,3110,Soběslav,14,209,100,109
3651,3110,Soběslav,15,197,102,95
3652,3110,Soběslav,16,211,106,105
3653,3110,Soběslav,17,214,107,107
3654,3110,Soběslav,18,193,96,97
3655,3110,Soběslav,19,198,96,102
3656,3110,Soběslav,20,201,101,100
3657,3110,Soběslav,21,181,89,92
3658,3110,Soběslav,22,216,109,107
3659,3110,Soběslav,23,210,94,116
3660,3110,Soběslav,24,211,116,95
3661,3110,Soběslav,25,209,104,105
3662,3110,Soběslav,26,250,119,131
3663,3110,Soběslav,27,242,143,99
3664,3110,Soběslav,28,252,139,113
3665,3110,Soběslav,29,297,143,154
3666,3110,Soběslav,30,250,147,103
3667,3110,Soběslav,31,245,122,123
3668,3110,Soběslav,32,265,135,130
3669,3110,Soběslav,33,269,144,125
3670,3110,Soběslav,34,233,128,105
3671,3110,Soběslav,35,306,146,160
3672,3110,Soběslav,36,269,133,136
3673,3110,Soběslav,37,295,148,147
3674,3110,Soběslav,38,278,152,126
3675,3110,Soběslav,39,259,143,116
3676,3110,Soběslav,40,288,162,126
3677,3110,Soběslav,41,338,173,165
3678,3110,Soběslav,42,335,174,161
3679,3110,Soběslav,43,352,176,176
3680,3110,Soběslav,44,370,189,181
3681,3110,Soběslav,45,388,194,194
3682,3110,Soběslav,46,384,203,181
3683,3110,Soběslav,47,325,164,161
3684,3110,Soběslav,48,325,190,135
3685,3110,Soběslav,49,297,152,145
3686,3110,Soběslav,50,295,150,145
3687,3110,Soběslav,51,286,144,142
3688,3110,Soběslav,52,266,138,128
3689,3110,Soběslav,53,255,140,115
3690,3110,Soběslav,54,294,157,137
3691,3110,Soběslav,55,253,127,126
3692,3110,Soběslav,56,338,167,171
3693,3110,Soběslav,57,283,137,146
3694,3110,Soběslav,58,261,118,143
3695,3110,Soběslav,59,265,134,131
3696,3110,Soběslav,60,287,147,140
3697,3110,Soběslav,61,294,150,144
3698,3110,Soběslav,62,303,145,158
3699,3110,Soběslav,63,311,159,152
3700,3110,Soběslav,64,341,166,175
3701,3110,Soběslav,65,297,145,152
3702,3110,Soběslav,66,322,163,159
3703,3110,Soběslav,67,290,143,147
3704,3110,Soběslav,68,308,147,161
3705,3110,Soběslav,69,302,153,149
3706,3110,Soběslav,70,284,142,142
3707,3110,Soběslav,71,289,123,166
3708,3110,Soběslav,72,279,133,146
3709,3110,Soběslav,73,290,134,156
3710,3110,Soběslav,74,265,114,151
3711,3110,Soběslav,75,207,78,129
3712,3110,Soběslav,76,205,93,112
3713,3110,Soběslav,77,180,80,100
3714,3110,Soběslav,78,174,78,96
3715,3110,Soběslav,79,155,62,93
3716,3110,Soběslav,80,154,64,90
3717,3110,Soběslav,81,126,45,81
3718,3110,Soběslav,82,104,40,64
3719,3110,Soběslav,83,101,44,57
3720,3110,Soběslav,84,88,26,62
3721,3110,Soběslav,85,87,26,61
3722,3110,Soběslav,86,72,19,53
3723,3110,Soběslav,87,72,24,48
3724,3110,Soběslav,88,54,19,35
3725,3110,Soběslav,89,52,18,34
3726,3110,Soběslav,90,30,12,18
3727,3110,Soběslav,91,33,3,30
3728,3110,Soběslav,92,19,3,16
3729,3110,Soběslav,93,22,4,18
3730,3110,Soběslav,94,13,2,11
3731,3110,Soběslav,95,7,4,3
3732,3110,Soběslav,96,9,0,9
3733,3110,Soběslav,97,2,1,1
3734,3110,Soběslav,98,5,0,5
3735,3110,Soběslav,99,2,1,1
3736,3110,Soběslav,100,2,0,2
3737,3111,Strakonice,0,422,216,206
3738,3111,Strakonice,1,416,222,194
3739,3111,Strakonice,2,468,215,253
3740,3111,Strakonice,3,527,274,253
3741,3111,Strakonice,4,470,242,228
3742,3111,Strakonice,5,479,250,229
3743,3111,Strakonice,6,501,245,256
3744,3111,Strakonice,7,482,250,232
3745,3111,Strakonice,8,463,239,224
3746,3111,Strakonice,9,483,254,229
3747,3111,Strakonice,10,487,253,234
3748,3111,Strakonice,11,529,270,259
3749,3111,Strakonice,12,516,285,231
3750,3111,Strakonice,13,531,246,285
3751,3111,Strakonice,14,484,264,220
3752,3111,Strakonice,15,424,217,207
3753,3111,Strakonice,16,442,217,225
3754,3111,Strakonice,17,416,217,199
3755,3111,Strakonice,18,412,205,207
3756,3111,Strakonice,19,363,166,197
3757,3111,Strakonice,20,352,169,183
3758,3111,Strakonice,21,394,196,198
3759,3111,Strakonice,22,354,191,163
3760,3111,Strakonice,23,376,192,184
3761,3111,Strakonice,24,400,209,191
3762,3111,Strakonice,25,409,209,200
3763,3111,Strakonice,26,468,242,226
3764,3111,Strakonice,27,520,264,256
3765,3111,Strakonice,28,485,243,242
3766,3111,Strakonice,29,573,308,265
3767,3111,Strakonice,30,555,301,254
3768,3111,Strakonice,31,566,300,266
3769,3111,Strakonice,32,564,275,289
3770,3111,Strakonice,33,588,314,274
3771,3111,Strakonice,34,579,293,286
3772,3111,Strakonice,35,553,277,276
3773,3111,Strakonice,36,593,312,281
3774,3111,Strakonice,37,568,293,275
3775,3111,Strakonice,38,623,341,282
3776,3111,Strakonice,39,616,308,308
3777,3111,Strakonice,40,599,316,283
3778,3111,Strakonice,41,715,385,330
3779,3111,Strakonice,42,681,348,333
3780,3111,Strakonice,43,755,381,374
3781,3111,Strakonice,44,762,388,374
3782,3111,Strakonice,45,779,408,371
3783,3111,Strakonice,46,755,379,376
3784,3111,Strakonice,47,737,382,355
3785,3111,Strakonice,48,605,311,294
3786,3111,Strakonice,49,632,322,310
3787,3111,Strakonice,50,570,295,275
3788,3111,Strakonice,51,593,294,299
3789,3111,Strakonice,52,561,266,295
3790,3111,Strakonice,53,588,282,306
3791,3111,Strakonice,54,612,299,313
3792,3111,Strakonice,55,583,291,292
3793,3111,Strakonice,56,661,346,315
3794,3111,Strakonice,57,669,331,338
3795,3111,Strakonice,58,578,294,284
3796,3111,Strakonice,59,559,284,275
3797,3111,Strakonice,60,529,254,275
3798,3111,Strakonice,61,537,282,255
3799,3111,Strakonice,62,579,298,281
3800,3111,Strakonice,63,614,286,328
3801,3111,Strakonice,64,679,344,335
3802,3111,Strakonice,65,642,301,341
3803,3111,Strakonice,66,632,313,319
3804,3111,Strakonice,67,599,257,342
3805,3111,Strakonice,68,585,287,298
3806,3111,Strakonice,69,604,284,320
3807,3111,Strakonice,70,606,286,320
3808,3111,Strakonice,71,484,224,260
3809,3111,Strakonice,72,525,223,302
3810,3111,Strakonice,73,530,251,279
3811,3111,Strakonice,74,481,214,267
3812,3111,Strakonice,75,386,163,223
3813,3111,Strakonice,76,383,129,254
3814,3111,Strakonice,77,420,175,245
3815,3111,Strakonice,78,354,127,227
3816,3111,Strakonice,79,302,106,196
3817,3111,Strakonice,80,330,125,205
3818,3111,Strakonice,81,238,82,156
3819,3111,Strakonice,82,236,87,149
3820,3111,Strakonice,83,202,76,126
3821,3111,Strakonice,84,176,69,107
3822,3111,Strakonice,85,147,50,97
3823,3111,Strakonice,86,160,54,106
3824,3111,Strakonice,87,144,58,86
3825,3111,Strakonice,88,104,31,73
3826,3111,Strakonice,89,89,31,58
3827,3111,Strakonice,90,83,21,62
3828,3111,Strakonice,91,51,17,34
3829,3111,Strakonice,92,39,6,33
3830,3111,Strakonice,93,22,9,13
3831,3111,Strakonice,94,25,5,20
3832,3111,Strakonice,95,12,1,11
3833,3111,Strakonice,96,8,0,8
3834,3111,Strakonice,97,11,2,9
3835,3111,Strakonice,98,4,2,2
3836,3111,Strakonice,99,4,0,4
3837,3111,Strakonice,100,0,0,0
3838,3112,Tábor,0,775,392,383
3839,3112,Tábor,1,798,391,407
3840,3112,Tábor,2,824,426,398
3841,3112,Tábor,3,861,441,420
3842,3112,Tábor,4,809,448,361
3843,3112,Tábor,5,769,392,377
3844,3112,Tábor,6,777,410,367
3845,3112,Tábor,7,851,423,428
3846,3112,Tábor,8,854,440,414
3847,3112,Tábor,9,769,386,383
3848,3112,Tábor,10,887,470,417
3849,3112,Tábor,11,943,468,475
3850,3112,Tábor,12,902,474,428
3851,3112,Tábor,13,867,447,420
3852,3112,Tábor,14,845,435,410
3853,3112,Tábor,15,805,416,389
3854,3112,Tábor,16,792,416,376
3855,3112,Tábor,17,731,340,391
3856,3112,Tábor,18,727,372,355
3857,3112,Tábor,19,696,335,361
3858,3112,Tábor,20,727,404,323
3859,3112,Tábor,21,726,388,338
3860,3112,Tábor,22,736,379,357
3861,3112,Tábor,23,691,358,333
3862,3112,Tábor,24,717,379,338
3863,3112,Tábor,25,790,442,348
3864,3112,Tábor,26,888,451,437
3865,3112,Tábor,27,935,460,475
3866,3112,Tábor,28,974,496,478
3867,3112,Tábor,29,969,473,496
3868,3112,Tábor,30,981,491,490
3869,3112,Tábor,31,939,501,438
3870,3112,Tábor,32,975,491,484
3871,3112,Tábor,33,944,482,462
3872,3112,Tábor,34,1040,566,474
3873,3112,Tábor,35,1017,523,494
3874,3112,Tábor,36,1019,553,466
3875,3112,Tábor,37,1038,532,506
3876,3112,Tábor,38,1093,549,544
3877,3112,Tábor,39,1074,534,540
3878,3112,Tábor,40,1130,564,566
3879,3112,Tábor,41,1259,665,594
3880,3112,Tábor,42,1350,686,664
3881,3112,Tábor,43,1297,636,661
3882,3112,Tábor,44,1328,670,658
3883,3112,Tábor,45,1424,737,687
3884,3112,Tábor,46,1482,758,724
3885,3112,Tábor,47,1374,701,673
3886,3112,Tábor,48,1194,625,569
3887,3112,Tábor,49,1164,593,571
3888,3112,Tábor,50,1107,573,534
3889,3112,Tábor,51,1068,524,544
3890,3112,Tábor,52,1062,503,559
3891,3112,Tábor,53,975,493,482
3892,3112,Tábor,54,968,525,443
3893,3112,Tábor,55,1065,528,537
3894,3112,Tábor,56,1074,568,506
3895,3112,Tábor,57,1085,533,552
3896,3112,Tábor,58,972,465,507
3897,3112,Tábor,59,1007,492,515
3898,3112,Tábor,60,936,491,445
3899,3112,Tábor,61,944,471,473
3900,3112,Tábor,62,1024,493,531
3901,3112,Tábor,63,1086,547,539
3902,3112,Tábor,64,1128,566,562
3903,3112,Tábor,65,1114,506,608
3904,3112,Tábor,66,1129,558,571
3905,3112,Tábor,67,1094,514,580
3906,3112,Tábor,68,1092,508,584
3907,3112,Tábor,69,1075,498,577
3908,3112,Tábor,70,1017,475,542
3909,3112,Tábor,71,919,436,483
3910,3112,Tábor,72,986,445,541
3911,3112,Tábor,73,1019,462,557
3912,3112,Tábor,74,988,441,547
3913,3112,Tábor,75,750,313,437
3914,3112,Tábor,76,738,303,435
3915,3112,Tábor,77,643,282,361
3916,3112,Tábor,78,565,217,348
3917,3112,Tábor,79,518,218,300
3918,3112,Tábor,80,470,181,289
3919,3112,Tábor,81,439,172,267
3920,3112,Tábor,82,402,133,269
3921,3112,Tábor,83,356,132,224
3922,3112,Tábor,84,338,123,215
3923,3112,Tábor,85,313,90,223
3924,3112,Tábor,86,287,104,183
3925,3112,Tábor,87,242,82,160
3926,3112,Tábor,88,206,73,133
3927,3112,Tábor,89,177,58,119
3928,3112,Tábor,90,167,54,113
3929,3112,Tábor,91,115,39,76
3930,3112,Tábor,92,107,33,74
3931,3112,Tábor,93,51,16,35
3932,3112,Tábor,94,44,16,28
3933,3112,Tábor,95,26,6,20
3934,3112,Tábor,96,19,3,16
3935,3112,Tábor,97,5,3,2
3936,3112,Tábor,98,11,3,8
3937,3112,Tábor,99,4,2,2
3938,3112,Tábor,100,5,1,4
3939,3113,Trhové Sviny,0,240,105,135
3940,3113,Trhové Sviny,1,187,101,86
3941,3113,Trhové Sviny,2,234,115,119
3942,3113,Trhové Sviny,3,236,126,110
3943,3113,Trhové Sviny,4,225,119,106
3944,3113,Trhové Sviny,5,227,123,104
3945,3113,Trhové Sviny,6,231,111,120
3946,3113,Trhové Sviny,7,205,104,101
3947,3113,Trhové Sviny,8,196,102,94
3948,3113,Trhové Sviny,9,208,113,95
3949,3113,Trhové Sviny,10,242,133,109
3950,3113,Trhové Sviny,11,227,110,117
3951,3113,Trhové Sviny,12,200,94,106
3952,3113,Trhové Sviny,13,213,103,110
3953,3113,Trhové Sviny,14,203,109,94
3954,3113,Trhové Sviny,15,196,101,95
3955,3113,Trhové Sviny,16,206,117,89
3956,3113,Trhové Sviny,17,181,97,84
3957,3113,Trhové Sviny,18,174,96,78
3958,3113,Trhové Sviny,19,162,91,71
3959,3113,Trhové Sviny,20,187,103,84
3960,3113,Trhové Sviny,21,174,94,80
3961,3113,Trhové Sviny,22,171,84,87
3962,3113,Trhové Sviny,23,189,105,84
3963,3113,Trhové Sviny,24,146,80,66
3964,3113,Trhové Sviny,25,191,88,103
3965,3113,Trhové Sviny,26,197,97,100
3966,3113,Trhové Sviny,27,221,114,107
3967,3113,Trhové Sviny,28,209,113,96
3968,3113,Trhové Sviny,29,271,136,135
3969,3113,Trhové Sviny,30,271,136,135
3970,3113,Trhové Sviny,31,247,113,134
3971,3113,Trhové Sviny,32,252,116,136
3972,3113,Trhové Sviny,33,245,116,129
3973,3113,Trhové Sviny,34,253,132,121
3974,3113,Trhové Sviny,35,263,123,140
3975,3113,Trhové Sviny,36,272,147,125
3976,3113,Trhové Sviny,37,286,148,138
3977,3113,Trhové Sviny,38,248,115,133
3978,3113,Trhové Sviny,39,298,164,134
3979,3113,Trhové Sviny,40,319,169,150
3980,3113,Trhové Sviny,41,303,163,140
3981,3113,Trhové Sviny,42,333,164,169
3982,3113,Trhové Sviny,43,342,187,155
3983,3113,Trhové Sviny,44,300,138,162
3984,3113,Trhové Sviny,45,358,182,176
3985,3113,Trhové Sviny,46,348,183,165
3986,3113,Trhové Sviny,47,319,172,147
3987,3113,Trhové Sviny,48,284,138,146
3988,3113,Trhové Sviny,49,274,145,129
3989,3113,Trhové Sviny,50,260,141,119
3990,3113,Trhové Sviny,51,271,131,140
3991,3113,Trhové Sviny,52,237,129,108
3992,3113,Trhové Sviny,53,227,112,115
3993,3113,Trhové Sviny,54,248,128,120
3994,3113,Trhové Sviny,55,232,128,104
3995,3113,Trhové Sviny,56,283,148,135
3996,3113,Trhové Sviny,57,230,115,115
3997,3113,Trhové Sviny,58,191,105,86
3998,3113,Trhové Sviny,59,225,109,116
3999,3113,Trhové Sviny,60,206,110,96
4000,3113,Trhové Sviny,61,242,121,121
4001,3113,Trhové Sviny,62,234,117,117
4002,3113,Trhové Sviny,63,282,133,149
4003,3113,Trhové Sviny,64,293,140,153
4004,3113,Trhové Sviny,65,274,140,134
4005,3113,Trhové Sviny,66,243,129,114
4006,3113,Trhové Sviny,67,271,142,129
4007,3113,Trhové Sviny,68,267,123,144
4008,3113,Trhové Sviny,69,263,120,143
4009,3113,Trhové Sviny,70,254,124,130
4010,3113,Trhové Sviny,71,207,113,94
4011,3113,Trhové Sviny,72,218,110,108
4012,3113,Trhové Sviny,73,214,102,112
4013,3113,Trhové Sviny,74,192,86,106
4014,3113,Trhové Sviny,75,146,66,80
4015,3113,Trhové Sviny,76,156,63,93
4016,3113,Trhové Sviny,77,161,67,94
4017,3113,Trhové Sviny,78,117,51,66
4018,3113,Trhové Sviny,79,107,46,61
4019,3113,Trhové Sviny,80,88,34,54
4020,3113,Trhové Sviny,81,81,23,58
4021,3113,Trhové Sviny,82,72,19,53
4022,3113,Trhové Sviny,83,63,19,44
4023,3113,Trhové Sviny,84,62,27,35
4024,3113,Trhové Sviny,85,57,27,30
4025,3113,Trhové Sviny,86,38,11,27
4026,3113,Trhové Sviny,87,25,11,14
4027,3113,Trhové Sviny,88,34,14,20
4028,3113,Trhové Sviny,89,26,10,16
4029,3113,Trhové Sviny,90,28,9,19
4030,3113,Trhové Sviny,91,18,6,12
4031,3113,Trhové Sviny,92,9,2,7
4032,3113,Trhové Sviny,93,13,3,10
4033,3113,Trhové Sviny,94,5,1,4
4034,3113,Trhové Sviny,95,7,0,7
4035,3113,Trhové Sviny,96,2,1,1
4036,3113,Trhové Sviny,97,2,0,2
4037,3113,Trhové Sviny,98,1,0,1
4038,3113,Trhové Sviny,99,1,1,0
4039,3113,Trhové Sviny,100,2,1,1
4040,3114,Třeboň,0,237,120,117
4041,3114,Třeboň,1,253,125,128
4042,3114,Třeboň,2,230,110,120
4043,3114,Třeboň,3,223,101,122
4044,3114,Třeboň,4,233,119,114
4045,3114,Třeboň,5,217,107,110
4046,3114,Třeboň,6,232,108,124
4047,3114,Třeboň,7,225,118,107
4048,3114,Třeboň,8,243,127,116
4049,3114,Třeboň,9,222,117,105
4050,3114,Třeboň,10,260,128,132
4051,3114,Třeboň,11,289,146,143
4052,3114,Třeboň,12,268,126,142
4053,3114,Třeboň,13,282,139,143
4054,3114,Třeboň,14,257,130,127
4055,3114,Třeboň,15,224,112,112
4056,3114,Třeboň,16,230,124,106
4057,3114,Třeboň,17,189,101,88
4058,3114,Třeboň,18,212,111,101
4059,3114,Třeboň,19,210,102,108
4060,3114,Třeboň,20,243,132,111
4061,3114,Třeboň,21,213,119,94
4062,3114,Třeboň,22,228,108,120
4063,3114,Třeboň,23,198,105,93
4064,3114,Třeboň,24,224,103,121
4065,3114,Třeboň,25,229,121,108
4066,3114,Třeboň,26,283,140,143
4067,3114,Třeboň,27,306,160,146
4068,3114,Třeboň,28,289,159,130
4069,3114,Třeboň,29,297,161,136
4070,3114,Třeboň,30,314,161,153
4071,3114,Třeboň,31,317,170,147
4072,3114,Třeboň,32,308,163,145
4073,3114,Třeboň,33,296,173,123
4074,3114,Třeboň,34,306,171,135
4075,3114,Třeboň,35,282,151,131
4076,3114,Třeboň,36,306,158,148
4077,3114,Třeboň,37,342,180,162
4078,3114,Třeboň,38,334,158,176
4079,3114,Třeboň,39,322,164,158
4080,3114,Třeboň,40,351,170,181
4081,3114,Třeboň,41,390,215,175
4082,3114,Třeboň,42,362,188,174
4083,3114,Třeboň,43,367,185,182
4084,3114,Třeboň,44,435,205,230
4085,3114,Třeboň,45,402,228,174
4086,3114,Třeboň,46,422,207,215
4087,3114,Třeboň,47,389,204,185
4088,3114,Třeboň,48,366,189,177
4089,3114,Třeboň,49,344,183,161
4090,3114,Třeboň,50,362,171,191
4091,3114,Třeboň,51,362,191,171
4092,3114,Třeboň,52,284,144,140
4093,3114,Třeboň,53,322,145,177
4094,3114,Třeboň,54,295,153,142
4095,3114,Třeboň,55,309,156,153
4096,3114,Třeboň,56,322,166,156
4097,3114,Třeboň,57,365,162,203
4098,3114,Třeboň,58,290,134,156
4099,3114,Třeboň,59,289,144,145
4100,3114,Třeboň,60,291,128,163
4101,3114,Třeboň,61,307,156,151
4102,3114,Třeboň,62,336,168,168
4103,3114,Třeboň,63,348,195,153
4104,3114,Třeboň,64,326,168,158
4105,3114,Třeboň,65,364,164,200
4106,3114,Třeboň,66,325,151,174
4107,3114,Třeboň,67,333,137,196
4108,3114,Třeboň,68,335,183,152
4109,3114,Třeboň,69,376,191,185
4110,3114,Třeboň,70,329,165,164
4111,3114,Třeboň,71,326,150,176
4112,3114,Třeboň,72,320,129,191
4113,3114,Třeboň,73,338,160,178
4114,3114,Třeboň,74,323,146,177
4115,3114,Třeboň,75,248,100,148
4116,3114,Třeboň,76,234,104,130
4117,3114,Třeboň,77,236,94,142
4118,3114,Třeboň,78,191,83,108
4119,3114,Třeboň,79,176,67,109
4120,3114,Třeboň,80,158,66,92
4121,3114,Třeboň,81,134,56,78
4122,3114,Třeboň,82,140,48,92
4123,3114,Třeboň,83,102,37,65
4124,3114,Třeboň,84,108,39,69
4125,3114,Třeboň,85,100,23,77
4126,3114,Třeboň,86,73,24,49
4127,3114,Třeboň,87,82,25,57
4128,3114,Třeboň,88,83,30,53
4129,3114,Třeboň,89,60,25,35
4130,3114,Třeboň,90,38,11,27
4131,3114,Třeboň,91,42,11,31
4132,3114,Třeboň,92,24,7,17
4133,3114,Třeboň,93,19,6,13
4134,3114,Třeboň,94,10,2,8
4135,3114,Třeboň,95,8,1,7
4136,3114,Třeboň,96,11,1,10
4137,3114,Třeboň,97,4,2,2
4138,3114,Třeboň,98,3,1,2
4139,3114,Třeboň,99,6,1,5
4140,3114,Třeboň,100,1,1,0
4141,3115,Týn nad Vltavou,0,171,93,78
4142,3115,Týn nad Vltavou,1,132,68,64
4143,3115,Týn nad Vltavou,2,158,82,76
4144,3115,Týn nad Vltavou,3,160,89,71
4145,3115,Týn nad Vltavou,4,140,67,73
4146,3115,Týn nad Vltavou,5,158,79,79
4147,3115,Týn nad Vltavou,6,133,61,72
4148,3115,Týn nad Vltavou,7,143,84,59
4149,3115,Týn nad Vltavou,8,154,87,67
4150,3115,Týn nad Vltavou,9,145,77,68
4151,3115,Týn nad Vltavou,10,148,80,68
4152,3115,Týn nad Vltavou,11,148,69,79
4153,3115,Týn nad Vltavou,12,163,87,76
4154,3115,Týn nad Vltavou,13,139,77,62
4155,3115,Týn nad Vltavou,14,145,64,81
4156,3115,Týn nad Vltavou,15,141,68,73
4157,3115,Týn nad Vltavou,16,119,62,57
4158,3115,Týn nad Vltavou,17,126,54,72
4159,3115,Týn nad Vltavou,18,154,76,78
4160,3115,Týn nad Vltavou,19,138,72,66
4161,3115,Týn nad Vltavou,20,114,55,59
4162,3115,Týn nad Vltavou,21,128,76,52
4163,3115,Týn nad Vltavou,22,128,59,69
4164,3115,Týn nad Vltavou,23,127,53,74
4165,3115,Týn nad Vltavou,24,159,82,77
4166,3115,Týn nad Vltavou,25,161,92,69
4167,3115,Týn nad Vltavou,26,179,90,89
4168,3115,Týn nad Vltavou,27,214,102,112
4169,3115,Týn nad Vltavou,28,195,106,89
4170,3115,Týn nad Vltavou,29,208,109,99
4171,3115,Týn nad Vltavou,30,194,110,84
4172,3115,Týn nad Vltavou,31,206,112,94
4173,3115,Týn nad Vltavou,32,173,84,89
4174,3115,Týn nad Vltavou,33,192,98,94
4175,3115,Týn nad Vltavou,34,198,110,88
4176,3115,Týn nad Vltavou,35,179,104,75
4177,3115,Týn nad Vltavou,36,169,87,82
4178,3115,Týn nad Vltavou,37,180,95,85
4179,3115,Týn nad Vltavou,38,174,84,90
4180,3115,Týn nad Vltavou,39,158,92,66
4181,3115,Týn nad Vltavou,40,201,110,91
4182,3115,Týn nad Vltavou,41,192,100,92
4183,3115,Týn nad Vltavou,42,181,83,98
4184,3115,Týn nad Vltavou,43,218,120,98
4185,3115,Týn nad Vltavou,44,252,124,128
4186,3115,Týn nad Vltavou,45,245,131,114
4187,3115,Týn nad Vltavou,46,259,137,122
4188,3115,Týn nad Vltavou,47,257,130,127
4189,3115,Týn nad Vltavou,48,244,119,125
4190,3115,Týn nad Vltavou,49,248,114,134
4191,3115,Týn nad Vltavou,50,204,110,94
4192,3115,Týn nad Vltavou,51,211,107,104
4193,3115,Týn nad Vltavou,52,225,139,86
4194,3115,Týn nad Vltavou,53,175,85,90
4195,3115,Týn nad Vltavou,54,182,90,92
4196,3115,Týn nad Vltavou,55,200,101,99
4197,3115,Týn nad Vltavou,56,191,97,94
4198,3115,Týn nad Vltavou,57,186,85,101
4199,3115,Týn nad Vltavou,58,158,84,74
4200,3115,Týn nad Vltavou,59,189,91,98
4201,3115,Týn nad Vltavou,60,159,85,74
4202,3115,Týn nad Vltavou,61,195,111,84
4203,3115,Týn nad Vltavou,62,191,83,108
4204,3115,Týn nad Vltavou,63,189,104,85
4205,3115,Týn nad Vltavou,64,178,86,92
4206,3115,Týn nad Vltavou,65,164,79,85
4207,3115,Týn nad Vltavou,66,189,97,92
4208,3115,Týn nad Vltavou,67,173,81,92
4209,3115,Týn nad Vltavou,68,169,83,86
4210,3115,Týn nad Vltavou,69,141,54,87
4211,3115,Týn nad Vltavou,70,162,82,80
4212,3115,Týn nad Vltavou,71,168,81,87
4213,3115,Týn nad Vltavou,72,161,82,79
4214,3115,Týn nad Vltavou,73,168,73,95
4215,3115,Týn nad Vltavou,74,127,60,67
4216,3115,Týn nad Vltavou,75,115,42,73
4217,3115,Týn nad Vltavou,76,100,34,66
4218,3115,Týn nad Vltavou,77,87,33,54
4219,3115,Týn nad Vltavou,78,80,37,43
4220,3115,Týn nad Vltavou,79,81,31,50
4221,3115,Týn nad Vltavou,80,74,27,47
4222,3115,Týn nad Vltavou,81,52,19,33
4223,3115,Týn nad Vltavou,82,46,12,34
4224,3115,Týn nad Vltavou,83,45,18,27
4225,3115,Týn nad Vltavou,84,44,12,32
4226,3115,Týn nad Vltavou,85,40,13,27
4227,3115,Týn nad Vltavou,86,37,11,26
4228,3115,Týn nad Vltavou,87,41,18,23
4229,3115,Týn nad Vltavou,88,35,8,27
4230,3115,Týn nad Vltavou,89,33,8,25
4231,3115,Týn nad Vltavou,90,25,12,13
4232,3115,Týn nad Vltavou,91,19,7,12
4233,3115,Týn nad Vltavou,92,10,3,7
4234,3115,Týn nad Vltavou,93,8,5,3
4235,3115,Týn nad Vltavou,94,6,3,3
4236,3115,Týn nad Vltavou,95,3,0,3
4237,3115,Týn nad Vltavou,96,1,0,1
4238,3115,Týn nad Vltavou,97,3,0,3
4239,3115,Týn nad Vltavou,98,1,0,1
4240,3115,Týn nad Vltavou,99,1,1,0
4241,3115,Týn nad Vltavou,100,3,0,3
4242,3116,Vimperk,0,154,81,73
4243,3116,Vimperk,1,169,73,96
4244,3116,Vimperk,2,183,91,92
4245,3116,Vimperk,3,186,91,95
4246,3116,Vimperk,4,174,103,71
4247,3116,Vimperk,5,188,108,80
4248,3116,Vimperk,6,164,86,78
4249,3116,Vimperk,7,168,81,87
4250,3116,Vimperk,8,192,95,97
4251,3116,Vimperk,9,191,102,89
4252,3116,Vimperk,10,183,99,84
4253,3116,Vimperk,11,195,102,93
4254,3116,Vimperk,12,200,104,96
4255,3116,Vimperk,13,174,94,80
4256,3116,Vimperk,14,162,89,73
4257,3116,Vimperk,15,173,91,82
4258,3116,Vimperk,16,190,98,92
4259,3116,Vimperk,17,136,75,61
4260,3116,Vimperk,18,166,91,75
4261,3116,Vimperk,19,191,97,94
4262,3116,Vimperk,20,150,71,79
4263,3116,Vimperk,21,183,113,70
4264,3116,Vimperk,22,161,74,87
4265,3116,Vimperk,23,174,80,94
4266,3116,Vimperk,24,156,82,74
4267,3116,Vimperk,25,173,92,81
4268,3116,Vimperk,26,187,96,91
4269,3116,Vimperk,27,197,104,93
4270,3116,Vimperk,28,206,99,107
4271,3116,Vimperk,29,233,121,112
4272,3116,Vimperk,30,222,124,98
4273,3116,Vimperk,31,214,111,103
4274,3116,Vimperk,32,210,108,102
4275,3116,Vimperk,33,199,107,92
4276,3116,Vimperk,34,213,118,95
4277,3116,Vimperk,35,218,118,100
4278,3116,Vimperk,36,232,112,120
4279,3116,Vimperk,37,256,130,126
4280,3116,Vimperk,38,234,124,110
4281,3116,Vimperk,39,278,153,125
4282,3116,Vimperk,40,234,120,114
4283,3116,Vimperk,41,254,125,129
4284,3116,Vimperk,42,292,139,153
4285,3116,Vimperk,43,301,158,143
4286,3116,Vimperk,44,272,132,140
4287,3116,Vimperk,45,300,156,144
4288,3116,Vimperk,46,280,144,136
4289,3116,Vimperk,47,289,151,138
4290,3116,Vimperk,48,259,139,120
4291,3116,Vimperk,49,244,118,126
4292,3116,Vimperk,50,225,112,113
4293,3116,Vimperk,51,224,111,113
4294,3116,Vimperk,52,212,110,102
4295,3116,Vimperk,53,197,96,101
4296,3116,Vimperk,54,219,118,101
4297,3116,Vimperk,55,235,134,101
4298,3116,Vimperk,56,234,120,114
4299,3116,Vimperk,57,249,116,133
4300,3116,Vimperk,58,225,109,116
4301,3116,Vimperk,59,216,106,110
4302,3116,Vimperk,60,241,119,122
4303,3116,Vimperk,61,207,111,96
4304,3116,Vimperk,62,252,111,141
4305,3116,Vimperk,63,266,133,133
4306,3116,Vimperk,64,261,143,118
4307,3116,Vimperk,65,237,121,116
4308,3116,Vimperk,66,283,141,142
4309,3116,Vimperk,67,222,109,113
4310,3116,Vimperk,68,226,114,112
4311,3116,Vimperk,69,219,109,110
4312,3116,Vimperk,70,229,114,115
4313,3116,Vimperk,71,208,118,90
4314,3116,Vimperk,72,199,85,114
4315,3116,Vimperk,73,234,105,129
4316,3116,Vimperk,74,189,80,109
4317,3116,Vimperk,75,146,63,83
4318,3116,Vimperk,76,140,65,75
4319,3116,Vimperk,77,133,62,71
4320,3116,Vimperk,78,103,45,58
4321,3116,Vimperk,79,115,44,71
4322,3116,Vimperk,80,104,41,63
4323,3116,Vimperk,81,95,32,63
4324,3116,Vimperk,82,61,20,41
4325,3116,Vimperk,83,81,27,54
4326,3116,Vimperk,84,85,32,53
4327,3116,Vimperk,85,62,22,40
4328,3116,Vimperk,86,51,19,32
4329,3116,Vimperk,87,48,14,34
4330,3116,Vimperk,88,51,20,31
4331,3116,Vimperk,89,34,8,26
4332,3116,Vimperk,90,25,5,20
4333,3116,Vimperk,91,21,11,10
4334,3116,Vimperk,92,15,2,13
4335,3116,Vimperk,93,9,0,9
4336,3116,Vimperk,94,6,1,5
4337,3116,Vimperk,95,4,1,3
4338,3116,Vimperk,96,2,2,0
4339,3116,Vimperk,97,5,2,3
4340,3116,Vimperk,98,2,0,2
4341,3116,Vimperk,99,4,1,3
4342,3116,Vimperk,100,1,0,1
4343,3117,Vodňany,0,123,60,63
4344,3117,Vodňany,1,133,68,65
4345,3117,Vodňany,2,121,65,56
4346,3117,Vodňany,3,127,56,71
4347,3117,Vodňany,4,120,58,62
4348,3117,Vodňany,5,124,61,63
4349,3117,Vodňany,6,99,52,47
4350,3117,Vodňany,7,89,38,51
4351,3117,Vodňany,8,124,80,44
4352,3117,Vodňany,9,116,63,53
4353,3117,Vodňany,10,123,61,62
4354,3117,Vodňany,11,139,61,78
4355,3117,Vodňany,12,130,72,58
4356,3117,Vodňany,13,144,76,68
4357,3117,Vodňany,14,122,69,53
4358,3117,Vodňany,15,137,75,62
4359,3117,Vodňany,16,130,65,65
4360,3117,Vodňany,17,109,55,54
4361,3117,Vodňany,18,118,56,62
4362,3117,Vodňany,19,114,53,61
4363,3117,Vodňany,20,131,65,66
4364,3117,Vodňany,21,111,54,57
4365,3117,Vodňany,22,106,50,56
4366,3117,Vodňany,23,127,62,65
4367,3117,Vodňany,24,135,74,61
4368,3117,Vodňany,25,133,68,65
4369,3117,Vodňany,26,142,78,64
4370,3117,Vodňany,27,140,76,64
4371,3117,Vodňany,28,151,88,63
4372,3117,Vodňany,29,161,98,63
4373,3117,Vodňany,30,150,79,71
4374,3117,Vodňany,31,129,71,58
4375,3117,Vodňany,32,151,77,74
4376,3117,Vodňany,33,141,73,68
4377,3117,Vodňany,34,155,83,72
4378,3117,Vodňany,35,164,97,67
4379,3117,Vodňany,36,166,84,82
4380,3117,Vodňany,37,157,94,63
4381,3117,Vodňany,38,167,87,80
4382,3117,Vodňany,39,163,89,74
4383,3117,Vodňany,40,182,94,88
4384,3117,Vodňany,41,223,127,96
4385,3117,Vodňany,42,202,106,96
4386,3117,Vodňany,43,211,121,90
4387,3117,Vodňany,44,243,121,122
4388,3117,Vodňany,45,201,87,114
4389,3117,Vodňany,46,226,108,118
4390,3117,Vodňany,47,183,95,88
4391,3117,Vodňany,48,192,92,100
4392,3117,Vodňany,49,183,89,94
4393,3117,Vodňany,50,220,112,108
4394,3117,Vodňany,51,155,71,84
4395,3117,Vodňany,52,153,80,73
4396,3117,Vodňany,53,138,84,54
4397,3117,Vodňany,54,147,84,63
4398,3117,Vodňany,55,145,60,85
4399,3117,Vodňany,56,150,83,67
4400,3117,Vodňany,57,152,79,73
4401,3117,Vodňany,58,134,67,67
4402,3117,Vodňany,59,144,71,73
4403,3117,Vodňany,60,135,68,67
4404,3117,Vodňany,61,134,68,66
4405,3117,Vodňany,62,151,76,75
4406,3117,Vodňany,63,149,87,62
4407,3117,Vodňany,64,154,68,86
4408,3117,Vodňany,65,159,81,78
4409,3117,Vodňany,66,164,80,84
4410,3117,Vodňany,67,145,73,72
4411,3117,Vodňany,68,141,74,67
4412,3117,Vodňany,69,120,50,70
4413,3117,Vodňany,70,115,58,57
4414,3117,Vodňany,71,134,69,65
4415,3117,Vodňany,72,139,54,85
4416,3117,Vodňany,73,137,60,77
4417,3117,Vodňany,74,106,52,54
4418,3117,Vodňany,75,101,42,59
4419,3117,Vodňany,76,92,34,58
4420,3117,Vodňany,77,100,43,57
4421,3117,Vodňany,78,86,39,47
4422,3117,Vodňany,79,92,38,54
4423,3117,Vodňany,80,61,24,37
4424,3117,Vodňany,81,60,25,35
4425,3117,Vodňany,82,48,18,30
4426,3117,Vodňany,83,47,17,30
4427,3117,Vodňany,84,35,8,27
4428,3117,Vodňany,85,47,14,33
4429,3117,Vodňany,86,33,10,23
4430,3117,Vodňany,87,24,3,21
4431,3117,Vodňany,88,22,5,17
4432,3117,Vodňany,89,18,6,12
4433,3117,Vodňany,90,9,4,5
4434,3117,Vodňany,91,21,6,15
4435,3117,Vodňany,92,14,2,12
4436,3117,Vodňany,93,9,2,7
4437,3117,Vodňany,94,5,1,4
4438,3117,Vodňany,95,4,0,4
4439,3117,Vodňany,96,1,0,1
4440,3117,Vodňany,97,5,0,5
4441,3117,Vodňany,98,2,0,2
4442,3117,Vodňany,99,1,0,1
4443,3117,Vodňany,100,1,0,1
4444,3201,Blovice,0,126,57,69
4445,3201,Blovice,1,126,73,53
4446,3201,Blovice,2,143,78,65
4447,3201,Blovice,3,129,70,59
4448,3201,Blovice,4,148,80,68
4449,3201,Blovice,5,100,52,48
4450,3201,Blovice,6,135,78,57
4451,3201,Blovice,7,126,74,52
4452,3201,Blovice,8,116,59,57
4453,3201,Blovice,9,122,60,62
4454,3201,Blovice,10,138,85,53
4455,3201,Blovice,11,137,63,74
4456,3201,Blovice,12,150,75,75
4457,3201,Blovice,13,123,61,62
4458,3201,Blovice,14,129,70,59
4459,3201,Blovice,15,116,53,63
4460,3201,Blovice,16,108,62,46
4461,3201,Blovice,17,90,44,46
4462,3201,Blovice,18,107,54,53
4463,3201,Blovice,19,98,52,46
4464,3201,Blovice,20,119,62,57
4465,3201,Blovice,21,106,50,56
4466,3201,Blovice,22,128,70,58
4467,3201,Blovice,23,103,50,53
4468,3201,Blovice,24,111,52,59
4469,3201,Blovice,25,128,61,67
4470,3201,Blovice,26,134,71,63
4471,3201,Blovice,27,131,61,70
4472,3201,Blovice,28,169,89,80
4473,3201,Blovice,29,148,83,65
4474,3201,Blovice,30,175,90,85
4475,3201,Blovice,31,152,76,76
4476,3201,Blovice,32,152,85,67
4477,3201,Blovice,33,143,73,70
4478,3201,Blovice,34,138,79,59
4479,3201,Blovice,35,160,87,73
4480,3201,Blovice,36,156,76,80
4481,3201,Blovice,37,157,87,70
4482,3201,Blovice,38,167,82,85
4483,3201,Blovice,39,174,82,92
4484,3201,Blovice,40,173,91,82
4485,3201,Blovice,41,190,93,97
4486,3201,Blovice,42,212,123,89
4487,3201,Blovice,43,197,99,98
4488,3201,Blovice,44,227,122,105
4489,3201,Blovice,45,210,114,96
4490,3201,Blovice,46,260,148,112
4491,3201,Blovice,47,211,108,103
4492,3201,Blovice,48,191,92,99
4493,3201,Blovice,49,174,90,84
4494,3201,Blovice,50,143,82,61
4495,3201,Blovice,51,166,86,80
4496,3201,Blovice,52,159,78,81
4497,3201,Blovice,53,155,78,77
4498,3201,Blovice,54,165,81,84
4499,3201,Blovice,55,143,74,69
4500,3201,Blovice,56,172,88,84
4501,3201,Blovice,57,144,78,66
4502,3201,Blovice,58,153,74,79
4503,3201,Blovice,59,132,69,63
4504,3201,Blovice,60,131,70,61
4505,3201,Blovice,61,157,76,81
4506,3201,Blovice,62,138,72,66
4507,3201,Blovice,63,146,83,63
4508,3201,Blovice,64,154,75,79
4509,3201,Blovice,65,186,89,97
4510,3201,Blovice,66,168,80,88
4511,3201,Blovice,67,150,77,73
4512,3201,Blovice,68,181,92,89
4513,3201,Blovice,69,170,73,97
4514,3201,Blovice,70,146,64,82
4515,3201,Blovice,71,141,68,73
4516,3201,Blovice,72,167,81,86
4517,3201,Blovice,73,149,72,77
4518,3201,Blovice,74,135,61,74
4519,3201,Blovice,75,131,60,71
4520,3201,Blovice,76,121,61,60
4521,3201,Blovice,77,91,50,41
4522,3201,Blovice,78,81,30,51
4523,3201,Blovice,79,74,26,48
4524,3201,Blovice,80,76,31,45
4525,3201,Blovice,81,50,21,29
4526,3201,Blovice,82,52,15,37
4527,3201,Blovice,83,49,18,31
4528,3201,Blovice,84,54,18,36
4529,3201,Blovice,85,45,17,28
4530,3201,Blovice,86,38,15,23
4531,3201,Blovice,87,27,10,17
4532,3201,Blovice,88,33,10,23
4533,3201,Blovice,89,20,5,15
4534,3201,Blovice,90,28,10,18
4535,3201,Blovice,91,16,5,11
4536,3201,Blovice,92,5,1,4
4537,3201,Blovice,93,9,0,9
4538,3201,Blovice,94,7,2,5
4539,3201,Blovice,95,2,0,2
4540,3201,Blovice,96,4,1,3
4541,3201,Blovice,97,4,1,3
4542,3201,Blovice,98,1,0,1
4543,3201,Blovice,99,0,0,0
4544,3201,Blovice,100,2,1,1
4545,3202,Domažlice,0,376,181,195
4546,3202,Domažlice,1,423,201,222
4547,3202,Domažlice,2,424,236,188
4548,3202,Domažlice,3,409,211,198
4549,3202,Domažlice,4,400,202,198
4550,3202,Domažlice,5,441,229,212
4551,3202,Domažlice,6,389,191,198
4552,3202,Domažlice,7,388,196,192
4553,3202,Domažlice,8,425,224,201
4554,3202,Domažlice,9,388,204,184
4555,3202,Domažlice,10,447,205,242
4556,3202,Domažlice,11,487,242,245
4557,3202,Domažlice,12,502,245,257
4558,3202,Domažlice,13,454,223,231
4559,3202,Domažlice,14,421,221,200
4560,3202,Domažlice,15,412,205,207
4561,3202,Domažlice,16,380,192,188
4562,3202,Domažlice,17,417,203,214
4563,3202,Domažlice,18,365,181,184
4564,3202,Domažlice,19,365,190,175
4565,3202,Domažlice,20,404,207,197
4566,3202,Domažlice,21,367,186,181
4567,3202,Domažlice,22,357,194,163
4568,3202,Domažlice,23,343,188,155
4569,3202,Domažlice,24,403,215,188
4570,3202,Domažlice,25,387,196,191
4571,3202,Domažlice,26,440,213,227
4572,3202,Domažlice,27,514,261,253
4573,3202,Domažlice,28,486,268,218
4574,3202,Domažlice,29,539,270,269
4575,3202,Domažlice,30,498,252,246
4576,3202,Domažlice,31,527,280,247
4577,3202,Domažlice,32,536,277,259
4578,3202,Domažlice,33,529,271,258
4579,3202,Domažlice,34,516,258,258
4580,3202,Domažlice,35,492,271,221
4581,3202,Domažlice,36,517,275,242
4582,3202,Domažlice,37,461,244,217
4583,3202,Domažlice,38,508,272,236
4584,3202,Domažlice,39,532,275,257
4585,3202,Domažlice,40,543,295,248
4586,3202,Domažlice,41,581,277,304
4587,3202,Domažlice,42,665,333,332
4588,3202,Domažlice,43,699,347,352
4589,3202,Domažlice,44,708,361,347
4590,3202,Domažlice,45,734,378,356
4591,3202,Domažlice,46,741,363,378
4592,3202,Domažlice,47,677,336,341
4593,3202,Domažlice,48,665,348,317
4594,3202,Domažlice,49,641,335,306
4595,3202,Domažlice,50,595,315,280
4596,3202,Domažlice,51,573,290,283
4597,3202,Domažlice,52,488,238,250
4598,3202,Domažlice,53,530,277,253
4599,3202,Domažlice,54,544,276,268
4600,3202,Domažlice,55,517,271,246
4601,3202,Domažlice,56,567,284,283
4602,3202,Domažlice,57,546,284,262
4603,3202,Domažlice,58,476,247,229
4604,3202,Domažlice,59,453,224,229
4605,3202,Domažlice,60,447,221,226
4606,3202,Domažlice,61,447,227,220
4607,3202,Domažlice,62,487,236,251
4608,3202,Domažlice,63,532,262,270
4609,3202,Domažlice,64,571,240,331
4610,3202,Domažlice,65,521,254,267
4611,3202,Domažlice,66,558,277,281
4612,3202,Domažlice,67,551,279,272
4613,3202,Domažlice,68,566,274,292
4614,3202,Domažlice,69,514,257,257
4615,3202,Domažlice,70,504,238,266
4616,3202,Domažlice,71,526,252,274
4617,3202,Domažlice,72,506,240,266
4618,3202,Domažlice,73,522,240,282
4619,3202,Domažlice,74,435,186,249
4620,3202,Domažlice,75,348,148,200
4621,3202,Domažlice,76,351,144,207
4622,3202,Domažlice,77,343,144,199
4623,3202,Domažlice,78,275,121,154
4624,3202,Domažlice,79,249,94,155
4625,3202,Domažlice,80,239,98,141
4626,3202,Domažlice,81,199,66,133
4627,3202,Domažlice,82,179,65,114
4628,3202,Domažlice,83,132,58,74
4629,3202,Domažlice,84,153,63,90
4630,3202,Domažlice,85,130,45,85
4631,3202,Domažlice,86,119,34,85
4632,3202,Domažlice,87,75,27,48
4633,3202,Domažlice,88,90,24,66
4634,3202,Domažlice,89,88,25,63
4635,3202,Domažlice,90,44,17,27
4636,3202,Domažlice,91,57,14,43
4637,3202,Domažlice,92,19,6,13
4638,3202,Domažlice,93,20,8,12
4639,3202,Domažlice,94,16,2,14
4640,3202,Domažlice,95,16,5,11
4641,3202,Domažlice,96,9,1,8
4642,3202,Domažlice,97,5,1,4
4643,3202,Domažlice,98,2,0,2
4644,3202,Domažlice,99,2,1,1
4645,3202,Domažlice,100,5,2,3
4646,3203,Horažďovice,0,103,59,44
4647,3203,Horažďovice,1,92,53,39
4648,3203,Horažďovice,2,92,46,46
4649,3203,Horažďovice,3,108,51,57
4650,3203,Horažďovice,4,101,51,50
4651,3203,Horažďovice,5,97,50,47
4652,3203,Horažďovice,6,87,45,42
4653,3203,Horažďovice,7,103,52,51
4654,3203,Horažďovice,8,105,55,50
4655,3203,Horažďovice,9,114,46,68
4656,3203,Horažďovice,10,104,53,51
4657,3203,Horažďovice,11,122,74,48
4658,3203,Horažďovice,12,134,69,65
4659,3203,Horažďovice,13,109,52,57
4660,3203,Horažďovice,14,121,56,65
4661,3203,Horažďovice,15,121,67,54
4662,3203,Horažďovice,16,96,55,41
4663,3203,Horažďovice,17,101,52,49
4664,3203,Horažďovice,18,117,66,51
4665,3203,Horažďovice,19,116,53,63
4666,3203,Horažďovice,20,105,50,55
4667,3203,Horažďovice,21,107,56,51
4668,3203,Horažďovice,22,103,54,49
4669,3203,Horažďovice,23,86,43,43
4670,3203,Horažďovice,24,140,73,67
4671,3203,Horažďovice,25,105,69,36
4672,3203,Horažďovice,26,133,73,60
4673,3203,Horažďovice,27,133,75,58
4674,3203,Horažďovice,28,135,71,64
4675,3203,Horažďovice,29,146,83,63
4676,3203,Horažďovice,30,141,82,59
4677,3203,Horažďovice,31,123,68,55
4678,3203,Horažďovice,32,116,64,52
4679,3203,Horažďovice,33,131,76,55
4680,3203,Horažďovice,34,127,65,62
4681,3203,Horažďovice,35,126,62,64
4682,3203,Horažďovice,36,128,67,61
4683,3203,Horažďovice,37,130,69,61
4684,3203,Horažďovice,38,131,73,58
4685,3203,Horažďovice,39,127,71,56
4686,3203,Horažďovice,40,162,88,74
4687,3203,Horažďovice,41,170,81,89
4688,3203,Horažďovice,42,160,86,74
4689,3203,Horažďovice,43,175,94,81
4690,3203,Horažďovice,44,198,94,104
4691,3203,Horažďovice,45,202,100,102
4692,3203,Horažďovice,46,196,84,112
4693,3203,Horažďovice,47,221,126,95
4694,3203,Horažďovice,48,176,102,74
4695,3203,Horažďovice,49,184,98,86
4696,3203,Horažďovice,50,156,82,74
4697,3203,Horažďovice,51,164,95,69
4698,3203,Horažďovice,52,139,72,67
4699,3203,Horažďovice,53,158,89,69
4700,3203,Horažďovice,54,152,79,73
4701,3203,Horažďovice,55,162,88,74
4702,3203,Horažďovice,56,162,71,91
4703,3203,Horažďovice,57,151,76,75
4704,3203,Horažďovice,58,165,88,77
4705,3203,Horažďovice,59,145,64,81
4706,3203,Horažďovice,60,154,73,81
4707,3203,Horažďovice,61,135,79,56
4708,3203,Horažďovice,62,157,76,81
4709,3203,Horažďovice,63,189,106,83
4710,3203,Horažďovice,64,163,77,86
4711,3203,Horažďovice,65,175,81,94
4712,3203,Horažďovice,66,146,76,70
4713,3203,Horažďovice,67,149,72,77
4714,3203,Horažďovice,68,177,84,93
4715,3203,Horažďovice,69,170,91,79
4716,3203,Horažďovice,70,150,75,75
4717,3203,Horažďovice,71,148,62,86
4718,3203,Horažďovice,72,145,72,73
4719,3203,Horažďovice,73,162,68,94
4720,3203,Horažďovice,74,132,63,69
4721,3203,Horažďovice,75,136,55,81
4722,3203,Horažďovice,76,118,45,73
4723,3203,Horažďovice,77,109,53,56
4724,3203,Horažďovice,78,92,45,47
4725,3203,Horažďovice,79,91,38,53
4726,3203,Horažďovice,80,80,29,51
4727,3203,Horažďovice,81,84,29,55
4728,3203,Horažďovice,82,78,25,53
4729,3203,Horažďovice,83,68,22,46
4730,3203,Horažďovice,84,36,16,20
4731,3203,Horažďovice,85,60,18,42
4732,3203,Horažďovice,86,39,11,28
4733,3203,Horažďovice,87,36,5,31
4734,3203,Horažďovice,88,37,8,29
4735,3203,Horažďovice,89,23,9,14
4736,3203,Horažďovice,90,24,2,22
4737,3203,Horažďovice,91,14,6,8
4738,3203,Horažďovice,92,12,4,8
4739,3203,Horažďovice,93,5,1,4
4740,3203,Horažďovice,94,4,1,3
4741,3203,Horažďovice,95,6,2,4
4742,3203,Horažďovice,96,2,0,2
4743,3203,Horažďovice,97,0,0,0
4744,3203,Horažďovice,98,1,0,1
4745,3203,Horažďovice,99,1,0,1
4746,3203,Horažďovice,100,3,1,2
4747,3204,Horšovský Týn,0,148,75,73
4748,3204,Horšovský Týn,1,154,84,70
4749,3204,Horšovský Týn,2,140,73,67
4750,3204,Horšovský Týn,3,153,76,77
4751,3204,Horšovský Týn,4,175,92,83
4752,3204,Horšovský Týn,5,149,75,74
4753,3204,Horšovský Týn,6,152,82,70
4754,3204,Horšovský Týn,7,154,65,89
4755,3204,Horšovský Týn,8,135,72,63
4756,3204,Horšovský Týn,9,154,83,71
4757,3204,Horšovský Týn,10,184,93,91
4758,3204,Horšovský Týn,11,185,89,96
4759,3204,Horšovský Týn,12,184,96,88
4760,3204,Horšovský Týn,13,180,92,88
4761,3204,Horšovský Týn,14,151,78,73
4762,3204,Horšovský Týn,15,172,88,84
4763,3204,Horšovský Týn,16,147,79,68
4764,3204,Horšovský Týn,17,168,95,73
4765,3204,Horšovský Týn,18,158,78,80
4766,3204,Horšovský Týn,19,149,71,78
4767,3204,Horšovský Týn,20,150,71,79
4768,3204,Horšovský Týn,21,124,73,51
4769,3204,Horšovský Týn,22,136,67,69
4770,3204,Horšovský Týn,23,112,58,54
4771,3204,Horšovský Týn,24,135,78,57
4772,3204,Horšovský Týn,25,148,83,65
4773,3204,Horšovský Týn,26,184,91,93
4774,3204,Horšovský Týn,27,188,98,90
4775,3204,Horšovský Týn,28,168,101,67
4776,3204,Horšovský Týn,29,208,112,96
4777,3204,Horšovský Týn,30,171,92,79
4778,3204,Horšovský Týn,31,195,103,92
4779,3204,Horšovský Týn,32,156,84,72
4780,3204,Horšovský Týn,33,185,93,92
4781,3204,Horšovský Týn,34,166,91,75
4782,3204,Horšovský Týn,35,184,89,95
4783,3204,Horšovský Týn,36,199,100,99
4784,3204,Horšovský Týn,37,215,117,98
4785,3204,Horšovský Týn,38,207,115,92
4786,3204,Horšovský Týn,39,197,108,89
4787,3204,Horšovský Týn,40,197,97,100
4788,3204,Horšovský Týn,41,266,146,120
4789,3204,Horšovský Týn,42,226,114,112
4790,3204,Horšovský Týn,43,287,161,126
4791,3204,Horšovský Týn,44,263,135,128
4792,3204,Horšovský Týn,45,288,153,135
4793,3204,Horšovský Týn,46,262,133,129
4794,3204,Horšovský Týn,47,240,125,115
4795,3204,Horšovský Týn,48,246,125,121
4796,3204,Horšovský Týn,49,208,98,110
4797,3204,Horšovský Týn,50,218,119,99
4798,3204,Horšovský Týn,51,213,117,96
4799,3204,Horšovský Týn,52,177,91,86
4800,3204,Horšovský Týn,53,178,97,81
4801,3204,Horšovský Týn,54,206,115,91
4802,3204,Horšovský Týn,55,179,89,90
4803,3204,Horšovský Týn,56,202,100,102
4804,3204,Horšovský Týn,57,182,90,92
4805,3204,Horšovský Týn,58,167,87,80
4806,3204,Horšovský Týn,59,182,90,92
4807,3204,Horšovský Týn,60,146,73,73
4808,3204,Horšovský Týn,61,160,82,78
4809,3204,Horšovský Týn,62,171,80,91
4810,3204,Horšovský Týn,63,217,100,117
4811,3204,Horšovský Týn,64,224,120,104
4812,3204,Horšovský Týn,65,205,99,106
4813,3204,Horšovský Týn,66,227,120,107
4814,3204,Horšovský Týn,67,174,84,90
4815,3204,Horšovský Týn,68,224,103,121
4816,3204,Horšovský Týn,69,186,95,91
4817,3204,Horšovský Týn,70,199,86,113
4818,3204,Horšovský Týn,71,176,82,94
4819,3204,Horšovský Týn,72,169,84,85
4820,3204,Horšovský Týn,73,195,92,103
4821,3204,Horšovský Týn,74,166,75,91
4822,3204,Horšovský Týn,75,108,50,58
4823,3204,Horšovský Týn,76,92,36,56
4824,3204,Horšovský Týn,77,102,48,54
4825,3204,Horšovský Týn,78,93,39,54
4826,3204,Horšovský Týn,79,75,26,49
4827,3204,Horšovský Týn,80,79,32,47
4828,3204,Horšovský Týn,81,58,30,28
4829,3204,Horšovský Týn,82,40,17,23
4830,3204,Horšovský Týn,83,52,18,34
4831,3204,Horšovský Týn,84,41,14,27
4832,3204,Horšovský Týn,85,37,11,26
4833,3204,Horšovský Týn,86,36,8,28
4834,3204,Horšovský Týn,87,35,14,21
4835,3204,Horšovský Týn,88,29,13,16
4836,3204,Horšovský Týn,89,23,8,15
4837,3204,Horšovský Týn,90,19,5,14
4838,3204,Horšovský Týn,91,15,4,11
4839,3204,Horšovský Týn,92,7,2,5
4840,3204,Horšovský Týn,93,7,2,5
4841,3204,Horšovský Týn,94,3,0,3
4842,3204,Horšovský Týn,95,4,0,4
4843,3204,Horšovský Týn,96,2,1,1
4844,3204,Horšovský Týn,97,1,0,1
4845,3204,Horšovský Týn,98,0,0,0
4846,3204,Horšovský Týn,99,0,0,0
4847,3204,Horšovský Týn,100,0,0,0
4848,3205,Klatovy,0,525,246,279
4849,3205,Klatovy,1,497,245,252
4850,3205,Klatovy,2,477,245,232
4851,3205,Klatovy,3,481,253,228
4852,3205,Klatovy,4,504,235,269
4853,3205,Klatovy,5,471,258,213
4854,3205,Klatovy,6,465,241,224
4855,3205,Klatovy,7,485,237,248
4856,3205,Klatovy,8,504,253,251
4857,3205,Klatovy,9,487,247,240
4858,3205,Klatovy,10,546,272,274
4859,3205,Klatovy,11,576,293,283
4860,3205,Klatovy,12,535,287,248
4861,3205,Klatovy,13,598,319,279
4862,3205,Klatovy,14,534,287,247
4863,3205,Klatovy,15,514,256,258
4864,3205,Klatovy,16,525,262,263
4865,3205,Klatovy,17,484,237,247
4866,3205,Klatovy,18,501,274,227
4867,3205,Klatovy,19,456,231,225
4868,3205,Klatovy,20,468,228,240
4869,3205,Klatovy,21,444,233,211
4870,3205,Klatovy,22,440,224,216
4871,3205,Klatovy,23,473,232,241
4872,3205,Klatovy,24,470,225,245
4873,3205,Klatovy,25,512,272,240
4874,3205,Klatovy,26,512,279,233
4875,3205,Klatovy,27,631,307,324
4876,3205,Klatovy,28,541,278,263
4877,3205,Klatovy,29,617,332,285
4878,3205,Klatovy,30,648,350,298
4879,3205,Klatovy,31,624,322,302
4880,3205,Klatovy,32,603,311,292
4881,3205,Klatovy,33,577,294,283
4882,3205,Klatovy,34,638,338,300
4883,3205,Klatovy,35,629,353,276
4884,3205,Klatovy,36,658,342,316
4885,3205,Klatovy,37,675,349,326
4886,3205,Klatovy,38,683,351,332
4887,3205,Klatovy,39,665,348,317
4888,3205,Klatovy,40,716,364,352
4889,3205,Klatovy,41,753,385,368
4890,3205,Klatovy,42,847,464,383
4891,3205,Klatovy,43,850,444,406
4892,3205,Klatovy,44,870,428,442
4893,3205,Klatovy,45,948,461,487
4894,3205,Klatovy,46,886,460,426
4895,3205,Klatovy,47,870,436,434
4896,3205,Klatovy,48,770,391,379
4897,3205,Klatovy,49,699,349,350
4898,3205,Klatovy,50,700,395,305
4899,3205,Klatovy,51,712,358,354
4900,3205,Klatovy,52,674,342,332
4901,3205,Klatovy,53,695,346,349
4902,3205,Klatovy,54,649,329,320
4903,3205,Klatovy,55,713,360,353
4904,3205,Klatovy,56,680,335,345
4905,3205,Klatovy,57,705,360,345
4906,3205,Klatovy,58,593,270,323
4907,3205,Klatovy,59,651,311,340
4908,3205,Klatovy,60,544,263,281
4909,3205,Klatovy,61,582,284,298
4910,3205,Klatovy,62,597,311,286
4911,3205,Klatovy,63,683,330,353
4912,3205,Klatovy,64,696,351,345
4913,3205,Klatovy,65,732,349,383
4914,3205,Klatovy,66,678,308,370
4915,3205,Klatovy,67,701,327,374
4916,3205,Klatovy,68,702,336,366
4917,3205,Klatovy,69,667,300,367
4918,3205,Klatovy,70,635,303,332
4919,3205,Klatovy,71,631,303,328
4920,3205,Klatovy,72,686,330,356
4921,3205,Klatovy,73,676,308,368
4922,3205,Klatovy,74,626,299,327
4923,3205,Klatovy,75,494,218,276
4924,3205,Klatovy,76,461,192,269
4925,3205,Klatovy,77,449,174,275
4926,3205,Klatovy,78,369,162,207
4927,3205,Klatovy,79,327,131,196
4928,3205,Klatovy,80,280,107,173
4929,3205,Klatovy,81,275,121,154
4930,3205,Klatovy,82,229,93,136
4931,3205,Klatovy,83,173,65,108
4932,3205,Klatovy,84,185,74,111
4933,3205,Klatovy,85,145,44,101
4934,3205,Klatovy,86,152,47,105
4935,3205,Klatovy,87,170,54,116
4936,3205,Klatovy,88,97,28,69
4937,3205,Klatovy,89,97,26,71
4938,3205,Klatovy,90,74,25,49
4939,3205,Klatovy,91,68,15,53
4940,3205,Klatovy,92,41,13,28
4941,3205,Klatovy,93,42,9,33
4942,3205,Klatovy,94,22,2,20
4943,3205,Klatovy,95,21,3,18
4944,3205,Klatovy,96,10,3,7
4945,3205,Klatovy,97,9,1,8
4946,3205,Klatovy,98,1,1,0
4947,3205,Klatovy,99,4,1,3
4948,3205,Klatovy,100,5,2,3
4949,3206,Kralovice,0,210,104,106
4950,3206,Kralovice,1,192,102,90
4951,3206,Kralovice,2,231,123,108
4952,3206,Kralovice,3,197,109,88
4953,3206,Kralovice,4,221,114,107
4954,3206,Kralovice,5,236,115,121
4955,3206,Kralovice,6,194,100,94
4956,3206,Kralovice,7,216,123,93
4957,3206,Kralovice,8,195,94,101
4958,3206,Kralovice,9,209,102,107
4959,3206,Kralovice,10,225,110,115
4960,3206,Kralovice,11,228,115,113
4961,3206,Kralovice,12,277,151,126
4962,3206,Kralovice,13,236,124,112
4963,3206,Kralovice,14,231,117,114
4964,3206,Kralovice,15,213,108,105
4965,3206,Kralovice,16,222,103,119
4966,3206,Kralovice,17,209,103,106
4967,3206,Kralovice,18,202,113,89
4968,3206,Kralovice,19,205,94,111
4969,3206,Kralovice,20,213,98,115
4970,3206,Kralovice,21,202,109,93
4971,3206,Kralovice,22,220,112,108
4972,3206,Kralovice,23,198,104,94
4973,3206,Kralovice,24,212,110,102
4974,3206,Kralovice,25,242,131,111
4975,3206,Kralovice,26,286,154,132
4976,3206,Kralovice,27,267,147,120
4977,3206,Kralovice,28,256,140,116
4978,3206,Kralovice,29,324,171,153
4979,3206,Kralovice,30,280,166,114
4980,3206,Kralovice,31,277,147,130
4981,3206,Kralovice,32,269,155,114
4982,3206,Kralovice,33,255,129,126
4983,3206,Kralovice,34,290,139,151
4984,3206,Kralovice,35,271,140,131
4985,3206,Kralovice,36,310,173,137
4986,3206,Kralovice,37,255,118,137
4987,3206,Kralovice,38,286,161,125
4988,3206,Kralovice,39,302,160,142
4989,3206,Kralovice,40,322,178,144
4990,3206,Kralovice,41,361,183,178
4991,3206,Kralovice,42,378,186,192
4992,3206,Kralovice,43,397,196,201
4993,3206,Kralovice,44,402,201,201
4994,3206,Kralovice,45,416,215,201
4995,3206,Kralovice,46,445,225,220
4996,3206,Kralovice,47,376,194,182
4997,3206,Kralovice,48,334,170,164
4998,3206,Kralovice,49,306,163,143
4999,3206,Kralovice,50,300,165,135
5000,3206,Kralovice,51,298,160,138
5001,3206,Kralovice,52,258,135,123
5002,3206,Kralovice,53,244,125,119
5003,3206,Kralovice,54,338,174,164
5004,3206,Kralovice,55,308,166,142
5005,3206,Kralovice,56,323,167,156
5006,3206,Kralovice,57,288,140,148
5007,3206,Kralovice,58,246,119,127
5008,3206,Kralovice,59,251,117,134
5009,3206,Kralovice,60,274,153,121
5010,3206,Kralovice,61,286,142,144
5011,3206,Kralovice,62,276,142,134
5012,3206,Kralovice,63,307,160,147
5013,3206,Kralovice,64,290,128,162
5014,3206,Kralovice,65,328,162,166
5015,3206,Kralovice,66,332,147,185
5016,3206,Kralovice,67,344,162,182
5017,3206,Kralovice,68,316,147,169
5018,3206,Kralovice,69,338,167,171
5019,3206,Kralovice,70,309,161,148
5020,3206,Kralovice,71,277,149,128
5021,3206,Kralovice,72,283,135,148
5022,3206,Kralovice,73,277,130,147
5023,3206,Kralovice,74,248,102,146
5024,3206,Kralovice,75,224,102,122
5025,3206,Kralovice,76,179,74,105
5026,3206,Kralovice,77,190,79,111
5027,3206,Kralovice,78,164,66,98
5028,3206,Kralovice,79,144,56,88
5029,3206,Kralovice,80,140,62,78
5030,3206,Kralovice,81,131,62,69
5031,3206,Kralovice,82,100,39,61
5032,3206,Kralovice,83,94,35,59
5033,3206,Kralovice,84,72,29,43
5034,3206,Kralovice,85,73,23,50
5035,3206,Kralovice,86,62,21,41
5036,3206,Kralovice,87,51,15,36
5037,3206,Kralovice,88,50,20,30
5038,3206,Kralovice,89,43,18,25
5039,3206,Kralovice,90,42,14,28
5040,3206,Kralovice,91,20,9,11
5041,3206,Kralovice,92,27,6,21
5042,3206,Kralovice,93,14,5,9
5043,3206,Kralovice,94,7,4,3
5044,3206,Kralovice,95,8,3,5
5045,3206,Kralovice,96,5,1,4
5046,3206,Kralovice,97,6,0,6
5047,3206,Kralovice,98,0,0,0
5048,3206,Kralovice,99,2,1,1
5049,3206,Kralovice,100,2,0,2
5050,3207,Nepomuk,0,86,35,51
5051,3207,Nepomuk,1,83,38,45
5052,3207,Nepomuk,2,115,61,54
5053,3207,Nepomuk,3,118,65,53
5054,3207,Nepomuk,4,95,46,49
5055,3207,Nepomuk,5,102,47,55
5056,3207,Nepomuk,6,112,57,55
5057,3207,Nepomuk,7,124,65,59
5058,3207,Nepomuk,8,121,62,59
5059,3207,Nepomuk,9,93,42,51
5060,3207,Nepomuk,10,120,58,62
5061,3207,Nepomuk,11,132,65,67
5062,3207,Nepomuk,12,127,67,60
5063,3207,Nepomuk,13,124,59,65
5064,3207,Nepomuk,14,101,51,50
5065,3207,Nepomuk,15,126,66,60
5066,3207,Nepomuk,16,105,55,50
5067,3207,Nepomuk,17,97,51,46
5068,3207,Nepomuk,18,92,46,46
5069,3207,Nepomuk,19,95,45,50
5070,3207,Nepomuk,20,101,57,44
5071,3207,Nepomuk,21,92,44,48
5072,3207,Nepomuk,22,95,47,48
5073,3207,Nepomuk,23,93,45,48
5074,3207,Nepomuk,24,107,57,50
5075,3207,Nepomuk,25,99,56,43
5076,3207,Nepomuk,26,114,65,49
5077,3207,Nepomuk,27,144,88,56
5078,3207,Nepomuk,28,116,61,55
5079,3207,Nepomuk,29,134,68,66
5080,3207,Nepomuk,30,98,58,40
5081,3207,Nepomuk,31,137,70,67
5082,3207,Nepomuk,32,131,77,54
5083,3207,Nepomuk,33,137,80,57
5084,3207,Nepomuk,34,148,83,65
5085,3207,Nepomuk,35,166,90,76
5086,3207,Nepomuk,36,152,76,76
5087,3207,Nepomuk,37,145,82,63
5088,3207,Nepomuk,38,159,90,69
5089,3207,Nepomuk,39,173,100,73
5090,3207,Nepomuk,40,189,117,72
5091,3207,Nepomuk,41,178,106,72
5092,3207,Nepomuk,42,199,105,94
5093,3207,Nepomuk,43,196,109,87
5094,3207,Nepomuk,44,200,106,94
5095,3207,Nepomuk,45,209,110,99
5096,3207,Nepomuk,46,218,134,84
5097,3207,Nepomuk,47,201,117,84
5098,3207,Nepomuk,48,167,84,83
5099,3207,Nepomuk,49,165,87,78
5100,3207,Nepomuk,50,160,83,77
5101,3207,Nepomuk,51,153,90,63
5102,3207,Nepomuk,52,171,100,71
5103,3207,Nepomuk,53,142,87,55
5104,3207,Nepomuk,54,137,68,69
5105,3207,Nepomuk,55,143,77,66
5106,3207,Nepomuk,56,179,108,71
5107,3207,Nepomuk,57,170,90,80
5108,3207,Nepomuk,58,146,91,55
5109,3207,Nepomuk,59,135,77,58
5110,3207,Nepomuk,60,130,67,63
5111,3207,Nepomuk,61,142,80,62
5112,3207,Nepomuk,62,138,69,69
5113,3207,Nepomuk,63,149,72,77
5114,3207,Nepomuk,64,167,73,94
5115,3207,Nepomuk,65,170,84,86
5116,3207,Nepomuk,66,190,107,83
5117,3207,Nepomuk,67,193,102,91
5118,3207,Nepomuk,68,192,93,99
5119,3207,Nepomuk,69,173,90,83
5120,3207,Nepomuk,70,137,79,58
5121,3207,Nepomuk,71,165,78,87
5122,3207,Nepomuk,72,185,84,101
5123,3207,Nepomuk,73,164,82,82
5124,3207,Nepomuk,74,143,70,73
5125,3207,Nepomuk,75,90,36,54
5126,3207,Nepomuk,76,131,55,76
5127,3207,Nepomuk,77,104,50,54
5128,3207,Nepomuk,78,87,41,46
5129,3207,Nepomuk,79,71,31,40
5130,3207,Nepomuk,80,79,38,41
5131,3207,Nepomuk,81,74,31,43
5132,3207,Nepomuk,82,62,23,39
5133,3207,Nepomuk,83,45,19,26
5134,3207,Nepomuk,84,47,15,32
5135,3207,Nepomuk,85,35,12,23
5136,3207,Nepomuk,86,43,14,29
5137,3207,Nepomuk,87,25,8,17
5138,3207,Nepomuk,88,25,8,17
5139,3207,Nepomuk,89,23,9,14
5140,3207,Nepomuk,90,9,1,8
5141,3207,Nepomuk,91,13,4,9
5142,3207,Nepomuk,92,10,3,7
5143,3207,Nepomuk,93,10,4,6
5144,3207,Nepomuk,94,4,1,3
5145,3207,Nepomuk,95,5,3,2
5146,3207,Nepomuk,96,1,0,1
5147,3207,Nepomuk,97,1,0,1
5148,3207,Nepomuk,98,2,0,2
5149,3207,Nepomuk,99,2,0,2
5150,3207,Nepomuk,100,0,0,0
5151,3208,Nýřany,0,616,323,293
5152,3208,Nýřany,1,619,320,299
5153,3208,Nýřany,2,656,358,298
5154,3208,Nýřany,3,637,315,322
5155,3208,Nýřany,4,629,332,297
5156,3208,Nýřany,5,681,353,328
5157,3208,Nýřany,6,615,316,299
5158,3208,Nýřany,7,600,310,290
5159,3208,Nýřany,8,616,310,306
5160,3208,Nýřany,9,626,292,334
5161,3208,Nýřany,10,753,376,377
5162,3208,Nýřany,11,704,388,316
5163,3208,Nýřany,12,721,359,362
5164,3208,Nýřany,13,749,384,365
5165,3208,Nýřany,14,634,335,299
5166,3208,Nýřany,15,599,317,282
5167,3208,Nýřany,16,567,310,257
5168,3208,Nýřany,17,535,263,272
5169,3208,Nýřany,18,530,274,256
5170,3208,Nýřany,19,539,280,259
5171,3208,Nýřany,20,470,226,244
5172,3208,Nýřany,21,550,287,263
5173,3208,Nýřany,22,535,270,265
5174,3208,Nýřany,23,536,271,265
5175,3208,Nýřany,24,529,266,263
5176,3208,Nýřany,25,551,285,266
5177,3208,Nýřany,26,645,318,327
5178,3208,Nýřany,27,709,363,346
5179,3208,Nýřany,28,713,365,348
5180,3208,Nýřany,29,801,393,408
5181,3208,Nýřany,30,763,399,364
5182,3208,Nýřany,31,759,396,363
5183,3208,Nýřany,32,794,381,413
5184,3208,Nýřany,33,753,387,366
5185,3208,Nýřany,34,799,417,382
5186,3208,Nýřany,35,796,408,388
5187,3208,Nýřany,36,850,454,396
5188,3208,Nýřany,37,855,422,433
5189,3208,Nýřany,38,894,459,435
5190,3208,Nýřany,39,861,463,398
5191,3208,Nýřany,40,922,488,434
5192,3208,Nýřany,41,1024,512,512
5193,3208,Nýřany,42,1034,534,500
5194,3208,Nýřany,43,1023,536,487
5195,3208,Nýřany,44,1114,519,595
5196,3208,Nýřany,45,1113,575,538
5197,3208,Nýřany,46,1166,622,544
5198,3208,Nýřany,47,982,540,442
5199,3208,Nýřany,48,942,487,455
5200,3208,Nýřany,49,848,440,408
5201,3208,Nýřany,50,819,428,391
5202,3208,Nýřany,51,778,391,387
5203,3208,Nýřany,52,737,396,341
5204,3208,Nýřany,53,732,376,356
5205,3208,Nýřany,54,777,399,378
5206,3208,Nýřany,55,693,328,365
5207,3208,Nýřany,56,790,408,382
5208,3208,Nýřany,57,726,367,359
5209,3208,Nýřany,58,663,336,327
5210,3208,Nýřany,59,675,348,327
5211,3208,Nýřany,60,600,319,281
5212,3208,Nýřany,61,565,280,285
5213,3208,Nýřany,62,651,341,310
5214,3208,Nýřany,63,701,342,359
5215,3208,Nýřany,64,683,325,358
5216,3208,Nýřany,65,676,338,338
5217,3208,Nýřany,66,685,326,359
5218,3208,Nýřany,67,673,297,376
5219,3208,Nýřany,68,728,340,388
5220,3208,Nýřany,69,673,339,334
5221,3208,Nýřany,70,640,301,339
5222,3208,Nýřany,71,635,295,340
5223,3208,Nýřany,72,622,293,329
5224,3208,Nýřany,73,667,303,364
5225,3208,Nýřany,74,587,244,343
5226,3208,Nýřany,75,443,203,240
5227,3208,Nýřany,76,468,212,256
5228,3208,Nýřany,77,398,171,227
5229,3208,Nýřany,78,354,154,200
5230,3208,Nýřany,79,337,141,196
5231,3208,Nýřany,80,325,134,191
5232,3208,Nýřany,81,240,96,144
5233,3208,Nýřany,82,237,102,135
5234,3208,Nýřany,83,210,89,121
5235,3208,Nýřany,84,165,52,113
5236,3208,Nýřany,85,154,66,88
5237,3208,Nýřany,86,127,38,89
5238,3208,Nýřany,87,117,44,73
5239,3208,Nýřany,88,110,32,78
5240,3208,Nýřany,89,102,38,64
5241,3208,Nýřany,90,82,23,59
5242,3208,Nýřany,91,53,17,36
5243,3208,Nýřany,92,27,8,19
5244,3208,Nýřany,93,36,7,29
5245,3208,Nýřany,94,23,7,16
5246,3208,Nýřany,95,15,2,13
5247,3208,Nýřany,96,7,2,5
5248,3208,Nýřany,97,8,1,7
5249,3208,Nýřany,98,1,0,1
5250,3208,Nýřany,99,5,1,4
5251,3208,Nýřany,100,4,2,2
5252,3209,Plzeň,0,1973,1037,936
5253,3209,Plzeň,1,2050,1067,983
5254,3209,Plzeň,2,2086,1049,1037
5255,3209,Plzeň,3,2088,1008,1080
5256,3209,Plzeň,4,2011,1039,972
5257,3209,Plzeň,5,2037,1055,982
5258,3209,Plzeň,6,2010,1049,961
5259,3209,Plzeň,7,1873,922,951
5260,3209,Plzeň,8,1949,982,967
5261,3209,Plzeň,9,1929,981,948
5262,3209,Plzeň,10,2100,1050,1050
5263,3209,Plzeň,11,2186,1112,1074
5264,3209,Plzeň,12,2117,1074,1043
5265,3209,Plzeň,13,1970,972,998
5266,3209,Plzeň,14,1889,962,927
5267,3209,Plzeň,15,1696,912,784
5268,3209,Plzeň,16,1588,808,780
5269,3209,Plzeň,17,1518,807,711
5270,3209,Plzeň,18,1575,764,811
5271,3209,Plzeň,19,1586,768,818
5272,3209,Plzeň,20,1594,828,766
5273,3209,Plzeň,21,1551,802,749
5274,3209,Plzeň,22,1549,789,760
5275,3209,Plzeň,23,1594,798,796
5276,3209,Plzeň,24,1708,862,846
5277,3209,Plzeň,25,1809,924,885
5278,3209,Plzeň,26,2091,1137,954
5279,3209,Plzeň,27,2222,1150,1072
5280,3209,Plzeň,28,2313,1153,1160
5281,3209,Plzeň,29,2555,1303,1252
5282,3209,Plzeň,30,2766,1402,1364
5283,3209,Plzeň,31,2787,1433,1354
5284,3209,Plzeň,32,2903,1470,1433
5285,3209,Plzeň,33,2937,1566,1371
5286,3209,Plzeň,34,2971,1598,1373
5287,3209,Plzeň,35,3130,1610,1520
5288,3209,Plzeň,36,2992,1554,1438
5289,3209,Plzeň,37,3059,1566,1493
5290,3209,Plzeň,38,3157,1648,1509
5291,3209,Plzeň,39,2956,1547,1409
5292,3209,Plzeň,40,3222,1646,1576
5293,3209,Plzeň,41,3288,1717,1571
5294,3209,Plzeň,42,3313,1714,1599
5295,3209,Plzeň,43,3337,1691,1646
5296,3209,Plzeň,44,3402,1737,1665
5297,3209,Plzeň,45,3503,1759,1744
5298,3209,Plzeň,46,3490,1788,1702
5299,3209,Plzeň,47,3252,1647,1605
5300,3209,Plzeň,48,2887,1471,1416
5301,3209,Plzeň,49,2623,1378,1245
5302,3209,Plzeň,50,2552,1295,1257
5303,3209,Plzeň,51,2421,1234,1187
5304,3209,Plzeň,52,2341,1186,1155
5305,3209,Plzeň,53,2296,1133,1163
5306,3209,Plzeň,54,2409,1240,1169
5307,3209,Plzeň,55,2416,1257,1159
5308,3209,Plzeň,56,2533,1256,1277
5309,3209,Plzeň,57,2447,1217,1230
5310,3209,Plzeň,58,2124,1000,1124
5311,3209,Plzeň,59,2121,1022,1099
5312,3209,Plzeň,60,2076,966,1110
5313,3209,Plzeň,61,2135,994,1141
5314,3209,Plzeň,62,2162,1003,1159
5315,3209,Plzeň,63,2262,1060,1202
5316,3209,Plzeň,64,2380,1120,1260
5317,3209,Plzeň,65,2539,1208,1331
5318,3209,Plzeň,66,2472,1155,1317
5319,3209,Plzeň,67,2532,1174,1358
5320,3209,Plzeň,68,2446,1158,1288
5321,3209,Plzeň,69,2148,987,1161
5322,3209,Plzeň,70,2216,979,1237
5323,3209,Plzeň,71,2124,950,1174
5324,3209,Plzeň,72,2148,916,1232
5325,3209,Plzeň,73,2259,953,1306
5326,3209,Plzeň,74,2221,904,1317
5327,3209,Plzeň,75,1860,745,1115
5328,3209,Plzeň,76,2020,787,1233
5329,3209,Plzeň,77,1816,772,1044
5330,3209,Plzeň,78,1553,656,897
5331,3209,Plzeň,79,1407,603,804
5332,3209,Plzeň,80,1270,568,702
5333,3209,Plzeň,81,1083,429,654
5334,3209,Plzeň,82,976,387,589
5335,3209,Plzeň,83,875,320,555
5336,3209,Plzeň,84,839,306,533
5337,3209,Plzeň,85,719,270,449
5338,3209,Plzeň,86,676,237,439
5339,3209,Plzeň,87,550,192,358
5340,3209,Plzeň,88,507,161,346
5341,3209,Plzeň,89,421,129,292
5342,3209,Plzeň,90,397,118,279
5343,3209,Plzeň,91,268,86,182
5344,3209,Plzeň,92,198,62,136
5345,3209,Plzeň,93,138,43,95
5346,3209,Plzeň,94,108,24,84
5347,3209,Plzeň,95,75,14,61
5348,3209,Plzeň,96,46,18,28
5349,3209,Plzeň,97,37,8,29
5350,3209,Plzeň,98,16,6,10
5351,3209,Plzeň,99,5,2,3
5352,3209,Plzeň,100,8,1,7
5353,3210,Přeštice,0,235,118,117
5354,3210,Přeštice,1,258,133,125
5355,3210,Přeštice,2,239,120,119
5356,3210,Přeštice,3,263,136,127
5357,3210,Přeštice,4,225,117,108
5358,3210,Přeštice,5,226,133,93
5359,3210,Přeštice,6,254,133,121
5360,3210,Přeštice,7,202,113,89
5361,3210,Přeštice,8,238,119,119
5362,3210,Přeštice,9,236,129,107
5363,3210,Přeštice,10,258,127,131
5364,3210,Přeštice,11,273,134,139
5365,3210,Přeštice,12,269,131,138
5366,3210,Přeštice,13,240,120,120
5367,3210,Přeštice,14,255,127,128
5368,3210,Přeštice,15,218,106,112
5369,3210,Přeštice,16,197,101,96
5370,3210,Přeštice,17,189,102,87
5371,3210,Přeštice,18,225,105,120
5372,3210,Přeštice,19,196,91,105
5373,3210,Přeštice,20,197,111,86
5374,3210,Přeštice,21,197,100,97
5375,3210,Přeštice,22,217,121,96
5376,3210,Přeštice,23,232,124,108
5377,3210,Přeštice,24,212,119,93
5378,3210,Přeštice,25,244,145,99
5379,3210,Přeštice,26,227,109,118
5380,3210,Přeštice,27,274,161,113
5381,3210,Přeštice,28,229,132,97
5382,3210,Přeštice,29,294,128,166
5383,3210,Přeštice,30,263,120,143
5384,3210,Přeštice,31,287,129,158
5385,3210,Přeštice,32,310,165,145
5386,3210,Přeštice,33,304,159,145
5387,3210,Přeštice,34,311,174,137
5388,3210,Přeštice,35,300,166,134
5389,3210,Přeštice,36,301,155,146
5390,3210,Přeštice,37,349,188,161
5391,3210,Přeštice,38,317,172,145
5392,3210,Přeštice,39,361,181,180
5393,3210,Přeštice,40,346,188,158
5394,3210,Přeštice,41,380,185,195
5395,3210,Přeštice,42,412,212,200
5396,3210,Přeštice,43,376,184,192
5397,3210,Přeštice,44,427,222,205
5398,3210,Přeštice,45,404,203,201
5399,3210,Přeštice,46,441,247,194
5400,3210,Přeštice,47,402,212,190
5401,3210,Přeštice,48,356,176,180
5402,3210,Přeštice,49,366,187,179
5403,3210,Přeštice,50,309,168,141
5404,3210,Přeštice,51,316,169,147
5405,3210,Přeštice,52,282,136,146
5406,3210,Přeštice,53,288,156,132
5407,3210,Přeštice,54,314,170,144
5408,3210,Přeštice,55,325,177,148
5409,3210,Přeštice,56,313,166,147
5410,3210,Přeštice,57,274,143,131
5411,3210,Přeštice,58,249,130,119
5412,3210,Přeštice,59,307,160,147
5413,3210,Přeštice,60,262,117,145
5414,3210,Přeštice,61,229,123,106
5415,3210,Přeštice,62,282,142,140
5416,3210,Přeštice,63,266,126,140
5417,3210,Přeštice,64,315,161,154
5418,3210,Přeštice,65,315,172,143
5419,3210,Přeštice,66,263,129,134
5420,3210,Přeštice,67,321,162,159
5421,3210,Přeštice,68,291,117,174
5422,3210,Přeštice,69,265,118,147
5423,3210,Přeštice,70,246,125,121
5424,3210,Přeštice,71,275,132,143
5425,3210,Přeštice,72,253,128,125
5426,3210,Přeštice,73,272,122,150
5427,3210,Přeštice,74,267,113,154
5428,3210,Přeštice,75,193,86,107
5429,3210,Přeštice,76,213,95,118
5430,3210,Přeštice,77,191,74,117
5431,3210,Přeštice,78,171,74,97
5432,3210,Přeštice,79,121,53,68
5433,3210,Přeštice,80,141,60,81
5434,3210,Přeštice,81,108,38,70
5435,3210,Přeštice,82,105,43,62
5436,3210,Přeštice,83,68,29,39
5437,3210,Přeštice,84,69,26,43
5438,3210,Přeštice,85,60,26,34
5439,3210,Přeštice,86,56,20,36
5440,3210,Přeštice,87,58,16,42
5441,3210,Přeštice,88,56,19,37
5442,3210,Přeštice,89,38,12,26
5443,3210,Přeštice,90,36,10,26
5444,3210,Přeštice,91,29,4,25
5445,3210,Přeštice,92,20,9,11
5446,3210,Přeštice,93,14,5,9
5447,3210,Přeštice,94,8,1,7
5448,3210,Přeštice,95,9,0,9
5449,3210,Přeštice,96,3,1,2
5450,3210,Přeštice,97,3,1,2
5451,3210,Přeštice,98,2,1,1
5452,3210,Přeštice,99,1,1,0
5453,3210,Přeštice,100,1,0,1
5454,3211,Rokycany,0,513,259,254
5455,3211,Rokycany,1,522,289,233
5456,3211,Rokycany,2,534,281,253
5457,3211,Rokycany,3,522,261,261
5458,3211,Rokycany,4,512,247,265
5459,3211,Rokycany,5,498,276,222
5460,3211,Rokycany,6,495,261,234
5461,3211,Rokycany,7,480,257,223
5462,3211,Rokycany,8,552,261,291
5463,3211,Rokycany,9,467,243,224
5464,3211,Rokycany,10,536,289,247
5465,3211,Rokycany,11,524,280,244
5466,3211,Rokycany,12,565,298,267
5467,3211,Rokycany,13,532,265,267
5468,3211,Rokycany,14,490,257,233
5469,3211,Rokycany,15,463,237,226
5470,3211,Rokycany,16,431,218,213
5471,3211,Rokycany,17,418,205,213
5472,3211,Rokycany,18,446,243,203
5473,3211,Rokycany,19,395,204,191
5474,3211,Rokycany,20,466,236,230
5475,3211,Rokycany,21,393,212,181
5476,3211,Rokycany,22,442,232,210
5477,3211,Rokycany,23,402,200,202
5478,3211,Rokycany,24,445,210,235
5479,3211,Rokycany,25,493,263,230
5480,3211,Rokycany,26,532,283,249
5481,3211,Rokycany,27,599,312,287
5482,3211,Rokycany,28,630,323,307
5483,3211,Rokycany,29,622,324,298
5484,3211,Rokycany,30,622,322,300
5485,3211,Rokycany,31,646,324,322
5486,3211,Rokycany,32,677,367,310
5487,3211,Rokycany,33,666,365,301
5488,3211,Rokycany,34,675,348,327
5489,3211,Rokycany,35,628,307,321
5490,3211,Rokycany,36,647,320,327
5491,3211,Rokycany,37,709,384,325
5492,3211,Rokycany,38,701,351,350
5493,3211,Rokycany,39,720,376,344
5494,3211,Rokycany,40,735,360,375
5495,3211,Rokycany,41,762,417,345
5496,3211,Rokycany,42,824,449,375
5497,3211,Rokycany,43,848,425,423
5498,3211,Rokycany,44,925,492,433
5499,3211,Rokycany,45,869,457,412
5500,3211,Rokycany,46,852,444,408
5501,3211,Rokycany,47,897,495,402
5502,3211,Rokycany,48,766,378,388
5503,3211,Rokycany,49,730,385,345
5504,3211,Rokycany,50,717,368,349
5505,3211,Rokycany,51,645,351,294
5506,3211,Rokycany,52,654,331,323
5507,3211,Rokycany,53,629,347,282
5508,3211,Rokycany,54,642,324,318
5509,3211,Rokycany,55,635,327,308
5510,3211,Rokycany,56,670,337,333
5511,3211,Rokycany,57,623,328,295
5512,3211,Rokycany,58,600,306,294
5513,3211,Rokycany,59,568,293,275
5514,3211,Rokycany,60,553,290,263
5515,3211,Rokycany,61,566,290,276
5516,3211,Rokycany,62,594,288,306
5517,3211,Rokycany,63,632,305,327
5518,3211,Rokycany,64,657,327,330
5519,3211,Rokycany,65,662,318,344
5520,3211,Rokycany,66,643,316,327
5521,3211,Rokycany,67,662,319,343
5522,3211,Rokycany,68,666,315,351
5523,3211,Rokycany,69,641,312,329
5524,3211,Rokycany,70,608,289,319
5525,3211,Rokycany,71,591,258,333
5526,3211,Rokycany,72,573,243,330
5527,3211,Rokycany,73,610,280,330
5528,3211,Rokycany,74,623,278,345
5529,3211,Rokycany,75,487,225,262
5530,3211,Rokycany,76,444,195,249
5531,3211,Rokycany,77,421,188,233
5532,3211,Rokycany,78,327,143,184
5533,3211,Rokycany,79,276,100,176
5534,3211,Rokycany,80,263,103,160
5535,3211,Rokycany,81,242,90,152
5536,3211,Rokycany,82,241,87,154
5537,3211,Rokycany,83,186,77,109
5538,3211,Rokycany,84,166,58,108
5539,3211,Rokycany,85,149,50,99
5540,3211,Rokycany,86,163,48,115
5541,3211,Rokycany,87,129,49,80
5542,3211,Rokycany,88,115,31,84
5543,3211,Rokycany,89,105,33,72
5544,3211,Rokycany,90,80,24,56
5545,3211,Rokycany,91,57,13,44
5546,3211,Rokycany,92,45,10,35
5547,3211,Rokycany,93,40,11,29
5548,3211,Rokycany,94,27,11,16
5549,3211,Rokycany,95,13,3,10
5550,3211,Rokycany,96,8,1,7
5551,3211,Rokycany,97,11,2,9
5552,3211,Rokycany,98,4,1,3
5553,3211,Rokycany,99,5,0,5
5554,3211,Rokycany,100,3,1,2
5555,3212,Stod,0,242,125,117
5556,3212,Stod,1,261,128,133
5557,3212,Stod,2,253,130,123
5558,3212,Stod,3,247,129,118
5559,3212,Stod,4,267,139,128
5560,3212,Stod,5,228,117,111
5561,3212,Stod,6,235,117,118
5562,3212,Stod,7,227,117,110
5563,3212,Stod,8,264,132,132
5564,3212,Stod,9,250,134,116
5565,3212,Stod,10,245,146,99
5566,3212,Stod,11,304,155,149
5567,3212,Stod,12,279,136,143
5568,3212,Stod,13,254,131,123
5569,3212,Stod,14,250,130,120
5570,3212,Stod,15,241,129,112
5571,3212,Stod,16,208,103,105
5572,3212,Stod,17,207,106,101
5573,3212,Stod,18,203,107,96
5574,3212,Stod,19,202,105,97
5575,3212,Stod,20,214,120,94
5576,3212,Stod,21,201,90,111
5577,3212,Stod,22,221,113,108
5578,3212,Stod,23,208,111,97
5579,3212,Stod,24,205,109,96
5580,3212,Stod,25,221,113,108
5581,3212,Stod,26,262,128,134
5582,3212,Stod,27,297,166,131
5583,3212,Stod,28,278,129,149
5584,3212,Stod,29,296,147,149
5585,3212,Stod,30,310,166,144
5586,3212,Stod,31,339,182,157
5587,3212,Stod,32,318,181,137
5588,3212,Stod,33,338,177,161
5589,3212,Stod,34,308,151,157
5590,3212,Stod,35,333,168,165
5591,3212,Stod,36,345,176,169
5592,3212,Stod,37,326,184,142
5593,3212,Stod,38,314,167,147
5594,3212,Stod,39,329,182,147
5595,3212,Stod,40,362,196,166
5596,3212,Stod,41,369,200,169
5597,3212,Stod,42,419,204,215
5598,3212,Stod,43,412,215,197
5599,3212,Stod,44,403,196,207
5600,3212,Stod,45,469,238,231
5601,3212,Stod,46,440,211,229
5602,3212,Stod,47,435,228,207
5603,3212,Stod,48,381,218,163
5604,3212,Stod,49,333,167,166
5605,3212,Stod,50,334,173,161
5606,3212,Stod,51,316,157,159
5607,3212,Stod,52,281,146,135
5608,3212,Stod,53,242,125,117
5609,3212,Stod,54,271,137,134
5610,3212,Stod,55,304,156,148
5611,3212,Stod,56,348,184,164
5612,3212,Stod,57,312,158,154
5613,3212,Stod,58,253,136,117
5614,3212,Stod,59,260,129,131
5615,3212,Stod,60,262,133,129
5616,3212,Stod,61,254,124,130
5617,3212,Stod,62,235,116,119
5618,3212,Stod,63,259,148,111
5619,3212,Stod,64,317,159,158
5620,3212,Stod,65,304,144,160
5621,3212,Stod,66,290,137,153
5622,3212,Stod,67,277,128,149
5623,3212,Stod,68,297,133,164
5624,3212,Stod,69,300,145,155
5625,3212,Stod,70,309,144,165
5626,3212,Stod,71,271,117,154
5627,3212,Stod,72,271,131,140
5628,3212,Stod,73,280,141,139
5629,3212,Stod,74,298,132,166
5630,3212,Stod,75,218,114,104
5631,3212,Stod,76,189,90,99
5632,3212,Stod,77,166,67,99
5633,3212,Stod,78,146,54,92
5634,3212,Stod,79,157,66,91
5635,3212,Stod,80,120,48,72
5636,3212,Stod,81,115,40,75
5637,3212,Stod,82,88,34,54
5638,3212,Stod,83,80,20,60
5639,3212,Stod,84,56,19,37
5640,3212,Stod,85,78,22,56
5641,3212,Stod,86,51,20,31
5642,3212,Stod,87,49,12,37
5643,3212,Stod,88,36,8,28
5644,3212,Stod,89,42,11,31
5645,3212,Stod,90,28,6,22
5646,3212,Stod,91,23,8,15
5647,3212,Stod,92,14,6,8
5648,3212,Stod,93,12,4,8
5649,3212,Stod,94,5,1,4
5650,3212,Stod,95,4,1,3
5651,3212,Stod,96,3,2,1
5652,3212,Stod,97,4,1,3
5653,3212,Stod,98,4,0,4
5654,3212,Stod,99,0,0,0
5655,3212,Stod,100,3,2,1
5656,3213,Stříbro,0,169,88,81
5657,3213,Stříbro,1,191,89,102
5658,3213,Stříbro,2,176,88,88
5659,3213,Stříbro,3,209,107,102
5660,3213,Stříbro,4,177,90,87
5661,3213,Stříbro,5,174,84,90
5662,3213,Stříbro,6,161,75,86
5663,3213,Stříbro,7,181,89,92
5664,3213,Stříbro,8,184,99,85
5665,3213,Stříbro,9,145,76,69
5666,3213,Stříbro,10,173,87,86
5667,3213,Stříbro,11,195,109,86
5668,3213,Stříbro,12,165,84,81
5669,3213,Stříbro,13,197,80,117
5670,3213,Stříbro,14,178,91,87
5671,3213,Stříbro,15,169,95,74
5672,3213,Stříbro,16,152,76,76
5673,3213,Stříbro,17,166,88,78
5674,3213,Stříbro,18,142,72,70
5675,3213,Stříbro,19,152,80,72
5676,3213,Stříbro,20,157,85,72
5677,3213,Stříbro,21,131,73,58
5678,3213,Stříbro,22,150,79,71
5679,3213,Stříbro,23,142,73,69
5680,3213,Stříbro,24,156,79,77
5681,3213,Stříbro,25,190,87,103
5682,3213,Stříbro,26,215,116,99
5683,3213,Stříbro,27,234,125,109
5684,3213,Stříbro,28,208,108,100
5685,3213,Stříbro,29,210,112,98
5686,3213,Stříbro,30,226,122,104
5687,3213,Stříbro,31,272,149,123
5688,3213,Stříbro,32,226,127,99
5689,3213,Stříbro,33,256,126,130
5690,3213,Stříbro,34,234,132,102
5691,3213,Stříbro,35,249,128,121
5692,3213,Stříbro,36,253,155,98
5693,3213,Stříbro,37,238,124,114
5694,3213,Stříbro,38,240,135,105
5695,3213,Stříbro,39,224,120,104
5696,3213,Stříbro,40,246,141,105
5697,3213,Stříbro,41,269,138,131
5698,3213,Stříbro,42,285,146,139
5699,3213,Stříbro,43,307,161,146
5700,3213,Stříbro,44,306,160,146
5701,3213,Stříbro,45,284,166,118
5702,3213,Stříbro,46,292,138,154
5703,3213,Stříbro,47,302,164,138
5704,3213,Stříbro,48,233,123,110
5705,3213,Stříbro,49,226,121,105
5706,3213,Stříbro,50,232,109,123
5707,3213,Stříbro,51,241,125,116
5708,3213,Stříbro,52,232,121,111
5709,3213,Stříbro,53,229,124,105
5710,3213,Stříbro,54,235,124,111
5711,3213,Stříbro,55,256,130,126
5712,3213,Stříbro,56,236,112,124
5713,3213,Stříbro,57,251,116,135
5714,3213,Stříbro,58,236,129,107
5715,3213,Stříbro,59,224,114,110
5716,3213,Stříbro,60,208,100,108
5717,3213,Stříbro,61,193,112,81
5718,3213,Stříbro,62,246,129,117
5719,3213,Stříbro,63,240,127,113
5720,3213,Stříbro,64,244,133,111
5721,3213,Stříbro,65,214,102,112
5722,3213,Stříbro,66,199,86,113
5723,3213,Stříbro,67,224,108,116
5724,3213,Stříbro,68,203,84,119
5725,3213,Stříbro,69,197,100,97
5726,3213,Stříbro,70,210,104,106
5727,3213,Stříbro,71,202,94,108
5728,3213,Stříbro,72,221,101,120
5729,3213,Stříbro,73,207,102,105
5730,3213,Stříbro,74,169,84,85
5731,3213,Stříbro,75,125,48,77
5732,3213,Stříbro,76,120,49,71
5733,3213,Stříbro,77,127,46,81
5734,3213,Stříbro,78,98,43,55
5735,3213,Stříbro,79,104,37,67
5736,3213,Stříbro,80,115,42,73
5737,3213,Stříbro,81,95,36,59
5738,3213,Stříbro,82,74,29,45
5739,3213,Stříbro,83,53,20,33
5740,3213,Stříbro,84,46,16,30
5741,3213,Stříbro,85,58,22,36
5742,3213,Stříbro,86,40,16,24
5743,3213,Stříbro,87,34,16,18
5744,3213,Stříbro,88,19,5,14
5745,3213,Stříbro,89,22,6,16
5746,3213,Stříbro,90,20,5,15
5747,3213,Stříbro,91,14,4,10
5748,3213,Stříbro,92,5,3,2
5749,3213,Stříbro,93,10,3,7
5750,3213,Stříbro,94,5,1,4
5751,3213,Stříbro,95,6,0,6
5752,3213,Stříbro,96,4,0,4
5753,3213,Stříbro,97,4,1,3
5754,3213,Stříbro,98,2,1,1
5755,3213,Stříbro,99,0,0,0
5756,3213,Stříbro,100,0,0,0
5757,3214,Sušice,0,205,90,115
5758,3214,Sušice,1,223,118,105
5759,3214,Sušice,2,217,98,119
5760,3214,Sušice,3,227,124,103
5761,3214,Sušice,4,230,112,118
5762,3214,Sušice,5,219,126,93
5763,3214,Sušice,6,236,119,117
5764,3214,Sušice,7,225,112,113
5765,3214,Sušice,8,221,116,105
5766,3214,Sušice,9,226,109,117
5767,3214,Sušice,10,261,138,123
5768,3214,Sušice,11,240,125,115
5769,3214,Sušice,12,225,114,111
5770,3214,Sušice,13,258,136,122
5771,3214,Sušice,14,255,134,121
5772,3214,Sušice,15,258,127,131
5773,3214,Sušice,16,211,116,95
5774,3214,Sušice,17,226,105,121
5775,3214,Sušice,18,208,112,96
5776,3214,Sušice,19,221,116,105
5777,3214,Sušice,20,209,114,95
5778,3214,Sušice,21,247,121,126
5779,3214,Sušice,22,210,100,110
5780,3214,Sušice,23,228,126,102
5781,3214,Sušice,24,196,108,88
5782,3214,Sušice,25,240,117,123
5783,3214,Sušice,26,287,140,147
5784,3214,Sušice,27,296,165,131
5785,3214,Sušice,28,286,159,127
5786,3214,Sušice,29,273,142,131
5787,3214,Sušice,30,291,159,132
5788,3214,Sušice,31,271,145,126
5789,3214,Sušice,32,264,136,128
5790,3214,Sušice,33,269,142,127
5791,3214,Sušice,34,242,131,111
5792,3214,Sušice,35,304,160,144
5793,3214,Sušice,36,260,129,131
5794,3214,Sušice,37,290,152,138
5795,3214,Sušice,38,261,139,122
5796,3214,Sušice,39,290,142,148
5797,3214,Sušice,40,338,182,156
5798,3214,Sušice,41,343,180,163
5799,3214,Sušice,42,351,184,167
5800,3214,Sušice,43,381,208,173
5801,3214,Sušice,44,356,165,191
5802,3214,Sušice,45,373,188,185
5803,3214,Sušice,46,434,217,217
5804,3214,Sušice,47,377,204,173
5805,3214,Sušice,48,414,209,205
5806,3214,Sušice,49,338,163,175
5807,3214,Sušice,50,364,196,168
5808,3214,Sušice,51,339,173,166
5809,3214,Sušice,52,312,162,150
5810,3214,Sušice,53,334,169,165
5811,3214,Sušice,54,282,133,149
5812,3214,Sušice,55,337,172,165
5813,3214,Sušice,56,359,185,174
5814,3214,Sušice,57,323,165,158
5815,3214,Sušice,58,297,161,136
5816,3214,Sušice,59,324,171,153
5817,3214,Sušice,60,315,159,156
5818,3214,Sušice,61,301,145,156
5819,3214,Sušice,62,326,181,145
5820,3214,Sušice,63,341,169,172
5821,3214,Sušice,64,363,176,187
5822,3214,Sušice,65,353,163,190
5823,3214,Sušice,66,371,176,195
5824,3214,Sušice,67,367,179,188
5825,3214,Sušice,68,343,162,181
5826,3214,Sušice,69,335,165,170
5827,3214,Sušice,70,348,161,187
5828,3214,Sušice,71,312,156,156
5829,3214,Sušice,72,335,168,167
5830,3214,Sušice,73,280,129,151
5831,3214,Sušice,74,286,134,152
5832,3214,Sušice,75,241,93,148
5833,3214,Sušice,76,238,102,136
5834,3214,Sušice,77,223,90,133
5835,3214,Sušice,78,215,85,130
5836,3214,Sušice,79,160,69,91
5837,3214,Sušice,80,145,60,85
5838,3214,Sušice,81,139,60,79
5839,3214,Sušice,82,130,46,84
5840,3214,Sušice,83,108,33,75
5841,3214,Sušice,84,104,29,75
5842,3214,Sušice,85,108,37,71
5843,3214,Sušice,86,99,28,71
5844,3214,Sušice,87,73,24,49
5845,3214,Sušice,88,74,20,54
5846,3214,Sušice,89,58,17,41
5847,3214,Sušice,90,56,12,44
5848,3214,Sušice,91,35,8,27
5849,3214,Sušice,92,31,9,22
5850,3214,Sušice,93,15,5,10
5851,3214,Sušice,94,5,2,3
5852,3214,Sušice,95,6,1,5
5853,3214,Sušice,96,11,2,9
5854,3214,Sušice,97,2,1,1
5855,3214,Sušice,98,2,1,1
5856,3214,Sušice,99,2,0,2
5857,3214,Sušice,100,0,0,0
5858,3215,Tachov,0,365,196,169
5859,3215,Tachov,1,398,190,208
5860,3215,Tachov,2,382,189,193
5861,3215,Tachov,3,400,224,176
5862,3215,Tachov,4,386,195,191
5863,3215,Tachov,5,354,182,172
5864,3215,Tachov,6,355,192,163
5865,3215,Tachov,7,346,159,187
5866,3215,Tachov,8,372,166,206
5867,3215,Tachov,9,374,190,184
5868,3215,Tachov,10,435,220,215
5869,3215,Tachov,11,410,214,196
5870,3215,Tachov,12,431,224,207
5871,3215,Tachov,13,415,197,218
5872,3215,Tachov,14,443,226,217
5873,3215,Tachov,15,353,181,172
5874,3215,Tachov,16,328,166,162
5875,3215,Tachov,17,332,161,171
5876,3215,Tachov,18,324,168,156
5877,3215,Tachov,19,347,177,170
5878,3215,Tachov,20,354,185,169
5879,3215,Tachov,21,339,178,161
5880,3215,Tachov,22,359,187,172
5881,3215,Tachov,23,403,218,185
5882,3215,Tachov,24,374,198,176
5883,3215,Tachov,25,423,229,194
5884,3215,Tachov,26,444,245,199
5885,3215,Tachov,27,483,269,214
5886,3215,Tachov,28,507,260,247
5887,3215,Tachov,29,505,286,219
5888,3215,Tachov,30,513,258,255
5889,3215,Tachov,31,514,269,245
5890,3215,Tachov,32,553,301,252
5891,3215,Tachov,33,549,288,261
5892,3215,Tachov,34,556,289,267
5893,3215,Tachov,35,558,285,273
5894,3215,Tachov,36,576,305,271
5895,3215,Tachov,37,537,297,240
5896,3215,Tachov,38,512,278,234
5897,3215,Tachov,39,470,249,221
5898,3215,Tachov,40,554,298,256
5899,3215,Tachov,41,565,306,259
5900,3215,Tachov,42,580,308,272
5901,3215,Tachov,43,629,334,295
5902,3215,Tachov,44,625,343,282
5903,3215,Tachov,45,678,354,324
5904,3215,Tachov,46,737,363,374
5905,3215,Tachov,47,659,317,342
5906,3215,Tachov,48,599,284,315
5907,3215,Tachov,49,540,272,268
5908,3215,Tachov,50,532,259,273
5909,3215,Tachov,51,530,301,229
5910,3215,Tachov,52,462,229,233
5911,3215,Tachov,53,501,262,239
5912,3215,Tachov,54,500,264,236
5913,3215,Tachov,55,524,267,257
5914,3215,Tachov,56,550,283,267
5915,3215,Tachov,57,528,272,256
5916,3215,Tachov,58,477,257,220
5917,3215,Tachov,59,419,219,200
5918,3215,Tachov,60,471,237,234
5919,3215,Tachov,61,410,207,203
5920,3215,Tachov,62,475,242,233
5921,3215,Tachov,63,493,235,258
5922,3215,Tachov,64,469,230,239
5923,3215,Tachov,65,527,267,260
5924,3215,Tachov,66,453,226,227
5925,3215,Tachov,67,486,228,258
5926,3215,Tachov,68,449,196,253
5927,3215,Tachov,69,464,219,245
5928,3215,Tachov,70,446,229,217
5929,3215,Tachov,71,426,201,225
5930,3215,Tachov,72,400,198,202
5931,3215,Tachov,73,426,176,250
5932,3215,Tachov,74,321,146,175
5933,3215,Tachov,75,254,105,149
5934,3215,Tachov,76,234,111,123
5935,3215,Tachov,77,199,89,110
5936,3215,Tachov,78,210,82,128
5937,3215,Tachov,79,212,84,128
5938,3215,Tachov,80,184,58,126
5939,3215,Tachov,81,142,45,97
5940,3215,Tachov,82,130,48,82
5941,3215,Tachov,83,117,40,77
5942,3215,Tachov,84,96,32,64
5943,3215,Tachov,85,80,24,56
5944,3215,Tachov,86,76,22,54
5945,3215,Tachov,87,59,19,40
5946,3215,Tachov,88,56,18,38
5947,3215,Tachov,89,46,10,36
5948,3215,Tachov,90,34,11,23
5949,3215,Tachov,91,31,12,19
5950,3215,Tachov,92,21,7,14
5951,3215,Tachov,93,19,5,14
5952,3215,Tachov,94,12,5,7
5953,3215,Tachov,95,9,4,5
5954,3215,Tachov,96,8,3,5
5955,3215,Tachov,97,3,0,3
5956,3215,Tachov,98,2,1,1
5957,3215,Tachov,99,1,0,1
5958,3215,Tachov,100,4,1,3
5959,4101,Aš,0,163,92,71
5960,4101,Aš,1,166,84,82
5961,4101,Aš,2,151,82,69
5962,4101,Aš,3,172,93,79
5963,4101,Aš,4,176,79,97
5964,4101,Aš,5,172,106,66
5965,4101,Aš,6,175,93,82
5966,4101,Aš,7,190,106,84
5967,4101,Aš,8,168,90,78
5968,4101,Aš,9,187,107,80
5969,4101,Aš,10,219,114,105
5970,4101,Aš,11,243,133,110
5971,4101,Aš,12,244,142,102
5972,4101,Aš,13,211,108,103
5973,4101,Aš,14,204,105,99
5974,4101,Aš,15,201,92,109
5975,4101,Aš,16,169,88,81
5976,4101,Aš,17,175,89,86
5977,4101,Aš,18,197,105,92
5978,4101,Aš,19,192,99,93
5979,4101,Aš,20,174,80,94
5980,4101,Aš,21,152,79,73
5981,4101,Aš,22,176,90,86
5982,4101,Aš,23,167,88,79
5983,4101,Aš,24,167,91,76
5984,4101,Aš,25,171,89,82
5985,4101,Aš,26,190,98,92
5986,4101,Aš,27,212,112,100
5987,4101,Aš,28,191,94,97
5988,4101,Aš,29,221,128,93
5989,4101,Aš,30,259,141,118
5990,4101,Aš,31,225,120,105
5991,4101,Aš,32,249,127,122
5992,4101,Aš,33,222,117,105
5993,4101,Aš,34,234,119,115
5994,4101,Aš,35,260,139,121
5995,4101,Aš,36,215,114,101
5996,4101,Aš,37,229,118,111
5997,4101,Aš,38,236,131,105
5998,4101,Aš,39,234,115,119
5999,4101,Aš,40,249,117,132
6000,4101,Aš,41,299,167,132
6001,4101,Aš,42,296,144,152
6002,4101,Aš,43,312,146,166
6003,4101,Aš,44,327,167,160
6004,4101,Aš,45,312,155,157
6005,4101,Aš,46,318,161,157
6006,4101,Aš,47,289,152,137
6007,4101,Aš,48,281,146,135
6008,4101,Aš,49,238,131,107
6009,4101,Aš,50,234,114,120
6010,4101,Aš,51,236,126,110
6011,4101,Aš,52,261,138,123
6012,4101,Aš,53,237,120,117
6013,4101,Aš,54,242,130,112
6014,4101,Aš,55,247,114,133
6015,4101,Aš,56,247,122,125
6016,4101,Aš,57,244,124,120
6017,4101,Aš,58,206,95,111
6018,4101,Aš,59,207,109,98
6019,4101,Aš,60,190,96,94
6020,4101,Aš,61,205,106,99
6021,4101,Aš,62,181,75,106
6022,4101,Aš,63,220,105,115
6023,4101,Aš,64,232,120,112
6024,4101,Aš,65,239,118,121
6025,4101,Aš,66,230,124,106
6026,4101,Aš,67,223,105,118
6027,4101,Aš,68,218,104,114
6028,4101,Aš,69,242,116,126
6029,4101,Aš,70,229,110,119
6030,4101,Aš,71,191,97,94
6031,4101,Aš,72,205,97,108
6032,4101,Aš,73,210,84,126
6033,4101,Aš,74,155,60,95
6034,4101,Aš,75,137,56,81
6035,4101,Aš,76,132,52,80
6036,4101,Aš,77,107,39,68
6037,4101,Aš,78,104,42,62
6038,4101,Aš,79,113,45,68
6039,4101,Aš,80,102,46,56
6040,4101,Aš,81,90,32,58
6041,4101,Aš,82,48,19,29
6042,4101,Aš,83,62,22,40
6043,4101,Aš,84,50,13,37
6044,4101,Aš,85,41,10,31
6045,4101,Aš,86,47,20,27
6046,4101,Aš,87,36,17,19
6047,4101,Aš,88,26,9,17
6048,4101,Aš,89,25,6,19
6049,4101,Aš,90,22,5,17
6050,4101,Aš,91,8,5,3
6051,4101,Aš,92,14,5,9
6052,4101,Aš,93,10,3,7
6053,4101,Aš,94,7,1,6
6054,4101,Aš,95,3,0,3
6055,4101,Aš,96,3,1,2
6056,4101,Aš,97,6,0,6
6057,4101,Aš,98,4,1,3
6058,4101,Aš,99,0,0,0
6059,4101,Aš,100,3,3,0
6060,4102,Cheb,0,431,215,216
6061,4102,Cheb,1,450,242,208
6062,4102,Cheb,2,463,235,228
6063,4102,Cheb,3,484,233,251
6064,4102,Cheb,4,489,248,241
6065,4102,Cheb,5,483,242,241
6066,4102,Cheb,6,476,245,231
6067,4102,Cheb,7,542,286,256
6068,4102,Cheb,8,489,257,232
6069,4102,Cheb,9,531,268,263
6070,4102,Cheb,10,579,302,277
6071,4102,Cheb,11,610,313,297
6072,4102,Cheb,12,579,305,274
6073,4102,Cheb,13,622,307,315
6074,4102,Cheb,14,549,316,233
6075,4102,Cheb,15,516,258,258
6076,4102,Cheb,16,493,253,240
6077,4102,Cheb,17,448,224,224
6078,4102,Cheb,18,507,259,248
6079,4102,Cheb,19,474,240,234
6080,4102,Cheb,20,478,244,234
6081,4102,Cheb,21,484,247,237
6082,4102,Cheb,22,465,240,225
6083,4102,Cheb,23,412,190,222
6084,4102,Cheb,24,471,241,230
6085,4102,Cheb,25,484,249,235
6086,4102,Cheb,26,579,307,272
6087,4102,Cheb,27,571,287,284
6088,4102,Cheb,28,589,313,276
6089,4102,Cheb,29,593,306,287
6090,4102,Cheb,30,668,332,336
6091,4102,Cheb,31,638,336,302
6092,4102,Cheb,32,637,313,324
6093,4102,Cheb,33,605,316,289
6094,4102,Cheb,34,650,341,309
6095,4102,Cheb,35,664,367,297
6096,4102,Cheb,36,649,352,297
6097,4102,Cheb,37,652,352,300
6098,4102,Cheb,38,626,332,294
6099,4102,Cheb,39,642,322,320
6100,4102,Cheb,40,749,376,373
6101,4102,Cheb,41,792,388,404
6102,4102,Cheb,42,839,419,420
6103,4102,Cheb,43,848,431,417
6104,4102,Cheb,44,895,444,451
6105,4102,Cheb,45,946,479,467
6106,4102,Cheb,46,927,462,465
6107,4102,Cheb,47,946,459,487
6108,4102,Cheb,48,830,447,383
6109,4102,Cheb,49,787,412,375
6110,4102,Cheb,50,727,379,348
6111,4102,Cheb,51,682,339,343
6112,4102,Cheb,52,674,350,324
6113,4102,Cheb,53,681,337,344
6114,4102,Cheb,54,662,329,333
6115,4102,Cheb,55,662,340,322
6116,4102,Cheb,56,706,369,337
6117,4102,Cheb,57,649,340,309
6118,4102,Cheb,58,587,308,279
6119,4102,Cheb,59,560,297,263
6120,4102,Cheb,60,607,294,313
6121,4102,Cheb,61,543,261,282
6122,4102,Cheb,62,620,297,323
6123,4102,Cheb,63,655,330,325
6124,4102,Cheb,64,652,313,339
6125,4102,Cheb,65,620,297,323
6126,4102,Cheb,66,651,314,337
6127,4102,Cheb,67,647,306,341
6128,4102,Cheb,68,658,286,372
6129,4102,Cheb,69,658,328,330
6130,4102,Cheb,70,656,304,352
6131,4102,Cheb,71,600,269,331
6132,4102,Cheb,72,615,268,347
6133,4102,Cheb,73,631,276,355
6134,4102,Cheb,74,530,220,310
6135,4102,Cheb,75,416,175,241
6136,4102,Cheb,76,396,177,219
6137,4102,Cheb,77,337,122,215
6138,4102,Cheb,78,322,144,178
6139,4102,Cheb,79,306,116,190
6140,4102,Cheb,80,299,110,189
6141,4102,Cheb,81,262,110,152
6142,4102,Cheb,82,175,66,109
6143,4102,Cheb,83,162,61,101
6144,4102,Cheb,84,170,54,116
6145,4102,Cheb,85,140,54,86
6146,4102,Cheb,86,128,52,76
6147,4102,Cheb,87,100,33,67
6148,4102,Cheb,88,108,37,71
6149,4102,Cheb,89,84,28,56
6150,4102,Cheb,90,54,18,36
6151,4102,Cheb,91,51,12,39
6152,4102,Cheb,92,39,9,30
6153,4102,Cheb,93,35,7,28
6154,4102,Cheb,94,26,3,23
6155,4102,Cheb,95,13,3,10
6156,4102,Cheb,96,14,3,11
6157,4102,Cheb,97,3,1,2
6158,4102,Cheb,98,7,1,6
6159,4102,Cheb,99,3,0,3
6160,4102,Cheb,100,3,1,2
6161,4103,Karlovy Vary,0,773,414,359
6162,4103,Karlovy Vary,1,801,405,396
6163,4103,Karlovy Vary,2,793,387,406
6164,4103,Karlovy Vary,3,765,389,376
6165,4103,Karlovy Vary,4,828,431,397
6166,4103,Karlovy Vary,5,765,378,387
6167,4103,Karlovy Vary,6,809,428,381
6168,4103,Karlovy Vary,7,781,404,377
6169,4103,Karlovy Vary,8,808,397,411
6170,4103,Karlovy Vary,9,794,387,407
6171,4103,Karlovy Vary,10,905,466,439
6172,4103,Karlovy Vary,11,937,458,479
6173,4103,Karlovy Vary,12,1000,488,512
6174,4103,Karlovy Vary,13,966,480,486
6175,4103,Karlovy Vary,14,861,440,421
6176,4103,Karlovy Vary,15,772,394,378
6177,4103,Karlovy Vary,16,715,364,351
6178,4103,Karlovy Vary,17,784,422,362
6179,4103,Karlovy Vary,18,757,371,386
6180,4103,Karlovy Vary,19,750,393,357
6181,4103,Karlovy Vary,20,798,396,402
6182,4103,Karlovy Vary,21,761,375,386
6183,4103,Karlovy Vary,22,776,435,341
6184,4103,Karlovy Vary,23,738,377,361
6185,4103,Karlovy Vary,24,753,388,365
6186,4103,Karlovy Vary,25,796,432,364
6187,4103,Karlovy Vary,26,930,443,487
6188,4103,Karlovy Vary,27,1052,548,504
6189,4103,Karlovy Vary,28,974,497,477
6190,4103,Karlovy Vary,29,1006,527,479
6191,4103,Karlovy Vary,30,1005,515,490
6192,4103,Karlovy Vary,31,1070,537,533
6193,4103,Karlovy Vary,32,1117,582,535
6194,4103,Karlovy Vary,33,1134,585,549
6195,4103,Karlovy Vary,34,1126,584,542
6196,4103,Karlovy Vary,35,1083,555,528
6197,4103,Karlovy Vary,36,1098,577,521
6198,4103,Karlovy Vary,37,1056,536,520
6199,4103,Karlovy Vary,38,1146,606,540
6200,4103,Karlovy Vary,39,1154,595,559
6201,4103,Karlovy Vary,40,1183,605,578
6202,4103,Karlovy Vary,41,1303,646,657
6203,4103,Karlovy Vary,42,1368,690,678
6204,4103,Karlovy Vary,43,1382,705,677
6205,4103,Karlovy Vary,44,1537,800,737
6206,4103,Karlovy Vary,45,1660,832,828
6207,4103,Karlovy Vary,46,1644,836,808
6208,4103,Karlovy Vary,47,1585,843,742
6209,4103,Karlovy Vary,48,1351,690,661
6210,4103,Karlovy Vary,49,1241,629,612
6211,4103,Karlovy Vary,50,1275,660,615
6212,4103,Karlovy Vary,51,1224,604,620
6213,4103,Karlovy Vary,52,1169,603,566
6214,4103,Karlovy Vary,53,1149,571,578
6215,4103,Karlovy Vary,54,1175,599,576
6216,4103,Karlovy Vary,55,1196,626,570
6217,4103,Karlovy Vary,56,1294,673,621
6218,4103,Karlovy Vary,57,1219,604,615
6219,4103,Karlovy Vary,58,1138,572,566
6220,4103,Karlovy Vary,59,1013,509,504
6221,4103,Karlovy Vary,60,1108,545,563
6222,4103,Karlovy Vary,61,1011,493,518
6223,4103,Karlovy Vary,62,1093,523,570
6224,4103,Karlovy Vary,63,1161,539,622
6225,4103,Karlovy Vary,64,1190,622,568
6226,4103,Karlovy Vary,65,1157,512,645
6227,4103,Karlovy Vary,66,1220,582,638
6228,4103,Karlovy Vary,67,1249,576,673
6229,4103,Karlovy Vary,68,1202,602,600
6230,4103,Karlovy Vary,69,1262,561,701
6231,4103,Karlovy Vary,70,1206,524,682
6232,4103,Karlovy Vary,71,1167,494,673
6233,4103,Karlovy Vary,72,1178,540,638
6234,4103,Karlovy Vary,73,1154,476,678
6235,4103,Karlovy Vary,74,1004,426,578
6236,4103,Karlovy Vary,75,801,341,460
6237,4103,Karlovy Vary,76,808,345,463
6238,4103,Karlovy Vary,77,731,301,430
6239,4103,Karlovy Vary,78,650,280,370
6240,4103,Karlovy Vary,79,589,247,342
6241,4103,Karlovy Vary,80,594,218,376
6242,4103,Karlovy Vary,81,530,202,328
6243,4103,Karlovy Vary,82,444,163,281
6244,4103,Karlovy Vary,83,394,129,265
6245,4103,Karlovy Vary,84,326,120,206
6246,4103,Karlovy Vary,85,295,99,196
6247,4103,Karlovy Vary,86,283,93,190
6248,4103,Karlovy Vary,87,215,65,150
6249,4103,Karlovy Vary,88,206,70,136
6250,4103,Karlovy Vary,89,179,61,118
6251,4103,Karlovy Vary,90,153,43,110
6252,4103,Karlovy Vary,91,124,39,85
6253,4103,Karlovy Vary,92,95,34,61
6254,4103,Karlovy Vary,93,61,11,50
6255,4103,Karlovy Vary,94,37,9,28
6256,4103,Karlovy Vary,95,22,7,15
6257,4103,Karlovy Vary,96,25,0,25
6258,4103,Karlovy Vary,97,14,3,11
6259,4103,Karlovy Vary,98,6,0,6
6260,4103,Karlovy Vary,99,6,1,5
6261,4103,Karlovy Vary,100,8,3,5
6262,4104,Kraslice,0,121,64,57
6263,4104,Kraslice,1,121,60,61
6264,4104,Kraslice,2,130,70,60
6265,4104,Kraslice,3,130,55,75
6266,4104,Kraslice,4,116,54,62
6267,4104,Kraslice,5,114,46,68
6268,4104,Kraslice,6,153,82,71
6269,4104,Kraslice,7,124,57,67
6270,4104,Kraslice,8,120,53,67
6271,4104,Kraslice,9,122,70,52
6272,4104,Kraslice,10,150,70,80
6273,4104,Kraslice,11,145,72,73
6274,4104,Kraslice,12,162,86,76
6275,4104,Kraslice,13,160,86,74
6276,4104,Kraslice,14,153,88,65
6277,4104,Kraslice,15,125,68,57
6278,4104,Kraslice,16,113,57,56
6279,4104,Kraslice,17,134,67,67
6280,4104,Kraslice,18,100,60,40
6281,4104,Kraslice,19,116,54,62
6282,4104,Kraslice,20,115,62,53
6283,4104,Kraslice,21,109,59,50
6284,4104,Kraslice,22,126,78,48
6285,4104,Kraslice,23,145,79,66
6286,4104,Kraslice,24,119,56,63
6287,4104,Kraslice,25,150,79,71
6288,4104,Kraslice,26,142,71,71
6289,4104,Kraslice,27,164,91,73
6290,4104,Kraslice,28,151,85,66
6291,4104,Kraslice,29,160,78,82
6292,4104,Kraslice,30,182,104,78
6293,4104,Kraslice,31,151,85,66
6294,4104,Kraslice,32,145,86,59
6295,4104,Kraslice,33,174,91,83
6296,4104,Kraslice,34,170,94,76
6297,4104,Kraslice,35,170,84,86
6298,4104,Kraslice,36,166,91,75
6299,4104,Kraslice,37,136,80,56
6300,4104,Kraslice,38,153,77,76
6301,4104,Kraslice,39,159,87,72
6302,4104,Kraslice,40,174,96,78
6303,4104,Kraslice,41,172,90,82
6304,4104,Kraslice,42,187,116,71
6305,4104,Kraslice,43,203,102,101
6306,4104,Kraslice,44,218,118,100
6307,4104,Kraslice,45,209,107,102
6308,4104,Kraslice,46,223,111,112
6309,4104,Kraslice,47,189,95,94
6310,4104,Kraslice,48,177,108,69
6311,4104,Kraslice,49,202,113,89
6312,4104,Kraslice,50,196,99,97
6313,4104,Kraslice,51,179,90,89
6314,4104,Kraslice,52,154,89,65
6315,4104,Kraslice,53,183,90,93
6316,4104,Kraslice,54,168,88,80
6317,4104,Kraslice,55,195,100,95
6318,4104,Kraslice,56,181,89,92
6319,4104,Kraslice,57,214,105,109
6320,4104,Kraslice,58,163,69,94
6321,4104,Kraslice,59,146,68,78
6322,4104,Kraslice,60,171,93,78
6323,4104,Kraslice,61,173,81,92
6324,4104,Kraslice,62,151,77,74
6325,4104,Kraslice,63,199,99,100
6326,4104,Kraslice,64,199,102,97
6327,4104,Kraslice,65,191,98,93
6328,4104,Kraslice,66,186,101,85
6329,4104,Kraslice,67,208,97,111
6330,4104,Kraslice,68,186,99,87
6331,4104,Kraslice,69,171,80,91
6332,4104,Kraslice,70,186,94,92
6333,4104,Kraslice,71,168,72,96
6334,4104,Kraslice,72,172,75,97
6335,4104,Kraslice,73,165,67,98
6336,4104,Kraslice,74,152,71,81
6337,4104,Kraslice,75,109,50,59
6338,4104,Kraslice,76,102,40,62
6339,4104,Kraslice,77,97,43,54
6340,4104,Kraslice,78,97,38,59
6341,4104,Kraslice,79,88,28,60
6342,4104,Kraslice,80,94,39,55
6343,4104,Kraslice,81,87,33,54
6344,4104,Kraslice,82,69,20,49
6345,4104,Kraslice,83,45,17,28
6346,4104,Kraslice,84,39,11,28
6347,4104,Kraslice,85,29,12,17
6348,4104,Kraslice,86,26,11,15
6349,4104,Kraslice,87,28,6,22
6350,4104,Kraslice,88,22,12,10
6351,4104,Kraslice,89,11,7,4
6352,4104,Kraslice,90,13,4,9
6353,4104,Kraslice,91,14,5,9
6354,4104,Kraslice,92,12,3,9
6355,4104,Kraslice,93,4,2,2
6356,4104,Kraslice,94,1,1,0
6357,4104,Kraslice,95,1,1,0
6358,4104,Kraslice,96,3,1,2
6359,4104,Kraslice,97,1,0,1
6360,4104,Kraslice,98,0,0,0
6361,4104,Kraslice,99,0,0,0
6362,4104,Kraslice,100,2,0,2
6363,4105,Mariánské Lázně,0,215,115,100
6364,4105,Mariánské Lázně,1,239,130,109
6365,4105,Mariánské Lázně,2,218,116,102
6366,4105,Mariánské Lázně,3,200,102,98
6367,4105,Mariánské Lázně,4,188,98,90
6368,4105,Mariánské Lázně,5,210,115,95
6369,4105,Mariánské Lázně,6,228,117,111
6370,4105,Mariánské Lázně,7,215,110,105
6371,4105,Mariánské Lázně,8,203,111,92
6372,4105,Mariánské Lázně,9,228,122,106
6373,4105,Mariánské Lázně,10,236,128,108
6374,4105,Mariánské Lázně,11,278,164,114
6375,4105,Mariánské Lázně,12,284,137,147
6376,4105,Mariánské Lázně,13,270,134,136
6377,4105,Mariánské Lázně,14,259,130,129
6378,4105,Mariánské Lázně,15,228,131,97
6379,4105,Mariánské Lázně,16,192,104,88
6380,4105,Mariánské Lázně,17,219,122,97
6381,4105,Mariánské Lázně,18,198,103,95
6382,4105,Mariánské Lázně,19,203,104,99
6383,4105,Mariánské Lázně,20,224,123,101
6384,4105,Mariánské Lázně,21,190,99,91
6385,4105,Mariánské Lázně,22,206,124,82
6386,4105,Mariánské Lázně,23,219,102,117
6387,4105,Mariánské Lázně,24,220,114,106
6388,4105,Mariánské Lázně,25,216,98,118
6389,4105,Mariánské Lázně,26,268,135,133
6390,4105,Mariánské Lázně,27,270,142,128
6391,4105,Mariánské Lázně,28,285,149,136
6392,4105,Mariánské Lázně,29,290,159,131
6393,4105,Mariánské Lázně,30,259,127,132
6394,4105,Mariánské Lázně,31,275,140,135
6395,4105,Mariánské Lázně,32,300,163,137
6396,4105,Mariánské Lázně,33,286,145,141
6397,4105,Mariánské Lázně,34,308,164,144
6398,4105,Mariánské Lázně,35,325,157,168
6399,4105,Mariánské Lázně,36,337,172,165
6400,4105,Mariánské Lázně,37,304,148,156
6401,4105,Mariánské Lázně,38,286,151,135
6402,4105,Mariánské Lázně,39,292,157,135
6403,4105,Mariánské Lázně,40,308,147,161
6404,4105,Mariánské Lázně,41,342,195,147
6405,4105,Mariánské Lázně,42,358,176,182
6406,4105,Mariánské Lázně,43,370,174,196
6407,4105,Mariánské Lázně,44,374,184,190
6408,4105,Mariánské Lázně,45,432,191,241
6409,4105,Mariánské Lázně,46,431,235,196
6410,4105,Mariánské Lázně,47,411,196,215
6411,4105,Mariánské Lázně,48,372,168,204
6412,4105,Mariánské Lázně,49,346,173,173
6413,4105,Mariánské Lázně,50,309,159,150
6414,4105,Mariánské Lázně,51,317,165,152
6415,4105,Mariánské Lázně,52,303,151,152
6416,4105,Mariánské Lázně,53,318,146,172
6417,4105,Mariánské Lázně,54,306,151,155
6418,4105,Mariánské Lázně,55,353,177,176
6419,4105,Mariánské Lázně,56,330,160,170
6420,4105,Mariánské Lázně,57,325,157,168
6421,4105,Mariánské Lázně,58,291,139,152
6422,4105,Mariánské Lázně,59,284,138,146
6423,4105,Mariánské Lázně,60,316,156,160
6424,4105,Mariánské Lázně,61,318,123,195
6425,4105,Mariánské Lázně,62,304,141,163
6426,4105,Mariánské Lázně,63,329,158,171
6427,4105,Mariánské Lázně,64,363,168,195
6428,4105,Mariánské Lázně,65,342,168,174
6429,4105,Mariánské Lázně,66,383,188,195
6430,4105,Mariánské Lázně,67,377,163,214
6431,4105,Mariánské Lázně,68,314,135,179
6432,4105,Mariánské Lázně,69,348,165,183
6433,4105,Mariánské Lázně,70,362,152,210
6434,4105,Mariánské Lázně,71,325,155,170
6435,4105,Mariánské Lázně,72,337,151,186
6436,4105,Mariánské Lázně,73,329,154,175
6437,4105,Mariánské Lázně,74,279,122,157
6438,4105,Mariánské Lázně,75,219,98,121
6439,4105,Mariánské Lázně,76,225,94,131
6440,4105,Mariánské Lázně,77,218,79,139
6441,4105,Mariánské Lázně,78,175,68,107
6442,4105,Mariánské Lázně,79,174,82,92
6443,4105,Mariánské Lázně,80,189,64,125
6444,4105,Mariánské Lázně,81,142,48,94
6445,4105,Mariánské Lázně,82,126,37,89
6446,4105,Mariánské Lázně,83,109,42,67
6447,4105,Mariánské Lázně,84,95,39,56
6448,4105,Mariánské Lázně,85,88,31,57
6449,4105,Mariánské Lázně,86,71,29,42
6450,4105,Mariánské Lázně,87,61,18,43
6451,4105,Mariánské Lázně,88,58,19,39
6452,4105,Mariánské Lázně,89,45,9,36
6453,4105,Mariánské Lázně,90,35,14,21
6454,4105,Mariánské Lázně,91,29,10,19
6455,4105,Mariánské Lázně,92,23,7,16
6456,4105,Mariánské Lázně,93,10,5,5
6457,4105,Mariánské Lázně,94,10,3,7
6458,4105,Mariánské Lázně,95,10,1,9
6459,4105,Mariánské Lázně,96,5,0,5
6460,4105,Mariánské Lázně,97,6,0,6
6461,4105,Mariánské Lázně,98,1,0,1
6462,4105,Mariánské Lázně,99,1,0,1
6463,4105,Mariánské Lázně,100,4,1,3
6464,4106,Ostrov,0,263,147,116
6465,4106,Ostrov,1,238,120,118
6466,4106,Ostrov,2,224,102,122
6467,4106,Ostrov,3,223,132,91
6468,4106,Ostrov,4,259,126,133
6469,4106,Ostrov,5,246,131,115
6470,4106,Ostrov,6,239,121,118
6471,4106,Ostrov,7,252,117,135
6472,4106,Ostrov,8,239,122,117
6473,4106,Ostrov,9,277,134,143
6474,4106,Ostrov,10,324,151,173
6475,4106,Ostrov,11,304,158,146
6476,4106,Ostrov,12,346,187,159
6477,4106,Ostrov,13,320,146,174
6478,4106,Ostrov,14,328,181,147
6479,4106,Ostrov,15,264,141,123
6480,4106,Ostrov,16,287,145,142
6481,4106,Ostrov,17,266,139,127
6482,4106,Ostrov,18,268,146,122
6483,4106,Ostrov,19,255,137,118
6484,4106,Ostrov,20,227,118,109
6485,4106,Ostrov,21,227,108,119
6486,4106,Ostrov,22,248,120,128
6487,4106,Ostrov,23,214,103,111
6488,4106,Ostrov,24,217,113,104
6489,4106,Ostrov,25,248,128,120
6490,4106,Ostrov,26,283,140,143
6491,4106,Ostrov,27,302,167,135
6492,4106,Ostrov,28,305,156,149
6493,4106,Ostrov,29,359,179,180
6494,4106,Ostrov,30,340,178,162
6495,4106,Ostrov,31,387,211,176
6496,4106,Ostrov,32,340,179,161
6497,4106,Ostrov,33,384,211,173
6498,4106,Ostrov,34,339,167,172
6499,4106,Ostrov,35,366,176,190
6500,4106,Ostrov,36,422,218,204
6501,4106,Ostrov,37,367,215,152
6502,4106,Ostrov,38,407,229,178
6503,4106,Ostrov,39,331,166,165
6504,4106,Ostrov,40,391,204,187
6505,4106,Ostrov,41,448,238,210
6506,4106,Ostrov,42,491,270,221
6507,4106,Ostrov,43,464,233,231
6508,4106,Ostrov,44,483,235,248
6509,4106,Ostrov,45,480,244,236
6510,4106,Ostrov,46,526,269,257
6511,4106,Ostrov,47,498,261,237
6512,4106,Ostrov,48,406,229,177
6513,4106,Ostrov,49,417,221,196
6514,4106,Ostrov,50,368,190,178
6515,4106,Ostrov,51,366,170,196
6516,4106,Ostrov,52,356,175,181
6517,4106,Ostrov,53,337,164,173
6518,4106,Ostrov,54,359,191,168
6519,4106,Ostrov,55,395,210,185
6520,4106,Ostrov,56,404,201,203
6521,4106,Ostrov,57,413,230,183
6522,4106,Ostrov,58,359,175,184
6523,4106,Ostrov,59,354,192,162
6524,4106,Ostrov,60,308,155,153
6525,4106,Ostrov,61,330,160,170
6526,4106,Ostrov,62,399,203,196
6527,4106,Ostrov,63,391,185,206
6528,4106,Ostrov,64,388,183,205
6529,4106,Ostrov,65,388,176,212
6530,4106,Ostrov,66,382,187,195
6531,4106,Ostrov,67,390,186,204
6532,4106,Ostrov,68,353,172,181
6533,4106,Ostrov,69,353,172,181
6534,4106,Ostrov,70,337,156,181
6535,4106,Ostrov,71,306,150,156
6536,4106,Ostrov,72,311,137,174
6537,4106,Ostrov,73,314,151,163
6538,4106,Ostrov,74,251,102,149
6539,4106,Ostrov,75,204,93,111
6540,4106,Ostrov,76,205,83,122
6541,4106,Ostrov,77,204,82,122
6542,4106,Ostrov,78,159,62,97
6543,4106,Ostrov,79,174,66,108
6544,4106,Ostrov,80,176,58,118
6545,4106,Ostrov,81,124,44,80
6546,4106,Ostrov,82,152,48,104
6547,4106,Ostrov,83,115,33,82
6548,4106,Ostrov,84,112,38,74
6549,4106,Ostrov,85,84,33,51
6550,4106,Ostrov,86,105,39,66
6551,4106,Ostrov,87,69,22,47
6552,4106,Ostrov,88,60,23,37
6553,4106,Ostrov,89,46,15,31
6554,4106,Ostrov,90,41,19,22
6555,4106,Ostrov,91,30,13,17
6556,4106,Ostrov,92,19,11,8
6557,4106,Ostrov,93,14,3,11
6558,4106,Ostrov,94,7,4,3
6559,4106,Ostrov,95,7,1,6
6560,4106,Ostrov,96,4,0,4
6561,4106,Ostrov,97,5,1,4
6562,4106,Ostrov,98,5,0,5
6563,4106,Ostrov,99,1,0,1
6564,4106,Ostrov,100,0,0,0
6565,4107,Sokolov,0,692,357,335
6566,4107,Sokolov,1,776,387,389
6567,4107,Sokolov,2,745,372,373
6568,4107,Sokolov,3,723,348,375
6569,4107,Sokolov,4,782,391,391
6570,4107,Sokolov,5,760,395,365
6571,4107,Sokolov,6,676,356,320
6572,4107,Sokolov,7,715,380,335
6573,4107,Sokolov,8,732,377,355
6574,4107,Sokolov,9,760,399,361
6575,4107,Sokolov,10,884,465,419
6576,4107,Sokolov,11,911,482,429
6577,4107,Sokolov,12,889,436,453
6578,4107,Sokolov,13,856,438,418
6579,4107,Sokolov,14,839,438,401
6580,4107,Sokolov,15,755,389,366
6581,4107,Sokolov,16,718,405,313
6582,4107,Sokolov,17,686,372,314
6583,4107,Sokolov,18,770,399,371
6584,4107,Sokolov,19,728,361,367
6585,4107,Sokolov,20,707,368,339
6586,4107,Sokolov,21,683,351,332
6587,4107,Sokolov,22,735,359,376
6588,4107,Sokolov,23,729,393,336
6589,4107,Sokolov,24,733,383,350
6590,4107,Sokolov,25,827,422,405
6591,4107,Sokolov,26,876,471,405
6592,4107,Sokolov,27,926,462,464
6593,4107,Sokolov,28,904,492,412
6594,4107,Sokolov,29,1017,543,474
6595,4107,Sokolov,30,985,483,502
6596,4107,Sokolov,31,970,500,470
6597,4107,Sokolov,32,987,498,489
6598,4107,Sokolov,33,975,511,464
6599,4107,Sokolov,34,973,497,476
6600,4107,Sokolov,35,992,527,465
6601,4107,Sokolov,36,953,494,459
6602,4107,Sokolov,37,998,516,482
6603,4107,Sokolov,38,997,509,488
6604,4107,Sokolov,39,963,512,451
6605,4107,Sokolov,40,986,542,444
6606,4107,Sokolov,41,1175,601,574
6607,4107,Sokolov,42,1137,582,555
6608,4107,Sokolov,43,1148,576,572
6609,4107,Sokolov,44,1260,657,603
6610,4107,Sokolov,45,1310,660,650
6611,4107,Sokolov,46,1275,646,629
6612,4107,Sokolov,47,1196,565,631
6613,4107,Sokolov,48,1237,653,584
6614,4107,Sokolov,49,1121,582,539
6615,4107,Sokolov,50,1162,580,582
6616,4107,Sokolov,51,1154,623,531
6617,4107,Sokolov,52,1066,541,525
6618,4107,Sokolov,53,1032,516,516
6619,4107,Sokolov,54,1002,505,497
6620,4107,Sokolov,55,1105,573,532
6621,4107,Sokolov,56,1057,523,534
6622,4107,Sokolov,57,1062,553,509
6623,4107,Sokolov,58,942,479,463
6624,4107,Sokolov,59,876,454,422
6625,4107,Sokolov,60,877,441,436
6626,4107,Sokolov,61,836,420,416
6627,4107,Sokolov,62,916,467,449
6628,4107,Sokolov,63,942,471,471
6629,4107,Sokolov,64,984,485,499
6630,4107,Sokolov,65,970,468,502
6631,4107,Sokolov,66,863,403,460
6632,4107,Sokolov,67,986,454,532
6633,4107,Sokolov,68,875,409,466
6634,4107,Sokolov,69,978,428,550
6635,4107,Sokolov,70,914,381,533
6636,4107,Sokolov,71,893,411,482
6637,4107,Sokolov,72,920,440,480
6638,4107,Sokolov,73,917,404,513
6639,4107,Sokolov,74,742,321,421
6640,4107,Sokolov,75,528,209,319
6641,4107,Sokolov,76,576,217,359
6642,4107,Sokolov,77,558,236,322
6643,4107,Sokolov,78,468,196,272
6644,4107,Sokolov,79,473,178,295
6645,4107,Sokolov,80,466,191,275
6646,4107,Sokolov,81,379,161,218
6647,4107,Sokolov,82,316,107,209
6648,4107,Sokolov,83,269,87,182
6649,4107,Sokolov,84,236,97,139
6650,4107,Sokolov,85,218,68,150
6651,4107,Sokolov,86,173,60,113
6652,4107,Sokolov,87,148,49,99
6653,4107,Sokolov,88,114,44,70
6654,4107,Sokolov,89,80,25,55
6655,4107,Sokolov,90,73,27,46
6656,4107,Sokolov,91,49,9,40
6657,4107,Sokolov,92,50,9,41
6658,4107,Sokolov,93,22,5,17
6659,4107,Sokolov,94,23,6,17
6660,4107,Sokolov,95,16,4,12
6661,4107,Sokolov,96,9,2,7
6662,4107,Sokolov,97,9,4,5
6663,4107,Sokolov,98,2,0,2
6664,4107,Sokolov,99,2,1,1
6665,4107,Sokolov,100,2,0,2
6666,4201,Bílina,0,189,104,85
6667,4201,Bílina,1,195,107,88
6668,4201,Bílina,2,177,90,87
6669,4201,Bílina,3,236,120,116
6670,4201,Bílina,4,208,93,115
6671,4201,Bílina,5,214,105,109
6672,4201,Bílina,6,191,107,84
6673,4201,Bílina,7,201,121,80
6674,4201,Bílina,8,198,98,100
6675,4201,Bílina,9,211,103,108
6676,4201,Bílina,10,261,134,127
6677,4201,Bílina,11,252,132,120
6678,4201,Bílina,12,277,138,139
6679,4201,Bílina,13,228,123,105
6680,4201,Bílina,14,277,135,142
6681,4201,Bílina,15,245,136,109
6682,4201,Bílina,16,222,103,119
6683,4201,Bílina,17,241,127,114
6684,4201,Bílina,18,211,111,100
6685,4201,Bílina,19,239,129,110
6686,4201,Bílina,20,212,106,106
6687,4201,Bílina,21,215,122,93
6688,4201,Bílina,22,231,119,112
6689,4201,Bílina,23,205,106,99
6690,4201,Bílina,24,212,110,102
6691,4201,Bílina,25,210,108,102
6692,4201,Bílina,26,268,144,124
6693,4201,Bílina,27,307,182,125
6694,4201,Bílina,28,269,152,117
6695,4201,Bílina,29,283,173,110
6696,4201,Bílina,30,303,188,115
6697,4201,Bílina,31,286,192,94
6698,4201,Bílina,32,340,200,140
6699,4201,Bílina,33,354,237,117
6700,4201,Bílina,34,325,211,114
6701,4201,Bílina,35,367,246,121
6702,4201,Bílina,36,371,247,124
6703,4201,Bílina,37,352,227,125
6704,4201,Bílina,38,340,230,110
6705,4201,Bílina,39,350,213,137
6706,4201,Bílina,40,354,214,140
6707,4201,Bílina,41,406,254,152
6708,4201,Bílina,42,413,236,177
6709,4201,Bílina,43,398,247,151
6710,4201,Bílina,44,427,241,186
6711,4201,Bílina,45,435,241,194
6712,4201,Bílina,46,415,249,166
6713,4201,Bílina,47,412,236,176
6714,4201,Bílina,48,389,225,164
6715,4201,Bílina,49,334,195,139
6716,4201,Bílina,50,355,217,138
6717,4201,Bílina,51,309,169,140
6718,4201,Bílina,52,311,176,135
6719,4201,Bílina,53,275,165,110
6720,4201,Bílina,54,287,157,130
6721,4201,Bílina,55,298,150,148
6722,4201,Bílina,56,315,169,146
6723,4201,Bílina,57,284,161,123
6724,4201,Bílina,58,245,134,111
6725,4201,Bílina,59,242,150,92
6726,4201,Bílina,60,249,125,124
6727,4201,Bílina,61,227,116,111
6728,4201,Bílina,62,269,139,130
6729,4201,Bílina,63,288,141,147
6730,4201,Bílina,64,267,143,124
6731,4201,Bílina,65,275,139,136
6732,4201,Bílina,66,293,144,149
6733,4201,Bílina,67,290,155,135
6734,4201,Bílina,68,250,112,138
6735,4201,Bílina,69,236,113,123
6736,4201,Bílina,70,291,130,161
6737,4201,Bílina,71,255,116,139
6738,4201,Bílina,72,271,127,144
6739,4201,Bílina,73,283,132,151
6740,4201,Bílina,74,224,109,115
6741,4201,Bílina,75,181,80,101
6742,4201,Bílina,76,165,76,89
6743,4201,Bílina,77,155,67,88
6744,4201,Bílina,78,128,49,79
6745,4201,Bílina,79,102,37,65
6746,4201,Bílina,80,127,49,78
6747,4201,Bílina,81,106,41,65
6748,4201,Bílina,82,74,22,52
6749,4201,Bílina,83,56,25,31
6750,4201,Bílina,84,60,26,34
6751,4201,Bílina,85,46,18,28
6752,4201,Bílina,86,39,16,23
6753,4201,Bílina,87,18,6,12
6754,4201,Bílina,88,26,5,21
6755,4201,Bílina,89,21,8,13
6756,4201,Bílina,90,23,10,13
6757,4201,Bílina,91,10,2,8
6758,4201,Bílina,92,5,3,2
6759,4201,Bílina,93,4,0,4
6760,4201,Bílina,94,10,3,7
6761,4201,Bílina,95,3,0,3
6762,4201,Bílina,96,3,1,2
6763,4201,Bílina,97,0,0,0
6764,4201,Bílina,98,0,0,0
6765,4201,Bílina,99,1,1,0
6766,4201,Bílina,100,0,0,0
6767,4202,Děčín,0,688,337,351
6768,4202,Děčín,1,762,400,362
6769,4202,Děčín,2,684,353,331
6770,4202,Děčín,3,797,422,375
6771,4202,Děčín,4,743,378,365
6772,4202,Děčín,5,756,373,383
6773,4202,Děčín,6,735,386,349
6774,4202,Děčín,7,772,402,370
6775,4202,Děčín,8,780,396,384
6776,4202,Děčín,9,833,440,393
6777,4202,Děčín,10,899,453,446
6778,4202,Děčín,11,943,490,453
6779,4202,Děčín,12,968,491,477
6780,4202,Děčín,13,968,489,479
6781,4202,Děčín,14,832,433,399
6782,4202,Děčín,15,864,420,444
6783,4202,Děčín,16,756,414,342
6784,4202,Děčín,17,843,450,393
6785,4202,Děčín,18,765,368,397
6786,4202,Děčín,19,772,391,381
6787,4202,Děčín,20,735,366,369
6788,4202,Děčín,21,703,356,347
6789,4202,Děčín,22,761,390,371
6790,4202,Děčín,23,654,353,301
6791,4202,Děčín,24,683,354,329
6792,4202,Děčín,25,762,385,377
6793,4202,Děčín,26,787,419,368
6794,4202,Děčín,27,944,488,456
6795,4202,Děčín,28,915,482,433
6796,4202,Děčín,29,957,509,448
6797,4202,Děčín,30,881,476,405
6798,4202,Děčín,31,886,464,422
6799,4202,Děčín,32,904,470,434
6800,4202,Děčín,33,916,462,454
6801,4202,Děčín,34,914,490,424
6802,4202,Děčín,35,936,483,453
6803,4202,Děčín,36,920,474,446
6804,4202,Děčín,37,917,461,456
6805,4202,Děčín,38,1014,510,504
6806,4202,Děčín,39,945,504,441
6807,4202,Děčín,40,978,519,459
6808,4202,Děčín,41,1201,614,587
6809,4202,Děčín,42,1196,613,583
6810,4202,Děčín,43,1244,697,547
6811,4202,Děčín,44,1339,677,662
6812,4202,Děčín,45,1419,740,679
6813,4202,Děčín,46,1444,709,735
6814,4202,Děčín,47,1399,738,661
6815,4202,Děčín,48,1261,627,634
6816,4202,Děčín,49,1132,585,547
6817,4202,Děčín,50,1139,592,547
6818,4202,Děčín,51,1051,539,512
6819,4202,Děčín,52,941,462,479
6820,4202,Děčín,53,961,484,477
6821,4202,Děčín,54,891,445,446
6822,4202,Děčín,55,1013,524,489
6823,4202,Děčín,56,1068,525,543
6824,4202,Děčín,57,944,470,474
6825,4202,Děčín,58,853,432,421
6826,4202,Děčín,59,728,361,367
6827,4202,Děčín,60,755,384,371
6828,4202,Děčín,61,743,379,364
6829,4202,Děčín,62,836,392,444
6830,4202,Děčín,63,950,459,491
6831,4202,Děčín,64,947,447,500
6832,4202,Děčín,65,928,450,478
6833,4202,Děčín,66,1018,458,560
6834,4202,Děčín,67,1053,456,597
6835,4202,Děčín,68,996,452,544
6836,4202,Děčín,69,1082,481,601
6837,4202,Děčín,70,1110,493,617
6838,4202,Děčín,71,1002,449,553
6839,4202,Děčín,72,1134,498,636
6840,4202,Děčín,73,1144,534,610
6841,4202,Děčín,74,1033,458,575
6842,4202,Děčín,75,718,320,398
6843,4202,Děčín,76,705,309,396
6844,4202,Děčín,77,647,260,387
6845,4202,Děčín,78,523,215,308
6846,4202,Děčín,79,514,214,300
6847,4202,Děčín,80,383,143,240
6848,4202,Děčín,81,343,127,216
6849,4202,Děčín,82,298,100,198
6850,4202,Děčín,83,261,88,173
6851,4202,Děčín,84,241,84,157
6852,4202,Děčín,85,220,81,139
6853,4202,Děčín,86,200,59,141
6854,4202,Děčín,87,165,61,104
6855,4202,Děčín,88,154,48,106
6856,4202,Děčín,89,146,49,97
6857,4202,Děčín,90,101,32,69
6858,4202,Děčín,91,77,21,56
6859,4202,Děčín,92,63,18,45
6860,4202,Děčín,93,53,14,39
6861,4202,Děčín,94,28,8,20
6862,4202,Děčín,95,18,4,14
6863,4202,Děčín,96,16,1,15
6864,4202,Děčín,97,16,2,14
6865,4202,Děčín,98,5,0,5
6866,4202,Děčín,99,2,0,2
6867,4202,Děčín,100,7,0,7
6868,4203,Chomutov,0,806,413,393
6869,4203,Chomutov,1,819,422,397
6870,4203,Chomutov,2,857,447,410
6871,4203,Chomutov,3,834,413,421
6872,4203,Chomutov,4,812,419,393
6873,4203,Chomutov,5,853,434,419
6874,4203,Chomutov,6,810,401,409
6875,4203,Chomutov,7,813,414,399
6876,4203,Chomutov,8,851,434,417
6877,4203,Chomutov,9,859,448,411
6878,4203,Chomutov,10,947,520,427
6879,4203,Chomutov,11,1007,505,502
6880,4203,Chomutov,12,1033,511,522
6881,4203,Chomutov,13,922,467,455
6882,4203,Chomutov,14,857,434,423
6883,4203,Chomutov,15,836,399,437
6884,4203,Chomutov,16,826,403,423
6885,4203,Chomutov,17,817,423,394
6886,4203,Chomutov,18,819,404,415
6887,4203,Chomutov,19,811,425,386
6888,4203,Chomutov,20,777,382,395
6889,4203,Chomutov,21,794,390,404
6890,4203,Chomutov,22,796,412,384
6891,4203,Chomutov,23,731,387,344
6892,4203,Chomutov,24,806,408,398
6893,4203,Chomutov,25,805,401,404
6894,4203,Chomutov,26,918,467,451
6895,4203,Chomutov,27,952,510,442
6896,4203,Chomutov,28,1035,557,478
6897,4203,Chomutov,29,1092,593,499
6898,4203,Chomutov,30,1023,548,475
6899,4203,Chomutov,31,1065,529,536
6900,4203,Chomutov,32,1108,576,532
6901,4203,Chomutov,33,1146,608,538
6902,4203,Chomutov,34,1101,593,508
6903,4203,Chomutov,35,1154,634,520
6904,4203,Chomutov,36,1221,651,570
6905,4203,Chomutov,37,1163,624,539
6906,4203,Chomutov,38,1172,660,512
6907,4203,Chomutov,39,1213,666,547
6908,4203,Chomutov,40,1186,624,562
6909,4203,Chomutov,41,1344,684,660
6910,4203,Chomutov,42,1369,730,639
6911,4203,Chomutov,43,1364,724,640
6912,4203,Chomutov,44,1378,699,679
6913,4203,Chomutov,45,1472,740,732
6914,4203,Chomutov,46,1388,695,693
6915,4203,Chomutov,47,1414,755,659
6916,4203,Chomutov,48,1253,655,598
6917,4203,Chomutov,49,1200,625,575
6918,4203,Chomutov,50,1169,571,598
6919,4203,Chomutov,51,1150,614,536
6920,4203,Chomutov,52,1099,581,518
6921,4203,Chomutov,53,1119,541,578
6922,4203,Chomutov,54,1135,558,577
6923,4203,Chomutov,55,1094,576,518
6924,4203,Chomutov,56,1171,589,582
6925,4203,Chomutov,57,1147,600,547
6926,4203,Chomutov,58,1024,506,518
6927,4203,Chomutov,59,998,497,501
6928,4203,Chomutov,60,947,468,479
6929,4203,Chomutov,61,944,471,473
6930,4203,Chomutov,62,1028,499,529
6931,4203,Chomutov,63,1071,504,567
6932,4203,Chomutov,64,990,467,523
6933,4203,Chomutov,65,978,453,525
6934,4203,Chomutov,66,974,468,506
6935,4203,Chomutov,67,1012,471,541
6936,4203,Chomutov,68,1004,481,523
6937,4203,Chomutov,69,1027,480,547
6938,4203,Chomutov,70,950,444,506
6939,4203,Chomutov,71,961,457,504
6940,4203,Chomutov,72,910,397,513
6941,4203,Chomutov,73,918,401,517
6942,4203,Chomutov,74,851,356,495
6943,4203,Chomutov,75,580,231,349
6944,4203,Chomutov,76,571,241,330
6945,4203,Chomutov,77,538,200,338
6946,4203,Chomutov,78,475,184,291
6947,4203,Chomutov,79,446,176,270
6948,4203,Chomutov,80,457,168,289
6949,4203,Chomutov,81,351,126,225
6950,4203,Chomutov,82,293,94,199
6951,4203,Chomutov,83,274,99,175
6952,4203,Chomutov,84,237,95,142
6953,4203,Chomutov,85,202,60,142
6954,4203,Chomutov,86,193,65,128
6955,4203,Chomutov,87,140,51,89
6956,4203,Chomutov,88,101,33,68
6957,4203,Chomutov,89,81,35,46
6958,4203,Chomutov,90,75,15,60
6959,4203,Chomutov,91,60,13,47
6960,4203,Chomutov,92,66,16,50
6961,4203,Chomutov,93,27,8,19
6962,4203,Chomutov,94,29,6,23
6963,4203,Chomutov,95,13,3,10
6964,4203,Chomutov,96,18,4,14
6965,4203,Chomutov,97,14,1,13
6966,4203,Chomutov,98,3,1,2
6967,4203,Chomutov,99,6,0,6
6968,4203,Chomutov,100,3,0,3
6969,4204,Kadaň,0,414,211,203
6970,4204,Kadaň,1,463,236,227
6971,4204,Kadaň,2,399,209,190
6972,4204,Kadaň,3,434,222,212
6973,4204,Kadaň,4,441,205,236
6974,4204,Kadaň,5,416,183,233
6975,4204,Kadaň,6,412,224,188
6976,4204,Kadaň,7,394,203,191
6977,4204,Kadaň,8,397,182,215
6978,4204,Kadaň,9,392,208,184
6979,4204,Kadaň,10,499,243,256
6980,4204,Kadaň,11,481,258,223
6981,4204,Kadaň,12,571,284,287
6982,4204,Kadaň,13,473,220,253
6983,4204,Kadaň,14,437,233,204
6984,4204,Kadaň,15,458,255,203
6985,4204,Kadaň,16,433,218,215
6986,4204,Kadaň,17,408,219,189
6987,4204,Kadaň,18,425,219,206
6988,4204,Kadaň,19,398,197,201
6989,4204,Kadaň,20,404,219,185
6990,4204,Kadaň,21,425,224,201
6991,4204,Kadaň,22,418,199,219
6992,4204,Kadaň,23,412,212,200
6993,4204,Kadaň,24,432,225,207
6994,4204,Kadaň,25,471,251,220
6995,4204,Kadaň,26,493,268,225
6996,4204,Kadaň,27,572,326,246
6997,4204,Kadaň,28,526,300,226
6998,4204,Kadaň,29,537,305,232
6999,4204,Kadaň,30,598,299,299
7000,4204,Kadaň,31,584,306,278
7001,4204,Kadaň,32,638,354,284
7002,4204,Kadaň,33,587,333,254
7003,4204,Kadaň,34,580,299,281
7004,4204,Kadaň,35,555,311,244
7005,4204,Kadaň,36,596,311,285
7006,4204,Kadaň,37,598,328,270
7007,4204,Kadaň,38,584,310,274
7008,4204,Kadaň,39,627,322,305
7009,4204,Kadaň,40,632,312,320
7010,4204,Kadaň,41,725,389,336
7011,4204,Kadaň,42,679,365,314
7012,4204,Kadaň,43,680,363,317
7013,4204,Kadaň,44,794,420,374
7014,4204,Kadaň,45,784,421,363
7015,4204,Kadaň,46,802,433,369
7016,4204,Kadaň,47,730,376,354
7017,4204,Kadaň,48,711,370,341
7018,4204,Kadaň,49,643,328,315
7019,4204,Kadaň,50,604,305,299
7020,4204,Kadaň,51,577,314,263
7021,4204,Kadaň,52,543,292,251
7022,4204,Kadaň,53,554,306,248
7023,4204,Kadaň,54,582,288,294
7024,4204,Kadaň,55,572,275,297
7025,4204,Kadaň,56,628,332,296
7026,4204,Kadaň,57,578,297,281
7027,4204,Kadaň,58,545,284,261
7028,4204,Kadaň,59,510,253,257
7029,4204,Kadaň,60,493,266,227
7030,4204,Kadaň,61,490,247,243
7031,4204,Kadaň,62,476,245,231
7032,4204,Kadaň,63,561,286,275
7033,4204,Kadaň,64,532,232,300
7034,4204,Kadaň,65,588,267,321
7035,4204,Kadaň,66,540,262,278
7036,4204,Kadaň,67,578,254,324
7037,4204,Kadaň,68,545,271,274
7038,4204,Kadaň,69,555,257,298
7039,4204,Kadaň,70,557,243,314
7040,4204,Kadaň,71,551,232,319
7041,4204,Kadaň,72,572,248,324
7042,4204,Kadaň,73,516,251,265
7043,4204,Kadaň,74,446,185,261
7044,4204,Kadaň,75,323,136,187
7045,4204,Kadaň,76,335,140,195
7046,4204,Kadaň,77,277,112,165
7047,4204,Kadaň,78,275,99,176
7048,4204,Kadaň,79,232,99,133
7049,4204,Kadaň,80,249,97,152
7050,4204,Kadaň,81,180,67,113
7051,4204,Kadaň,82,154,55,99
7052,4204,Kadaň,83,129,46,83
7053,4204,Kadaň,84,118,38,80
7054,4204,Kadaň,85,92,30,62
7055,4204,Kadaň,86,79,25,54
7056,4204,Kadaň,87,87,26,61
7057,4204,Kadaň,88,60,23,37
7058,4204,Kadaň,89,56,10,46
7059,4204,Kadaň,90,40,7,33
7060,4204,Kadaň,91,24,7,17
7061,4204,Kadaň,92,13,3,10
7062,4204,Kadaň,93,19,4,15
7063,4204,Kadaň,94,21,3,18
7064,4204,Kadaň,95,11,4,7
7065,4204,Kadaň,96,9,1,8
7066,4204,Kadaň,97,2,1,1
7067,4204,Kadaň,98,3,0,3
7068,4204,Kadaň,99,2,0,2
7069,4204,Kadaň,100,2,0,2
7070,4205,Litoměřice,0,555,283,272
7071,4205,Litoměřice,1,580,293,287
7072,4205,Litoměřice,2,588,279,309
7073,4205,Litoměřice,3,617,314,303
7074,4205,Litoměřice,4,558,279,279
7075,4205,Litoměřice,5,663,350,313
7076,4205,Litoměřice,6,632,330,302
7077,4205,Litoměřice,7,616,319,297
7078,4205,Litoměřice,8,614,312,302
7079,4205,Litoměřice,9,692,357,335
7080,4205,Litoměřice,10,654,348,306
7081,4205,Litoměřice,11,641,307,334
7082,4205,Litoměřice,12,735,397,338
7083,4205,Litoměřice,13,724,382,342
7084,4205,Litoměřice,14,645,340,305
7085,4205,Litoměřice,15,645,325,320
7086,4205,Litoměřice,16,594,288,306
7087,4205,Litoměřice,17,549,279,270
7088,4205,Litoměřice,18,537,291,246
7089,4205,Litoměřice,19,578,297,281
7090,4205,Litoměřice,20,533,260,273
7091,4205,Litoměřice,21,522,262,260
7092,4205,Litoměřice,22,523,278,245
7093,4205,Litoměřice,23,528,271,257
7094,4205,Litoměřice,24,534,290,244
7095,4205,Litoměřice,25,594,311,283
7096,4205,Litoměřice,26,582,287,295
7097,4205,Litoměřice,27,685,345,340
7098,4205,Litoměřice,28,700,352,348
7099,4205,Litoměřice,29,773,401,372
7100,4205,Litoměřice,30,716,354,362
7101,4205,Litoměřice,31,722,380,342
7102,4205,Litoměřice,32,755,400,355
7103,4205,Litoměřice,33,714,370,344
7104,4205,Litoměřice,34,741,393,348
7105,4205,Litoměřice,35,753,402,351
7106,4205,Litoměřice,36,773,409,364
7107,4205,Litoměřice,37,789,406,383
7108,4205,Litoměřice,38,766,375,391
7109,4205,Litoměřice,39,814,439,375
7110,4205,Litoměřice,40,923,491,432
7111,4205,Litoměřice,41,976,507,469
7112,4205,Litoměřice,42,1007,514,493
7113,4205,Litoměřice,43,1032,532,500
7114,4205,Litoměřice,44,1011,488,523
7115,4205,Litoměřice,45,1087,548,539
7116,4205,Litoměřice,46,1084,566,518
7117,4205,Litoměřice,47,980,527,453
7118,4205,Litoměřice,48,936,475,461
7119,4205,Litoměřice,49,861,416,445
7120,4205,Litoměřice,50,843,438,405
7121,4205,Litoměřice,51,804,421,383
7122,4205,Litoměřice,52,767,383,384
7123,4205,Litoměřice,53,764,389,375
7124,4205,Litoměřice,54,761,387,374
7125,4205,Litoměřice,55,806,419,387
7126,4205,Litoměřice,56,751,369,382
7127,4205,Litoměřice,57,772,403,369
7128,4205,Litoměřice,58,666,337,329
7129,4205,Litoměřice,59,634,312,322
7130,4205,Litoměřice,60,629,290,339
7131,4205,Litoměřice,61,620,296,324
7132,4205,Litoměřice,62,719,357,362
7133,4205,Litoměřice,63,749,369,380
7134,4205,Litoměřice,64,791,390,401
7135,4205,Litoměřice,65,834,399,435
7136,4205,Litoměřice,66,852,410,442
7137,4205,Litoměřice,67,718,341,377
7138,4205,Litoměřice,68,767,363,404
7139,4205,Litoměřice,69,720,340,380
7140,4205,Litoměřice,70,780,335,445
7141,4205,Litoměřice,71,753,320,433
7142,4205,Litoměřice,72,739,310,429
7143,4205,Litoměřice,73,750,321,429
7144,4205,Litoměřice,74,680,307,373
7145,4205,Litoměřice,75,477,198,279
7146,4205,Litoměřice,76,462,204,258
7147,4205,Litoměřice,77,476,203,273
7148,4205,Litoměřice,78,400,171,229
7149,4205,Litoměřice,79,382,140,242
7150,4205,Litoměřice,80,325,136,189
7151,4205,Litoměřice,81,259,103,156
7152,4205,Litoměřice,82,232,86,146
7153,4205,Litoměřice,83,185,57,128
7154,4205,Litoměřice,84,161,43,118
7155,4205,Litoměřice,85,168,65,103
7156,4205,Litoměřice,86,161,50,111
7157,4205,Litoměřice,87,127,40,87
7158,4205,Litoměřice,88,105,31,74
7159,4205,Litoměřice,89,81,30,51
7160,4205,Litoměřice,90,73,16,57
7161,4205,Litoměřice,91,52,16,36
7162,4205,Litoměřice,92,39,8,31
7163,4205,Litoměřice,93,24,5,19
7164,4205,Litoměřice,94,24,2,22
7165,4205,Litoměřice,95,13,4,9
7166,4205,Litoměřice,96,16,2,14
7167,4205,Litoměřice,97,4,1,3
7168,4205,Litoměřice,98,4,1,3
7169,4205,Litoměřice,99,1,0,1
7170,4205,Litoměřice,100,5,1,4
7171,4206,Litvínov,0,330,174,156
7172,4206,Litvínov,1,338,185,153
7173,4206,Litvínov,2,351,177,174
7174,4206,Litvínov,3,375,194,181
7175,4206,Litvínov,4,383,204,179
7176,4206,Litvínov,5,363,173,190
7177,4206,Litvínov,6,366,188,178
7178,4206,Litvínov,7,377,204,173
7179,4206,Litvínov,8,369,187,182
7180,4206,Litvínov,9,375,192,183
7181,4206,Litvínov,10,405,225,180
7182,4206,Litvínov,11,475,238,237
7183,4206,Litvínov,12,501,241,260
7184,4206,Litvínov,13,437,235,202
7185,4206,Litvínov,14,411,208,203
7186,4206,Litvínov,15,355,203,152
7187,4206,Litvínov,16,385,183,202
7188,4206,Litvínov,17,350,184,166
7189,4206,Litvínov,18,404,217,187
7190,4206,Litvínov,19,369,192,177
7191,4206,Litvínov,20,358,193,165
7192,4206,Litvínov,21,332,158,174
7193,4206,Litvínov,22,320,148,172
7194,4206,Litvínov,23,330,174,156
7195,4206,Litvínov,24,296,164,132
7196,4206,Litvínov,25,338,174,164
7197,4206,Litvínov,26,396,192,204
7198,4206,Litvínov,27,459,232,227
7199,4206,Litvínov,28,429,223,206
7200,4206,Litvínov,29,414,218,196
7201,4206,Litvínov,30,441,220,221
7202,4206,Litvínov,31,426,219,207
7203,4206,Litvínov,32,465,237,228
7204,4206,Litvínov,33,435,230,205
7205,4206,Litvínov,34,482,248,234
7206,4206,Litvínov,35,449,222,227
7207,4206,Litvínov,36,443,226,217
7208,4206,Litvínov,37,466,243,223
7209,4206,Litvínov,38,467,251,216
7210,4206,Litvínov,39,487,234,253
7211,4206,Litvínov,40,521,253,268
7212,4206,Litvínov,41,557,298,259
7213,4206,Litvínov,42,610,319,291
7214,4206,Litvínov,43,621,345,276
7215,4206,Litvínov,44,659,347,312
7216,4206,Litvínov,45,658,335,323
7217,4206,Litvínov,46,666,354,312
7218,4206,Litvínov,47,577,320,257
7219,4206,Litvínov,48,595,298,297
7220,4206,Litvínov,49,499,264,235
7221,4206,Litvínov,50,543,271,272
7222,4206,Litvínov,51,477,266,211
7223,4206,Litvínov,52,474,263,211
7224,4206,Litvínov,53,440,214,226
7225,4206,Litvínov,54,506,260,246
7226,4206,Litvínov,55,538,293,245
7227,4206,Litvínov,56,525,272,253
7228,4206,Litvínov,57,532,266,266
7229,4206,Litvínov,58,403,200,203
7230,4206,Litvínov,59,440,231,209
7231,4206,Litvínov,60,425,214,211
7232,4206,Litvínov,61,397,196,201
7233,4206,Litvínov,62,465,231,234
7234,4206,Litvínov,63,488,261,227
7235,4206,Litvínov,64,502,246,256
7236,4206,Litvínov,65,546,266,280
7237,4206,Litvínov,66,500,217,283
7238,4206,Litvínov,67,487,247,240
7239,4206,Litvínov,68,493,250,243
7240,4206,Litvínov,69,558,264,294
7241,4206,Litvínov,70,479,206,273
7242,4206,Litvínov,71,456,209,247
7243,4206,Litvínov,72,493,220,273
7244,4206,Litvínov,73,456,202,254
7245,4206,Litvínov,74,441,170,271
7246,4206,Litvínov,75,325,121,204
7247,4206,Litvínov,76,321,131,190
7248,4206,Litvínov,77,324,140,184
7249,4206,Litvínov,78,289,116,173
7250,4206,Litvínov,79,275,105,170
7251,4206,Litvínov,80,251,113,138
7252,4206,Litvínov,81,186,72,114
7253,4206,Litvínov,82,155,68,87
7254,4206,Litvínov,83,136,43,93
7255,4206,Litvínov,84,113,48,65
7256,4206,Litvínov,85,119,42,77
7257,4206,Litvínov,86,76,24,52
7258,4206,Litvínov,87,76,19,57
7259,4206,Litvínov,88,79,23,56
7260,4206,Litvínov,89,53,11,42
7261,4206,Litvínov,90,48,11,37
7262,4206,Litvínov,91,33,7,26
7263,4206,Litvínov,92,24,4,20
7264,4206,Litvínov,93,25,6,19
7265,4206,Litvínov,94,13,2,11
7266,4206,Litvínov,95,6,1,5
7267,4206,Litvínov,96,12,4,8
7268,4206,Litvínov,97,3,0,3
7269,4206,Litvínov,98,7,1,6
7270,4206,Litvínov,99,2,0,2
7271,4206,Litvínov,100,4,2,2
7272,4207,Louny,0,421,215,206
7273,4207,Louny,1,416,205,211
7274,4207,Louny,2,447,239,208
7275,4207,Louny,3,457,230,227
7276,4207,Louny,4,454,244,210
7277,4207,Louny,5,444,207,237
7278,4207,Louny,6,437,230,207
7279,4207,Louny,7,471,237,234
7280,4207,Louny,8,424,228,196
7281,4207,Louny,9,451,229,222
7282,4207,Louny,10,527,266,261
7283,4207,Louny,11,534,269,265
7284,4207,Louny,12,543,285,258
7285,4207,Louny,13,483,228,255
7286,4207,Louny,14,486,248,238
7287,4207,Louny,15,406,216,190
7288,4207,Louny,16,454,216,238
7289,4207,Louny,17,423,210,213
7290,4207,Louny,18,401,213,188
7291,4207,Louny,19,403,225,178
7292,4207,Louny,20,397,204,193
7293,4207,Louny,21,385,201,184
7294,4207,Louny,22,395,203,192
7295,4207,Louny,23,387,205,182
7296,4207,Louny,24,438,204,234
7297,4207,Louny,25,407,211,196
7298,4207,Louny,26,455,232,223
7299,4207,Louny,27,521,270,251
7300,4207,Louny,28,515,267,248
7301,4207,Louny,29,498,261,237
7302,4207,Louny,30,534,275,259
7303,4207,Louny,31,584,306,278
7304,4207,Louny,32,555,274,281
7305,4207,Louny,33,540,280,260
7306,4207,Louny,34,543,264,279
7307,4207,Louny,35,584,314,270
7308,4207,Louny,36,566,312,254
7309,4207,Louny,37,625,335,290
7310,4207,Louny,38,635,336,299
7311,4207,Louny,39,613,329,284
7312,4207,Louny,40,672,347,325
7313,4207,Louny,41,705,381,324
7314,4207,Louny,42,737,379,358
7315,4207,Louny,43,757,359,398
7316,4207,Louny,44,751,390,361
7317,4207,Louny,45,791,420,371
7318,4207,Louny,46,879,441,438
7319,4207,Louny,47,778,424,354
7320,4207,Louny,48,714,349,365
7321,4207,Louny,49,660,351,309
7322,4207,Louny,50,583,289,294
7323,4207,Louny,51,535,286,249
7324,4207,Louny,52,525,256,269
7325,4207,Louny,53,541,303,238
7326,4207,Louny,54,537,265,272
7327,4207,Louny,55,579,289,290
7328,4207,Louny,56,597,319,278
7329,4207,Louny,57,572,312,260
7330,4207,Louny,58,503,237,266
7331,4207,Louny,59,451,216,235
7332,4207,Louny,60,495,218,277
7333,4207,Louny,61,473,224,249
7334,4207,Louny,62,507,261,246
7335,4207,Louny,63,581,277,304
7336,4207,Louny,64,572,278,294
7337,4207,Louny,65,625,287,338
7338,4207,Louny,66,565,288,277
7339,4207,Louny,67,595,270,325
7340,4207,Louny,68,591,257,334
7341,4207,Louny,69,565,249,316
7342,4207,Louny,70,614,277,337
7343,4207,Louny,71,560,243,317
7344,4207,Louny,72,542,261,281
7345,4207,Louny,73,572,261,311
7346,4207,Louny,74,518,238,280
7347,4207,Louny,75,345,136,209
7348,4207,Louny,76,350,146,204
7349,4207,Louny,77,294,123,171
7350,4207,Louny,78,283,109,174
7351,4207,Louny,79,228,80,148
7352,4207,Louny,80,240,78,162
7353,4207,Louny,81,195,64,131
7354,4207,Louny,82,155,51,104
7355,4207,Louny,83,146,54,92
7356,4207,Louny,84,127,46,81
7357,4207,Louny,85,121,43,78
7358,4207,Louny,86,100,35,65
7359,4207,Louny,87,82,16,66
7360,4207,Louny,88,56,21,35
7361,4207,Louny,89,69,21,48
7362,4207,Louny,90,53,18,35
7363,4207,Louny,91,28,6,22
7364,4207,Louny,92,20,6,14
7365,4207,Louny,93,29,5,24
7366,4207,Louny,94,13,2,11
7367,4207,Louny,95,13,4,9
7368,4207,Louny,96,6,1,5
7369,4207,Louny,97,5,0,5
7370,4207,Louny,98,4,1,3
7371,4207,Louny,99,1,0,1
7372,4207,Louny,100,3,3,0
7373,4208,Lovosice,0,273,128,145
7374,4208,Lovosice,1,285,148,137
7375,4208,Lovosice,2,261,136,125
7376,4208,Lovosice,3,277,134,143
7377,4208,Lovosice,4,289,153,136
7378,4208,Lovosice,5,260,137,123
7379,4208,Lovosice,6,277,147,130
7380,4208,Lovosice,7,280,149,131
7381,4208,Lovosice,8,294,137,157
7382,4208,Lovosice,9,299,161,138
7383,4208,Lovosice,10,303,157,146
7384,4208,Lovosice,11,338,160,178
7385,4208,Lovosice,12,319,158,161
7386,4208,Lovosice,13,333,170,163
7387,4208,Lovosice,14,270,143,127
7388,4208,Lovosice,15,259,133,126
7389,4208,Lovosice,16,280,160,120
7390,4208,Lovosice,17,253,134,119
7391,4208,Lovosice,18,228,120,108
7392,4208,Lovosice,19,264,136,128
7393,4208,Lovosice,20,254,136,118
7394,4208,Lovosice,21,253,131,122
7395,4208,Lovosice,22,246,118,128
7396,4208,Lovosice,23,234,117,117
7397,4208,Lovosice,24,249,135,114
7398,4208,Lovosice,25,279,152,127
7399,4208,Lovosice,26,297,165,132
7400,4208,Lovosice,27,364,181,183
7401,4208,Lovosice,28,352,176,176
7402,4208,Lovosice,29,342,187,155
7403,4208,Lovosice,30,323,182,141
7404,4208,Lovosice,31,332,170,162
7405,4208,Lovosice,32,353,197,156
7406,4208,Lovosice,33,357,194,163
7407,4208,Lovosice,34,363,195,168
7408,4208,Lovosice,35,340,175,165
7409,4208,Lovosice,36,367,192,175
7410,4208,Lovosice,37,381,199,182
7411,4208,Lovosice,38,398,214,184
7412,4208,Lovosice,39,372,201,171
7413,4208,Lovosice,40,400,203,197
7414,4208,Lovosice,41,490,244,246
7415,4208,Lovosice,42,441,244,197
7416,4208,Lovosice,43,477,247,230
7417,4208,Lovosice,44,479,234,245
7418,4208,Lovosice,45,479,243,236
7419,4208,Lovosice,46,506,269,237
7420,4208,Lovosice,47,495,254,241
7421,4208,Lovosice,48,423,210,213
7422,4208,Lovosice,49,435,234,201
7423,4208,Lovosice,50,397,206,191
7424,4208,Lovosice,51,355,188,167
7425,4208,Lovosice,52,318,171,147
7426,4208,Lovosice,53,342,181,161
7427,4208,Lovosice,54,330,175,155
7428,4208,Lovosice,55,341,177,164
7429,4208,Lovosice,56,392,207,185
7430,4208,Lovosice,57,348,179,169
7431,4208,Lovosice,58,323,172,151
7432,4208,Lovosice,59,289,143,146
7433,4208,Lovosice,60,300,154,146
7434,4208,Lovosice,61,288,137,151
7435,4208,Lovosice,62,345,177,168
7436,4208,Lovosice,63,363,181,182
7437,4208,Lovosice,64,366,173,193
7438,4208,Lovosice,65,352,169,183
7439,4208,Lovosice,66,363,161,202
7440,4208,Lovosice,67,340,168,172
7441,4208,Lovosice,68,351,159,192
7442,4208,Lovosice,69,401,181,220
7443,4208,Lovosice,70,330,156,174
7444,4208,Lovosice,71,348,155,193
7445,4208,Lovosice,72,369,170,199
7446,4208,Lovosice,73,399,189,210
7447,4208,Lovosice,74,303,139,164
7448,4208,Lovosice,75,222,95,127
7449,4208,Lovosice,76,240,91,149
7450,4208,Lovosice,77,228,96,132
7451,4208,Lovosice,78,209,81,128
7452,4208,Lovosice,79,181,66,115
7453,4208,Lovosice,80,174,71,103
7454,4208,Lovosice,81,132,47,85
7455,4208,Lovosice,82,127,48,79
7456,4208,Lovosice,83,126,42,84
7457,4208,Lovosice,84,105,44,61
7458,4208,Lovosice,85,97,35,62
7459,4208,Lovosice,86,81,28,53
7460,4208,Lovosice,87,77,21,56
7461,4208,Lovosice,88,58,23,35
7462,4208,Lovosice,89,47,16,31
7463,4208,Lovosice,90,40,9,31
7464,4208,Lovosice,91,28,8,20
7465,4208,Lovosice,92,22,4,18
7466,4208,Lovosice,93,11,2,9
7467,4208,Lovosice,94,13,4,9
7468,4208,Lovosice,95,6,1,5
7469,4208,Lovosice,96,4,0,4
7470,4208,Lovosice,97,3,1,2
7471,4208,Lovosice,98,3,0,3
7472,4208,Lovosice,99,0,0,0
7473,4208,Lovosice,100,5,2,3
7474,4209,Most,0,674,338,336
7475,4209,Most,1,730,389,341
7476,4209,Most,2,724,376,348
7477,4209,Most,3,727,360,367
7478,4209,Most,4,750,396,354
7479,4209,Most,5,755,402,353
7480,4209,Most,6,756,374,382
7481,4209,Most,7,712,363,349
7482,4209,Most,8,766,383,383
7483,4209,Most,9,705,346,359
7484,4209,Most,10,819,417,402
7485,4209,Most,11,889,476,413
7486,4209,Most,12,875,457,418
7487,4209,Most,13,913,471,442
7488,4209,Most,14,873,442,431
7489,4209,Most,15,733,384,349
7490,4209,Most,16,770,406,364
7491,4209,Most,17,710,368,342
7492,4209,Most,18,711,362,349
7493,4209,Most,19,709,360,349
7494,4209,Most,20,717,367,350
7495,4209,Most,21,705,367,338
7496,4209,Most,22,726,385,341
7497,4209,Most,23,729,377,352
7498,4209,Most,24,736,385,351
7499,4209,Most,25,759,390,369
7500,4209,Most,26,922,476,446
7501,4209,Most,27,951,501,450
7502,4209,Most,28,949,489,460
7503,4209,Most,29,993,534,459
7504,4209,Most,30,1000,508,492
7505,4209,Most,31,962,548,414
7506,4209,Most,32,1023,527,496
7507,4209,Most,33,1007,567,440
7508,4209,Most,34,1037,595,442
7509,4209,Most,35,1000,535,465
7510,4209,Most,36,1002,528,474
7511,4209,Most,37,1022,561,461
7512,4209,Most,38,1030,580,450
7513,4209,Most,39,988,565,423
7514,4209,Most,40,1033,516,517
7515,4209,Most,41,1082,544,538
7516,4209,Most,42,1175,622,553
7517,4209,Most,43,1167,611,556
7518,4209,Most,44,1193,614,579
7519,4209,Most,45,1304,658,646
7520,4209,Most,46,1358,677,681
7521,4209,Most,47,1253,643,610
7522,4209,Most,48,1156,571,585
7523,4209,Most,49,1116,539,577
7524,4209,Most,50,1015,524,491
7525,4209,Most,51,1040,531,509
7526,4209,Most,52,974,479,495
7527,4209,Most,53,1069,541,528
7528,4209,Most,54,1047,492,555
7529,4209,Most,55,1094,553,541
7530,4209,Most,56,1164,567,597
7531,4209,Most,57,1127,613,514
7532,4209,Most,58,955,480,475
7533,4209,Most,59,926,487,439
7534,4209,Most,60,882,464,418
7535,4209,Most,61,857,441,416
7536,4209,Most,62,911,442,469
7537,4209,Most,63,902,450,452
7538,4209,Most,64,931,445,486
7539,4209,Most,65,875,417,458
7540,4209,Most,66,909,389,520
7541,4209,Most,67,855,404,451
7542,4209,Most,68,861,368,493
7543,4209,Most,69,894,383,511
7544,4209,Most,70,902,364,538
7545,4209,Most,71,851,380,471
7546,4209,Most,72,883,387,496
7547,4209,Most,73,858,349,509
7548,4209,Most,74,761,303,458
7549,4209,Most,75,556,233,323
7550,4209,Most,76,606,249,357
7551,4209,Most,77,517,196,321
7552,4209,Most,78,471,174,297
7553,4209,Most,79,396,147,249
7554,4209,Most,80,432,139,293
7555,4209,Most,81,349,124,225
7556,4209,Most,82,266,95,171
7557,4209,Most,83,267,109,158
7558,4209,Most,84,203,63,140
7559,4209,Most,85,202,73,129
7560,4209,Most,86,156,41,115
7561,4209,Most,87,120,40,80
7562,4209,Most,88,105,32,73
7563,4209,Most,89,121,35,86
7564,4209,Most,90,91,24,67
7565,4209,Most,91,52,15,37
7566,4209,Most,92,48,15,33
7567,4209,Most,93,27,6,21
7568,4209,Most,94,22,4,18
7569,4209,Most,95,22,4,18
7570,4209,Most,96,16,3,13
7571,4209,Most,97,7,3,4
7572,4209,Most,98,4,1,3
7573,4209,Most,99,3,1,2
7574,4209,Most,100,1,0,1
7575,4210,Podbořany,0,154,76,78
7576,4210,Podbořany,1,149,66,83
7577,4210,Podbořany,2,143,74,69
7578,4210,Podbořany,3,164,92,72
7579,4210,Podbořany,4,156,74,82
7580,4210,Podbořany,5,170,84,86
7581,4210,Podbořany,6,178,84,94
7582,4210,Podbořany,7,161,76,85
7583,4210,Podbořany,8,159,82,77
7584,4210,Podbořany,9,167,84,83
7585,4210,Podbořany,10,179,78,101
7586,4210,Podbořany,11,184,83,101
7587,4210,Podbořany,12,207,108,99
7588,4210,Podbořany,13,199,92,107
7589,4210,Podbořany,14,174,82,92
7590,4210,Podbořany,15,155,82,73
7591,4210,Podbořany,16,141,74,67
7592,4210,Podbořany,17,158,94,64
7593,4210,Podbořany,18,152,82,70
7594,4210,Podbořany,19,148,87,61
7595,4210,Podbořany,20,151,96,55
7596,4210,Podbořany,21,157,92,65
7597,4210,Podbořany,22,143,72,71
7598,4210,Podbořany,23,168,85,83
7599,4210,Podbořany,24,154,82,72
7600,4210,Podbořany,25,191,108,83
7601,4210,Podbořany,26,175,91,84
7602,4210,Podbořany,27,189,100,89
7603,4210,Podbořany,28,175,101,74
7604,4210,Podbořany,29,205,103,102
7605,4210,Podbořany,30,186,101,85
7606,4210,Podbořany,31,152,73,79
7607,4210,Podbořany,32,179,96,83
7608,4210,Podbořany,33,192,100,92
7609,4210,Podbořany,34,195,99,96
7610,4210,Podbořany,35,195,98,97
7611,4210,Podbořany,36,205,103,102
7612,4210,Podbořany,37,201,95,106
7613,4210,Podbořany,38,224,127,97
7614,4210,Podbořany,39,230,123,107
7615,4210,Podbořany,40,197,104,93
7616,4210,Podbořany,41,226,116,110
7617,4210,Podbořany,42,250,134,116
7618,4210,Podbořany,43,257,130,127
7619,4210,Podbořany,44,275,140,135
7620,4210,Podbořany,45,265,130,135
7621,4210,Podbořany,46,277,148,129
7622,4210,Podbořany,47,257,133,124
7623,4210,Podbořany,48,212,99,113
7624,4210,Podbořany,49,221,115,106
7625,4210,Podbořany,50,214,97,117
7626,4210,Podbořany,51,212,102,110
7627,4210,Podbořany,52,212,110,102
7628,4210,Podbořany,53,202,111,91
7629,4210,Podbořany,54,209,105,104
7630,4210,Podbořany,55,213,103,110
7631,4210,Podbořany,56,197,114,83
7632,4210,Podbořany,57,238,124,114
7633,4210,Podbořany,58,193,101,92
7634,4210,Podbořany,59,210,112,98
7635,4210,Podbořany,60,186,95,91
7636,4210,Podbořany,61,181,75,106
7637,4210,Podbořany,62,216,96,120
7638,4210,Podbořany,63,215,107,108
7639,4210,Podbořany,64,197,96,101
7640,4210,Podbořany,65,216,109,107
7641,4210,Podbořany,66,242,115,127
7642,4210,Podbořany,67,220,108,112
7643,4210,Podbořany,68,230,103,127
7644,4210,Podbořany,69,217,111,106
7645,4210,Podbořany,70,200,100,100
7646,4210,Podbořany,71,205,91,114
7647,4210,Podbořany,72,203,91,112
7648,4210,Podbořany,73,178,87,91
7649,4210,Podbořany,74,147,70,77
7650,4210,Podbořany,75,116,40,76
7651,4210,Podbořany,76,124,49,75
7652,4210,Podbořany,77,125,57,68
7653,4210,Podbořany,78,81,27,54
7654,4210,Podbořany,79,86,33,53
7655,4210,Podbořany,80,87,31,56
7656,4210,Podbořany,81,66,27,39
7657,4210,Podbořany,82,66,25,41
7658,4210,Podbořany,83,60,27,33
7659,4210,Podbořany,84,48,19,29
7660,4210,Podbořany,85,55,20,35
7661,4210,Podbořany,86,24,12,12
7662,4210,Podbořany,87,33,10,23
7663,4210,Podbořany,88,39,5,34
7664,4210,Podbořany,89,30,5,25
7665,4210,Podbořany,90,15,4,11
7666,4210,Podbořany,91,12,5,7
7667,4210,Podbořany,92,9,0,9
7668,4210,Podbořany,93,5,1,4
7669,4210,Podbořany,94,6,1,5
7670,4210,Podbořany,95,3,0,3
7671,4210,Podbořany,96,1,0,1
7672,4210,Podbořany,97,1,0,1
7673,4210,Podbořany,98,0,0,0
7674,4210,Podbořany,99,2,1,1
7675,4210,Podbořany,100,0,0,0
7676,4211,Roudnice nad Labem,0,341,170,171
7677,4211,Roudnice nad Labem,1,312,158,154
7678,4211,Roudnice nad Labem,2,337,189,148
7679,4211,Roudnice nad Labem,3,384,193,191
7680,4211,Roudnice nad Labem,4,344,198,146
7681,4211,Roudnice nad Labem,5,398,225,173
7682,4211,Roudnice nad Labem,6,396,203,193
7683,4211,Roudnice nad Labem,7,360,194,166
7684,4211,Roudnice nad Labem,8,360,177,183
7685,4211,Roudnice nad Labem,9,349,184,165
7686,4211,Roudnice nad Labem,10,405,216,189
7687,4211,Roudnice nad Labem,11,412,224,188
7688,4211,Roudnice nad Labem,12,433,213,220
7689,4211,Roudnice nad Labem,13,402,211,191
7690,4211,Roudnice nad Labem,14,335,162,173
7691,4211,Roudnice nad Labem,15,349,175,174
7692,4211,Roudnice nad Labem,16,339,177,162
7693,4211,Roudnice nad Labem,17,298,151,147
7694,4211,Roudnice nad Labem,18,302,148,154
7695,4211,Roudnice nad Labem,19,286,135,151
7696,4211,Roudnice nad Labem,20,302,158,144
7697,4211,Roudnice nad Labem,21,261,147,114
7698,4211,Roudnice nad Labem,22,268,142,126
7699,4211,Roudnice nad Labem,23,281,145,136
7700,4211,Roudnice nad Labem,24,309,161,148
7701,4211,Roudnice nad Labem,25,274,134,140
7702,4211,Roudnice nad Labem,26,361,172,189
7703,4211,Roudnice nad Labem,27,377,208,169
7704,4211,Roudnice nad Labem,28,396,202,194
7705,4211,Roudnice nad Labem,29,409,211,198
7706,4211,Roudnice nad Labem,30,392,201,191
7707,4211,Roudnice nad Labem,31,382,171,211
7708,4211,Roudnice nad Labem,32,397,192,205
7709,4211,Roudnice nad Labem,33,419,230,189
7710,4211,Roudnice nad Labem,34,418,234,184
7711,4211,Roudnice nad Labem,35,405,207,198
7712,4211,Roudnice nad Labem,36,404,205,199
7713,4211,Roudnice nad Labem,37,419,231,188
7714,4211,Roudnice nad Labem,38,457,230,227
7715,4211,Roudnice nad Labem,39,491,252,239
7716,4211,Roudnice nad Labem,40,540,279,261
7717,4211,Roudnice nad Labem,41,612,325,287
7718,4211,Roudnice nad Labem,42,615,322,293
7719,4211,Roudnice nad Labem,43,586,301,285
7720,4211,Roudnice nad Labem,44,603,305,298
7721,4211,Roudnice nad Labem,45,606,337,269
7722,4211,Roudnice nad Labem,46,626,328,298
7723,4211,Roudnice nad Labem,47,546,277,269
7724,4211,Roudnice nad Labem,48,478,247,231
7725,4211,Roudnice nad Labem,49,484,246,238
7726,4211,Roudnice nad Labem,50,431,234,197
7727,4211,Roudnice nad Labem,51,413,209,204
7728,4211,Roudnice nad Labem,52,396,213,183
7729,4211,Roudnice nad Labem,53,399,208,191
7730,4211,Roudnice nad Labem,54,379,193,186
7731,4211,Roudnice nad Labem,55,436,197,239
7732,4211,Roudnice nad Labem,56,401,205,196
7733,4211,Roudnice nad Labem,57,389,202,187
7734,4211,Roudnice nad Labem,58,348,180,168
7735,4211,Roudnice nad Labem,59,371,181,190
7736,4211,Roudnice nad Labem,60,322,170,152
7737,4211,Roudnice nad Labem,61,318,169,149
7738,4211,Roudnice nad Labem,62,396,186,210
7739,4211,Roudnice nad Labem,63,391,196,195
7740,4211,Roudnice nad Labem,64,412,184,228
7741,4211,Roudnice nad Labem,65,472,210,262
7742,4211,Roudnice nad Labem,66,446,206,240
7743,4211,Roudnice nad Labem,67,427,208,219
7744,4211,Roudnice nad Labem,68,451,206,245
7745,4211,Roudnice nad Labem,69,435,216,219
7746,4211,Roudnice nad Labem,70,462,200,262
7747,4211,Roudnice nad Labem,71,396,196,200
7748,4211,Roudnice nad Labem,72,400,164,236
7749,4211,Roudnice nad Labem,73,387,172,215
7750,4211,Roudnice nad Labem,74,407,178,229
7751,4211,Roudnice nad Labem,75,265,115,150
7752,4211,Roudnice nad Labem,76,296,131,165
7753,4211,Roudnice nad Labem,77,254,104,150
7754,4211,Roudnice nad Labem,78,226,94,132
7755,4211,Roudnice nad Labem,79,191,82,109
7756,4211,Roudnice nad Labem,80,178,66,112
7757,4211,Roudnice nad Labem,81,128,50,78
7758,4211,Roudnice nad Labem,82,106,34,72
7759,4211,Roudnice nad Labem,83,129,36,93
7760,4211,Roudnice nad Labem,84,108,42,66
7761,4211,Roudnice nad Labem,85,89,27,62
7762,4211,Roudnice nad Labem,86,94,30,64
7763,4211,Roudnice nad Labem,87,90,36,54
7764,4211,Roudnice nad Labem,88,77,26,51
7765,4211,Roudnice nad Labem,89,49,13,36
7766,4211,Roudnice nad Labem,90,52,16,36
7767,4211,Roudnice nad Labem,91,36,7,29
7768,4211,Roudnice nad Labem,92,28,10,18
7769,4211,Roudnice nad Labem,93,20,5,15
7770,4211,Roudnice nad Labem,94,17,6,11
7771,4211,Roudnice nad Labem,95,10,3,7
7772,4211,Roudnice nad Labem,96,5,2,3
7773,4211,Roudnice nad Labem,97,3,0,3
7774,4211,Roudnice nad Labem,98,6,3,3
7775,4211,Roudnice nad Labem,99,2,0,2
7776,4211,Roudnice nad Labem,100,2,0,2
7777,4212,Rumburk,0,327,156,171
7778,4212,Rumburk,1,312,166,146
7779,4212,Rumburk,2,283,138,145
7780,4212,Rumburk,3,334,157,177
7781,4212,Rumburk,4,325,163,162
7782,4212,Rumburk,5,368,183,185
7783,4212,Rumburk,6,360,212,148
7784,4212,Rumburk,7,341,188,153
7785,4212,Rumburk,8,337,154,183
7786,4212,Rumburk,9,350,179,171
7787,4212,Rumburk,10,391,203,188
7788,4212,Rumburk,11,401,203,198
7789,4212,Rumburk,12,427,228,199
7790,4212,Rumburk,13,435,220,215
7791,4212,Rumburk,14,379,180,199
7792,4212,Rumburk,15,350,175,175
7793,4212,Rumburk,16,348,173,175
7794,4212,Rumburk,17,347,180,167
7795,4212,Rumburk,18,355,197,158
7796,4212,Rumburk,19,319,154,165
7797,4212,Rumburk,20,342,172,170
7798,4212,Rumburk,21,324,178,146
7799,4212,Rumburk,22,353,174,179
7800,4212,Rumburk,23,346,175,171
7801,4212,Rumburk,24,325,159,166
7802,4212,Rumburk,25,345,181,164
7803,4212,Rumburk,26,357,189,168
7804,4212,Rumburk,27,409,214,195
7805,4212,Rumburk,28,388,221,167
7806,4212,Rumburk,29,391,209,182
7807,4212,Rumburk,30,378,185,193
7808,4212,Rumburk,31,370,191,179
7809,4212,Rumburk,32,400,216,184
7810,4212,Rumburk,33,428,231,197
7811,4212,Rumburk,34,393,211,182
7812,4212,Rumburk,35,400,214,186
7813,4212,Rumburk,36,382,204,178
7814,4212,Rumburk,37,416,222,194
7815,4212,Rumburk,38,405,209,196
7816,4212,Rumburk,39,438,221,217
7817,4212,Rumburk,40,436,237,199
7818,4212,Rumburk,41,509,272,237
7819,4212,Rumburk,42,502,249,253
7820,4212,Rumburk,43,505,266,239
7821,4212,Rumburk,44,542,287,255
7822,4212,Rumburk,45,594,311,283
7823,4212,Rumburk,46,578,309,269
7824,4212,Rumburk,47,568,279,289
7825,4212,Rumburk,48,554,285,269
7826,4212,Rumburk,49,528,265,263
7827,4212,Rumburk,50,476,236,240
7828,4212,Rumburk,51,403,206,197
7829,4212,Rumburk,52,412,224,188
7830,4212,Rumburk,53,365,174,191
7831,4212,Rumburk,54,379,197,182
7832,4212,Rumburk,55,409,234,175
7833,4212,Rumburk,56,398,212,186
7834,4212,Rumburk,57,408,209,199
7835,4212,Rumburk,58,366,188,178
7836,4212,Rumburk,59,337,165,172
7837,4212,Rumburk,60,364,179,185
7838,4212,Rumburk,61,344,174,170
7839,4212,Rumburk,62,367,176,191
7840,4212,Rumburk,63,430,193,237
7841,4212,Rumburk,64,424,217,207
7842,4212,Rumburk,65,415,205,210
7843,4212,Rumburk,66,424,194,230
7844,4212,Rumburk,67,440,198,242
7845,4212,Rumburk,68,499,203,296
7846,4212,Rumburk,69,522,215,307
7847,4212,Rumburk,70,435,192,243
7848,4212,Rumburk,71,416,182,234
7849,4212,Rumburk,72,409,191,218
7850,4212,Rumburk,73,441,202,239
7851,4212,Rumburk,74,376,157,219
7852,4212,Rumburk,75,288,131,157
7853,4212,Rumburk,76,260,100,160
7854,4212,Rumburk,77,235,109,126
7855,4212,Rumburk,78,214,92,122
7856,4212,Rumburk,79,181,68,113
7857,4212,Rumburk,80,171,65,106
7858,4212,Rumburk,81,153,61,92
7859,4212,Rumburk,82,114,38,76
7860,4212,Rumburk,83,93,33,60
7861,4212,Rumburk,84,99,39,60
7862,4212,Rumburk,85,85,30,55
7863,4212,Rumburk,86,60,16,44
7864,4212,Rumburk,87,52,12,40
7865,4212,Rumburk,88,64,27,37
7866,4212,Rumburk,89,54,16,38
7867,4212,Rumburk,90,24,8,16
7868,4212,Rumburk,91,35,11,24
7869,4212,Rumburk,92,25,3,22
7870,4212,Rumburk,93,17,1,16
7871,4212,Rumburk,94,15,2,13
7872,4212,Rumburk,95,10,1,9
7873,4212,Rumburk,96,11,1,10
7874,4212,Rumburk,97,3,0,3
7875,4212,Rumburk,98,4,0,4
7876,4212,Rumburk,99,4,0,4
7877,4212,Rumburk,100,4,0,4
7878,4213,Teplice,0,1042,526,516
7879,4213,Teplice,1,1069,532,537
7880,4213,Teplice,2,1069,547,522
7881,4213,Teplice,3,1069,535,534
7882,4213,Teplice,4,1113,560,553
7883,4213,Teplice,5,1048,527,521
7884,4213,Teplice,6,1132,616,516
7885,4213,Teplice,7,1033,496,537
7886,4213,Teplice,8,1075,544,531
7887,4213,Teplice,9,1125,613,512
7888,4213,Teplice,10,1247,664,583
7889,4213,Teplice,11,1199,631,568
7890,4213,Teplice,12,1284,689,595
7891,4213,Teplice,13,1323,695,628
7892,4213,Teplice,14,1174,601,573
7893,4213,Teplice,15,1090,552,538
7894,4213,Teplice,16,1094,560,534
7895,4213,Teplice,17,1031,540,491
7896,4213,Teplice,18,994,523,471
7897,4213,Teplice,19,985,492,493
7898,4213,Teplice,20,982,512,470
7899,4213,Teplice,21,928,455,473
7900,4213,Teplice,22,956,466,490
7901,4213,Teplice,23,974,491,483
7902,4213,Teplice,24,999,502,497
7903,4213,Teplice,25,1077,555,522
7904,4213,Teplice,26,1203,632,571
7905,4213,Teplice,27,1287,672,615
7906,4213,Teplice,28,1284,656,628
7907,4213,Teplice,29,1307,677,630
7908,4213,Teplice,30,1279,646,633
7909,4213,Teplice,31,1293,635,658
7910,4213,Teplice,32,1351,664,687
7911,4213,Teplice,33,1368,690,678
7912,4213,Teplice,34,1434,724,710
7913,4213,Teplice,35,1388,725,663
7914,4213,Teplice,36,1387,718,669
7915,4213,Teplice,37,1355,674,681
7916,4213,Teplice,38,1420,725,695
7917,4213,Teplice,39,1405,734,671
7918,4213,Teplice,40,1415,708,707
7919,4213,Teplice,41,1691,873,818
7920,4213,Teplice,42,1715,872,843
7921,4213,Teplice,43,1799,912,887
7922,4213,Teplice,44,1941,1035,906
7923,4213,Teplice,45,1958,987,971
7924,4213,Teplice,46,2040,1049,991
7925,4213,Teplice,47,1903,972,931
7926,4213,Teplice,48,1824,884,940
7927,4213,Teplice,49,1634,827,807
7928,4213,Teplice,50,1618,802,816
7929,4213,Teplice,51,1520,797,723
7930,4213,Teplice,52,1387,698,689
7931,4213,Teplice,53,1382,673,709
7932,4213,Teplice,54,1403,694,709
7933,4213,Teplice,55,1446,733,713
7934,4213,Teplice,56,1561,790,771
7935,4213,Teplice,57,1505,761,744
7936,4213,Teplice,58,1153,586,567
7937,4213,Teplice,59,1140,565,575
7938,4213,Teplice,60,1136,571,565
7939,4213,Teplice,61,1144,576,568
7940,4213,Teplice,62,1192,576,616
7941,4213,Teplice,63,1282,602,680
7942,4213,Teplice,64,1315,623,692
7943,4213,Teplice,65,1267,608,659
7944,4213,Teplice,66,1345,624,721
7945,4213,Teplice,67,1288,610,678
7946,4213,Teplice,68,1358,591,767
7947,4213,Teplice,69,1414,611,803
7948,4213,Teplice,70,1395,622,773
7949,4213,Teplice,71,1371,598,773
7950,4213,Teplice,72,1362,595,767
7951,4213,Teplice,73,1403,583,820
7952,4213,Teplice,74,1192,515,677
7953,4213,Teplice,75,883,373,510
7954,4213,Teplice,76,963,392,571
7955,4213,Teplice,77,815,332,483
7956,4213,Teplice,78,732,293,439
7957,4213,Teplice,79,699,272,427
7958,4213,Teplice,80,620,240,380
7959,4213,Teplice,81,584,192,392
7960,4213,Teplice,82,414,144,270
7961,4213,Teplice,83,370,129,241
7962,4213,Teplice,84,286,106,180
7963,4213,Teplice,85,293,111,182
7964,4213,Teplice,86,219,72,147
7965,4213,Teplice,87,225,66,159
7966,4213,Teplice,88,196,59,137
7967,4213,Teplice,89,159,57,102
7968,4213,Teplice,90,141,35,106
7969,4213,Teplice,91,101,31,70
7970,4213,Teplice,92,90,26,64
7971,4213,Teplice,93,62,18,44
7972,4213,Teplice,94,27,6,21
7973,4213,Teplice,95,20,2,18
7974,4213,Teplice,96,17,2,15
7975,4213,Teplice,97,16,4,12
7976,4213,Teplice,98,8,3,5
7977,4213,Teplice,99,4,1,3
7978,4213,Teplice,100,6,4,2
7979,4214,Ústí nad Labem,0,1219,645,574
7980,4214,Ústí nad Labem,1,1194,589,605
7981,4214,Ústí nad Labem,2,1285,625,660
7982,4214,Ústí nad Labem,3,1247,641,606
7983,4214,Ústí nad Labem,4,1280,673,607
7984,4214,Ústí nad Labem,5,1258,615,643
7985,4214,Ústí nad Labem,6,1250,655,595
7986,4214,Ústí nad Labem,7,1224,620,604
7987,4214,Ústí nad Labem,8,1214,666,548
7988,4214,Ústí nad Labem,9,1242,649,593
7989,4214,Ústí nad Labem,10,1379,703,676
7990,4214,Ústí nad Labem,11,1431,721,710
7991,4214,Ústí nad Labem,12,1501,767,734
7992,4214,Ústí nad Labem,13,1442,729,713
7993,4214,Ústí nad Labem,14,1318,674,644
7994,4214,Ústí nad Labem,15,1266,654,612
7995,4214,Ústí nad Labem,16,1228,619,609
7996,4214,Ústí nad Labem,17,1268,629,639
7997,4214,Ústí nad Labem,18,1204,642,562
7998,4214,Ústí nad Labem,19,1166,596,570
7999,4214,Ústí nad Labem,20,1189,622,567
8000,4214,Ústí nad Labem,21,1108,557,551
8001,4214,Ústí nad Labem,22,1067,534,533
8002,4214,Ústí nad Labem,23,1105,562,543
8003,4214,Ústí nad Labem,24,1135,584,551
8004,4214,Ústí nad Labem,25,1152,563,589
8005,4214,Ústí nad Labem,26,1355,674,681
8006,4214,Ústí nad Labem,27,1492,804,688
8007,4214,Ústí nad Labem,28,1424,744,680
8008,4214,Ústí nad Labem,29,1567,793,774
8009,4214,Ústí nad Labem,30,1547,807,740
8010,4214,Ústí nad Labem,31,1475,771,704
8011,4214,Ústí nad Labem,32,1507,781,726
8012,4214,Ústí nad Labem,33,1476,783,693
8013,4214,Ústí nad Labem,34,1464,745,719
8014,4214,Ústí nad Labem,35,1492,777,715
8015,4214,Ústí nad Labem,36,1494,788,706
8016,4214,Ústí nad Labem,37,1494,726,768
8017,4214,Ústí nad Labem,38,1602,800,802
8018,4214,Ústí nad Labem,39,1560,802,758
8019,4214,Ústí nad Labem,40,1672,864,808
8020,4214,Ústí nad Labem,41,1937,993,944
8021,4214,Ústí nad Labem,42,1976,987,989
8022,4214,Ústí nad Labem,43,1930,1039,891
8023,4214,Ústí nad Labem,44,2130,1084,1046
8024,4214,Ústí nad Labem,45,2106,1059,1047
8025,4214,Ústí nad Labem,46,2284,1173,1111
8026,4214,Ústí nad Labem,47,2167,1104,1063
8027,4214,Ústí nad Labem,48,1902,948,954
8028,4214,Ústí nad Labem,49,1807,908,899
8029,4214,Ústí nad Labem,50,1736,915,821
8030,4214,Ústí nad Labem,51,1583,818,765
8031,4214,Ústí nad Labem,52,1489,750,739
8032,4214,Ústí nad Labem,53,1435,690,745
8033,4214,Ústí nad Labem,54,1531,785,746
8034,4214,Ústí nad Labem,55,1567,790,777
8035,4214,Ústí nad Labem,56,1594,831,763
8036,4214,Ústí nad Labem,57,1580,769,811
8037,4214,Ústí nad Labem,58,1328,674,654
8038,4214,Ústí nad Labem,59,1173,582,591
8039,4214,Ústí nad Labem,60,1188,596,592
8040,4214,Ústí nad Labem,61,1183,591,592
8041,4214,Ústí nad Labem,62,1282,605,677
8042,4214,Ústí nad Labem,63,1325,606,719
8043,4214,Ústí nad Labem,64,1396,632,764
8044,4214,Ústí nad Labem,65,1384,654,730
8045,4214,Ústí nad Labem,66,1465,677,788
8046,4214,Ústí nad Labem,67,1418,648,770
8047,4214,Ústí nad Labem,68,1523,694,829
8048,4214,Ústí nad Labem,69,1521,654,867
8049,4214,Ústí nad Labem,70,1552,699,853
8050,4214,Ústí nad Labem,71,1551,661,890
8051,4214,Ústí nad Labem,72,1532,679,853
8052,4214,Ústí nad Labem,73,1669,770,899
8053,4214,Ústí nad Labem,74,1410,573,837
8054,4214,Ústí nad Labem,75,933,401,532
8055,4214,Ústí nad Labem,76,1012,392,620
8056,4214,Ústí nad Labem,77,944,351,593
8057,4214,Ústí nad Labem,78,809,328,481
8058,4214,Ústí nad Labem,79,737,316,421
8059,4214,Ústí nad Labem,80,668,262,406
8060,4214,Ústí nad Labem,81,575,219,356
8061,4214,Ústí nad Labem,82,499,180,319
8062,4214,Ústí nad Labem,83,394,150,244
8063,4214,Ústí nad Labem,84,412,132,280
8064,4214,Ústí nad Labem,85,357,133,224
8065,4214,Ústí nad Labem,86,315,96,219
8066,4214,Ústí nad Labem,87,271,94,177
8067,4214,Ústí nad Labem,88,247,73,174
8068,4214,Ústí nad Labem,89,193,49,144
8069,4214,Ústí nad Labem,90,141,39,102
8070,4214,Ústí nad Labem,91,117,27,90
8071,4214,Ústí nad Labem,92,111,36,75
8072,4214,Ústí nad Labem,93,74,17,57
8073,4214,Ústí nad Labem,94,68,15,53
8074,4214,Ústí nad Labem,95,41,11,30
8075,4214,Ústí nad Labem,96,31,7,24
8076,4214,Ústí nad Labem,97,22,2,20
8077,4214,Ústí nad Labem,98,13,1,12
8078,4214,Ústí nad Labem,99,13,4,9
8079,4214,Ústí nad Labem,100,7,3,4
8080,4215,Varnsdorf,0,178,84,94
8081,4215,Varnsdorf,1,186,96,90
8082,4215,Varnsdorf,2,194,99,95
8083,4215,Varnsdorf,3,211,110,101
8084,4215,Varnsdorf,4,210,110,100
8085,4215,Varnsdorf,5,202,104,98
8086,4215,Varnsdorf,6,209,106,103
8087,4215,Varnsdorf,7,190,98,92
8088,4215,Varnsdorf,8,196,99,97
8089,4215,Varnsdorf,9,219,126,93
8090,4215,Varnsdorf,10,224,120,104
8091,4215,Varnsdorf,11,252,119,133
8092,4215,Varnsdorf,12,224,103,121
8093,4215,Varnsdorf,13,263,137,126
8094,4215,Varnsdorf,14,223,118,105
8095,4215,Varnsdorf,15,219,101,118
8096,4215,Varnsdorf,16,200,107,93
8097,4215,Varnsdorf,17,193,98,95
8098,4215,Varnsdorf,18,199,109,90
8099,4215,Varnsdorf,19,223,123,100
8100,4215,Varnsdorf,20,178,90,88
8101,4215,Varnsdorf,21,180,79,101
8102,4215,Varnsdorf,22,197,100,97
8103,4215,Varnsdorf,23,230,115,115
8104,4215,Varnsdorf,24,190,98,92
8105,4215,Varnsdorf,25,199,105,94
8106,4215,Varnsdorf,26,235,119,116
8107,4215,Varnsdorf,27,262,137,125
8108,4215,Varnsdorf,28,206,116,90
8109,4215,Varnsdorf,29,210,103,107
8110,4215,Varnsdorf,30,249,127,122
8111,4215,Varnsdorf,31,226,131,95
8112,4215,Varnsdorf,32,252,136,116
8113,4215,Varnsdorf,33,223,121,102
8114,4215,Varnsdorf,34,219,120,99
8115,4215,Varnsdorf,35,237,118,119
8116,4215,Varnsdorf,36,211,104,107
8117,4215,Varnsdorf,37,226,118,108
8118,4215,Varnsdorf,38,235,118,117
8119,4215,Varnsdorf,39,247,111,136
8120,4215,Varnsdorf,40,266,140,126
8121,4215,Varnsdorf,41,273,143,130
8122,4215,Varnsdorf,42,315,165,150
8123,4215,Varnsdorf,43,332,166,166
8124,4215,Varnsdorf,44,324,166,158
8125,4215,Varnsdorf,45,358,184,174
8126,4215,Varnsdorf,46,370,190,180
8127,4215,Varnsdorf,47,385,199,186
8128,4215,Varnsdorf,48,298,149,149
8129,4215,Varnsdorf,49,286,154,132
8130,4215,Varnsdorf,50,256,135,121
8131,4215,Varnsdorf,51,267,142,125
8132,4215,Varnsdorf,52,258,127,131
8133,4215,Varnsdorf,53,256,133,123
8134,4215,Varnsdorf,54,241,105,136
8135,4215,Varnsdorf,55,265,135,130
8136,4215,Varnsdorf,56,293,138,155
8137,4215,Varnsdorf,57,233,112,121
8138,4215,Varnsdorf,58,214,96,118
8139,4215,Varnsdorf,59,229,134,95
8140,4215,Varnsdorf,60,205,101,104
8141,4215,Varnsdorf,61,206,99,107
8142,4215,Varnsdorf,62,223,107,116
8143,4215,Varnsdorf,63,234,108,126
8144,4215,Varnsdorf,64,258,111,147
8145,4215,Varnsdorf,65,293,152,141
8146,4215,Varnsdorf,66,319,134,185
8147,4215,Varnsdorf,67,288,145,143
8148,4215,Varnsdorf,68,314,149,165
8149,4215,Varnsdorf,69,291,122,169
8150,4215,Varnsdorf,70,289,128,161
8151,4215,Varnsdorf,71,302,137,165
8152,4215,Varnsdorf,72,272,131,141
8153,4215,Varnsdorf,73,295,122,173
8154,4215,Varnsdorf,74,216,100,116
8155,4215,Varnsdorf,75,145,68,77
8156,4215,Varnsdorf,76,158,62,96
8157,4215,Varnsdorf,77,146,57,89
8158,4215,Varnsdorf,78,122,45,77
8159,4215,Varnsdorf,79,101,43,58
8160,4215,Varnsdorf,80,108,40,68
8161,4215,Varnsdorf,81,116,43,73
8162,4215,Varnsdorf,82,74,22,52
8163,4215,Varnsdorf,83,74,37,37
8164,4215,Varnsdorf,84,50,13,37
8165,4215,Varnsdorf,85,55,20,35
8166,4215,Varnsdorf,86,56,21,35
8167,4215,Varnsdorf,87,50,10,40
8168,4215,Varnsdorf,88,47,20,27
8169,4215,Varnsdorf,89,31,9,22
8170,4215,Varnsdorf,90,27,5,22
8171,4215,Varnsdorf,91,24,7,17
8172,4215,Varnsdorf,92,13,5,8
8173,4215,Varnsdorf,93,13,4,9
8174,4215,Varnsdorf,94,11,2,9
8175,4215,Varnsdorf,95,5,1,4
8176,4215,Varnsdorf,96,5,2,3
8177,4215,Varnsdorf,97,4,1,3
8178,4215,Varnsdorf,98,2,0,2
8179,4215,Varnsdorf,99,1,0,1
8180,4215,Varnsdorf,100,0,0,0
8181,4216,Žatec,0,284,145,139
8182,4216,Žatec,1,260,130,130
8183,4216,Žatec,2,295,136,159
8184,4216,Žatec,3,283,142,141
8185,4216,Žatec,4,286,140,146
8186,4216,Žatec,5,279,154,125
8187,4216,Žatec,6,280,124,156
8188,4216,Žatec,7,291,147,144
8189,4216,Žatec,8,260,137,123
8190,4216,Žatec,9,320,159,161
8191,4216,Žatec,10,326,154,172
8192,4216,Žatec,11,351,187,164
8193,4216,Žatec,12,309,158,151
8194,4216,Žatec,13,329,171,158
8195,4216,Žatec,14,285,143,142
8196,4216,Žatec,15,309,159,150
8197,4216,Žatec,16,289,137,152
8198,4216,Žatec,17,306,160,146
8199,4216,Žatec,18,268,118,150
8200,4216,Žatec,19,254,131,123
8201,4216,Žatec,20,264,145,119
8202,4216,Žatec,21,258,129,129
8203,4216,Žatec,22,273,153,120
8204,4216,Žatec,23,301,140,161
8205,4216,Žatec,24,259,125,134
8206,4216,Žatec,25,281,143,138
8207,4216,Žatec,26,306,161,145
8208,4216,Žatec,27,361,179,182
8209,4216,Žatec,28,325,167,158
8210,4216,Žatec,29,352,192,160
8211,4216,Žatec,30,350,163,187
8212,4216,Žatec,31,365,191,174
8213,4216,Žatec,32,364,198,166
8214,4216,Žatec,33,333,176,157
8215,4216,Žatec,34,361,188,173
8216,4216,Žatec,35,403,210,193
8217,4216,Žatec,36,341,175,166
8218,4216,Žatec,37,358,191,167
8219,4216,Žatec,38,370,177,193
8220,4216,Žatec,39,357,204,153
8221,4216,Žatec,40,363,185,178
8222,4216,Žatec,41,414,214,200
8223,4216,Žatec,42,492,251,241
8224,4216,Žatec,43,437,244,193
8225,4216,Žatec,44,460,233,227
8226,4216,Žatec,45,495,249,246
8227,4216,Žatec,46,503,255,248
8228,4216,Žatec,47,475,253,222
8229,4216,Žatec,48,450,238,212
8230,4216,Žatec,49,385,184,201
8231,4216,Žatec,50,347,180,167
8232,4216,Žatec,51,368,195,173
8233,4216,Žatec,52,352,183,169
8234,4216,Žatec,53,345,163,182
8235,4216,Žatec,54,326,165,161
8236,4216,Žatec,55,335,187,148
8237,4216,Žatec,56,353,169,184
8238,4216,Žatec,57,337,191,146
8239,4216,Žatec,58,351,170,181
8240,4216,Žatec,59,318,151,167
8241,4216,Žatec,60,277,152,125
8242,4216,Žatec,61,307,156,151
8243,4216,Žatec,62,326,146,180
8244,4216,Žatec,63,329,138,191
8245,4216,Žatec,64,386,175,211
8246,4216,Žatec,65,376,183,193
8247,4216,Žatec,66,318,145,173
8248,4216,Žatec,67,370,183,187
8249,4216,Žatec,68,358,179,179
8250,4216,Žatec,69,371,162,209
8251,4216,Žatec,70,371,179,192
8252,4216,Žatec,71,293,135,158
8253,4216,Žatec,72,348,163,185
8254,4216,Žatec,73,328,146,182
8255,4216,Žatec,74,306,125,181
8256,4216,Žatec,75,183,82,101
8257,4216,Žatec,76,206,98,108
8258,4216,Žatec,77,191,75,116
8259,4216,Žatec,78,160,60,100
8260,4216,Žatec,79,157,70,87
8261,4216,Žatec,80,129,51,78
8262,4216,Žatec,81,109,33,76
8263,4216,Žatec,82,122,42,80
8264,4216,Žatec,83,89,19,70
8265,4216,Žatec,84,81,20,61
8266,4216,Žatec,85,63,29,34
8267,4216,Žatec,86,73,27,46
8268,4216,Žatec,87,59,19,40
8269,4216,Žatec,88,43,15,28
8270,4216,Žatec,89,37,10,27
8271,4216,Žatec,90,32,9,23
8272,4216,Žatec,91,33,3,30
8273,4216,Žatec,92,19,4,15
8274,4216,Žatec,93,13,4,9
8275,4216,Žatec,94,10,2,8
8276,4216,Žatec,95,8,2,6
8277,4216,Žatec,96,5,1,4
8278,4216,Žatec,97,5,1,4
8279,4216,Žatec,98,2,1,1
8280,4216,Žatec,99,2,0,2
8281,4216,Žatec,100,1,0,1
8282,5101,Česká Lípa,0,824,432,392
8283,5101,Česká Lípa,1,765,387,378
8284,5101,Česká Lípa,2,810,425,385
8285,5101,Česká Lípa,3,777,399,378
8286,5101,Česká Lípa,4,838,418,420
8287,5101,Česká Lípa,5,794,384,410
8288,5101,Česká Lípa,6,828,413,415
8289,5101,Česká Lípa,7,849,439,410
8290,5101,Česká Lípa,8,804,423,381
8291,5101,Česká Lípa,9,859,443,416
8292,5101,Česká Lípa,10,915,476,439
8293,5101,Česká Lípa,11,919,454,465
8294,5101,Česká Lípa,12,1020,523,497
8295,5101,Česká Lípa,13,951,466,485
8296,5101,Česká Lípa,14,769,386,383
8297,5101,Česká Lípa,15,737,376,361
8298,5101,Česká Lípa,16,792,425,367
8299,5101,Česká Lípa,17,737,381,356
8300,5101,Česká Lípa,18,753,361,392
8301,5101,Česká Lípa,19,674,329,345
8302,5101,Česká Lípa,20,778,413,365
8303,5101,Česká Lípa,21,730,372,358
8304,5101,Česká Lípa,22,745,372,373
8305,5101,Česká Lípa,23,785,414,371
8306,5101,Česká Lípa,24,783,414,369
8307,5101,Česká Lípa,25,820,452,368
8308,5101,Česká Lípa,26,856,442,414
8309,5101,Česká Lípa,27,1010,542,468
8310,5101,Česká Lípa,28,986,555,431
8311,5101,Česká Lípa,29,964,496,468
8312,5101,Česká Lípa,30,1049,535,514
8313,5101,Česká Lípa,31,981,502,479
8314,5101,Česká Lípa,32,1080,557,523
8315,5101,Česká Lípa,33,1052,547,505
8316,5101,Česká Lípa,34,1006,537,469
8317,5101,Česká Lípa,35,999,528,471
8318,5101,Česká Lípa,36,1130,575,555
8319,5101,Česká Lípa,37,1099,580,519
8320,5101,Česká Lípa,38,1083,576,507
8321,5101,Česká Lípa,39,1081,557,524
8322,5101,Česká Lípa,40,1210,606,604
8323,5101,Česká Lípa,41,1284,667,617
8324,5101,Česká Lípa,42,1335,739,596
8325,5101,Česká Lípa,43,1283,653,630
8326,5101,Česká Lípa,44,1423,742,681
8327,5101,Česká Lípa,45,1333,699,634
8328,5101,Česká Lípa,46,1350,702,648
8329,5101,Česká Lípa,47,1331,685,646
8330,5101,Česká Lípa,48,1126,588,538
8331,5101,Česká Lípa,49,1034,498,536
8332,5101,Česká Lípa,50,1029,523,506
8333,5101,Česká Lípa,51,1032,504,528
8334,5101,Česká Lípa,52,951,470,481
8335,5101,Česká Lípa,53,955,453,502
8336,5101,Česká Lípa,54,890,416,474
8337,5101,Česká Lípa,55,990,478,512
8338,5101,Česká Lípa,56,1059,515,544
8339,5101,Česká Lípa,57,1010,498,512
8340,5101,Česká Lípa,58,891,430,461
8341,5101,Česká Lípa,59,894,425,469
8342,5101,Česká Lípa,60,894,458,436
8343,5101,Česká Lípa,61,823,418,405
8344,5101,Česká Lípa,62,889,403,486
8345,5101,Česká Lípa,63,957,470,487
8346,5101,Česká Lípa,64,1019,480,539
8347,5101,Česká Lípa,65,1013,480,533
8348,5101,Česká Lípa,66,944,438,506
8349,5101,Česká Lípa,67,960,418,542
8350,5101,Česká Lípa,68,954,447,507
8351,5101,Česká Lípa,69,929,421,508
8352,5101,Česká Lípa,70,954,447,507
8353,5101,Česká Lípa,71,993,447,546
8354,5101,Česká Lípa,72,959,439,520
8355,5101,Česká Lípa,73,911,390,521
8356,5101,Česká Lípa,74,806,344,462
8357,5101,Česká Lípa,75,599,264,335
8358,5101,Česká Lípa,76,526,214,312
8359,5101,Česká Lípa,77,513,197,316
8360,5101,Česká Lípa,78,432,187,245
8361,5101,Česká Lípa,79,393,144,249
8362,5101,Česká Lípa,80,369,158,211
8363,5101,Česká Lípa,81,296,113,183
8364,5101,Česká Lípa,82,270,96,174
8365,5101,Česká Lípa,83,241,74,167
8366,5101,Česká Lípa,84,221,77,144
8367,5101,Česká Lípa,85,178,61,117
8368,5101,Česká Lípa,86,161,49,112
8369,5101,Česká Lípa,87,157,48,109
8370,5101,Česká Lípa,88,127,39,88
8371,5101,Česká Lípa,89,90,30,60
8372,5101,Česká Lípa,90,83,28,55
8373,5101,Česká Lípa,91,55,10,45
8374,5101,Česká Lípa,92,40,4,36
8375,5101,Česká Lípa,93,30,8,22
8376,5101,Česká Lípa,94,26,7,19
8377,5101,Česká Lípa,95,12,2,10
8378,5101,Česká Lípa,96,15,2,13
8379,5101,Česká Lípa,97,9,2,7
8380,5101,Česká Lípa,98,7,1,6
8381,5101,Česká Lípa,99,2,0,2
8382,5101,Česká Lípa,100,5,1,4
8383,5102,Frýdlant,0,260,123,137
8384,5102,Frýdlant,1,223,104,119
8385,5102,Frýdlant,2,253,136,117
8386,5102,Frýdlant,3,279,150,129
8387,5102,Frýdlant,4,268,144,124
8388,5102,Frýdlant,5,252,130,122
8389,5102,Frýdlant,6,263,141,122
8390,5102,Frýdlant,7,239,120,119
8391,5102,Frýdlant,8,273,140,133
8392,5102,Frýdlant,9,268,121,147
8393,5102,Frýdlant,10,256,126,130
8394,5102,Frýdlant,11,330,170,160
8395,5102,Frýdlant,12,278,137,141
8396,5102,Frýdlant,13,311,166,145
8397,5102,Frýdlant,14,257,117,140
8398,5102,Frýdlant,15,249,107,142
8399,5102,Frýdlant,16,248,110,138
8400,5102,Frýdlant,17,249,139,110
8401,5102,Frýdlant,18,223,108,115
8402,5102,Frýdlant,19,253,125,128
8403,5102,Frýdlant,20,259,147,112
8404,5102,Frýdlant,21,260,137,123
8405,5102,Frýdlant,22,254,136,118
8406,5102,Frýdlant,23,251,126,125
8407,5102,Frýdlant,24,281,148,133
8408,5102,Frýdlant,25,234,115,119
8409,5102,Frýdlant,26,281,142,139
8410,5102,Frýdlant,27,340,171,169
8411,5102,Frýdlant,28,333,170,163
8412,5102,Frýdlant,29,303,149,154
8413,5102,Frýdlant,30,325,178,147
8414,5102,Frýdlant,31,281,139,142
8415,5102,Frýdlant,32,286,154,132
8416,5102,Frýdlant,33,301,155,146
8417,5102,Frýdlant,34,275,137,138
8418,5102,Frýdlant,35,306,169,137
8419,5102,Frýdlant,36,255,129,126
8420,5102,Frýdlant,37,323,149,174
8421,5102,Frýdlant,38,326,171,155
8422,5102,Frýdlant,39,316,168,148
8423,5102,Frýdlant,40,317,167,150
8424,5102,Frýdlant,41,345,192,153
8425,5102,Frýdlant,42,392,207,185
8426,5102,Frýdlant,43,427,236,191
8427,5102,Frýdlant,44,430,230,200
8428,5102,Frýdlant,45,443,232,211
8429,5102,Frýdlant,46,448,248,200
8430,5102,Frýdlant,47,432,230,202
8431,5102,Frýdlant,48,398,200,198
8432,5102,Frýdlant,49,415,204,211
8433,5102,Frýdlant,50,325,170,155
8434,5102,Frýdlant,51,326,179,147
8435,5102,Frýdlant,52,284,157,127
8436,5102,Frýdlant,53,304,166,138
8437,5102,Frýdlant,54,316,152,164
8438,5102,Frýdlant,55,322,175,147
8439,5102,Frýdlant,56,322,166,156
8440,5102,Frýdlant,57,298,144,154
8441,5102,Frýdlant,58,268,137,131
8442,5102,Frýdlant,59,247,115,132
8443,5102,Frýdlant,60,272,129,143
8444,5102,Frýdlant,61,264,127,137
8445,5102,Frýdlant,62,279,140,139
8446,5102,Frýdlant,63,310,150,160
8447,5102,Frýdlant,64,287,134,153
8448,5102,Frýdlant,65,292,149,143
8449,5102,Frýdlant,66,340,162,178
8450,5102,Frýdlant,67,317,145,172
8451,5102,Frýdlant,68,377,171,206
8452,5102,Frýdlant,69,341,158,183
8453,5102,Frýdlant,70,358,162,196
8454,5102,Frýdlant,71,321,155,166
8455,5102,Frýdlant,72,352,160,192
8456,5102,Frýdlant,73,333,147,186
8457,5102,Frýdlant,74,288,136,152
8458,5102,Frýdlant,75,224,90,134
8459,5102,Frýdlant,76,200,95,105
8460,5102,Frýdlant,77,170,88,82
8461,5102,Frýdlant,78,174,62,112
8462,5102,Frýdlant,79,126,58,68
8463,5102,Frýdlant,80,137,51,86
8464,5102,Frýdlant,81,98,25,73
8465,5102,Frýdlant,82,96,39,57
8466,5102,Frýdlant,83,85,34,51
8467,5102,Frýdlant,84,63,31,32
8468,5102,Frýdlant,85,54,18,36
8469,5102,Frýdlant,86,45,15,30
8470,5102,Frýdlant,87,47,10,37
8471,5102,Frýdlant,88,37,9,28
8472,5102,Frýdlant,89,30,8,22
8473,5102,Frýdlant,90,27,11,16
8474,5102,Frýdlant,91,24,7,17
8475,5102,Frýdlant,92,20,4,16
8476,5102,Frýdlant,93,10,1,9
8477,5102,Frýdlant,94,11,2,9
8478,5102,Frýdlant,95,7,2,5
8479,5102,Frýdlant,96,7,2,5
8480,5102,Frýdlant,97,3,2,1
8481,5102,Frýdlant,98,1,0,1
8482,5102,Frýdlant,99,2,1,1
8483,5102,Frýdlant,100,0,0,0
8484,5103,Jablonec nad Nisou,0,576,294,282
8485,5103,Jablonec nad Nisou,1,651,326,325
8486,5103,Jablonec nad Nisou,2,612,322,290
8487,5103,Jablonec nad Nisou,3,621,323,298
8488,5103,Jablonec nad Nisou,4,656,339,317
8489,5103,Jablonec nad Nisou,5,585,325,260
8490,5103,Jablonec nad Nisou,6,597,308,289
8491,5103,Jablonec nad Nisou,7,623,331,292
8492,5103,Jablonec nad Nisou,8,591,306,285
8493,5103,Jablonec nad Nisou,9,619,312,307
8494,5103,Jablonec nad Nisou,10,657,351,306
8495,5103,Jablonec nad Nisou,11,695,367,328
8496,5103,Jablonec nad Nisou,12,664,361,303
8497,5103,Jablonec nad Nisou,13,652,343,309
8498,5103,Jablonec nad Nisou,14,579,286,293
8499,5103,Jablonec nad Nisou,15,523,267,256
8500,5103,Jablonec nad Nisou,16,568,296,272
8501,5103,Jablonec nad Nisou,17,538,286,252
8502,5103,Jablonec nad Nisou,18,513,276,237
8503,5103,Jablonec nad Nisou,19,514,266,248
8504,5103,Jablonec nad Nisou,20,488,234,254
8505,5103,Jablonec nad Nisou,21,496,259,237
8506,5103,Jablonec nad Nisou,22,508,245,263
8507,5103,Jablonec nad Nisou,23,487,240,247
8508,5103,Jablonec nad Nisou,24,506,271,235
8509,5103,Jablonec nad Nisou,25,493,246,247
8510,5103,Jablonec nad Nisou,26,608,308,300
8511,5103,Jablonec nad Nisou,27,624,324,300
8512,5103,Jablonec nad Nisou,28,697,355,342
8513,5103,Jablonec nad Nisou,29,713,359,354
8514,5103,Jablonec nad Nisou,30,713,368,345
8515,5103,Jablonec nad Nisou,31,694,372,322
8516,5103,Jablonec nad Nisou,32,714,361,353
8517,5103,Jablonec nad Nisou,33,706,360,346
8518,5103,Jablonec nad Nisou,34,707,351,356
8519,5103,Jablonec nad Nisou,35,731,371,360
8520,5103,Jablonec nad Nisou,36,749,354,395
8521,5103,Jablonec nad Nisou,37,766,388,378
8522,5103,Jablonec nad Nisou,38,779,398,381
8523,5103,Jablonec nad Nisou,39,796,396,400
8524,5103,Jablonec nad Nisou,40,868,487,381
8525,5103,Jablonec nad Nisou,41,950,484,466
8526,5103,Jablonec nad Nisou,42,910,436,474
8527,5103,Jablonec nad Nisou,43,926,467,459
8528,5103,Jablonec nad Nisou,44,1002,523,479
8529,5103,Jablonec nad Nisou,45,961,475,486
8530,5103,Jablonec nad Nisou,46,1010,488,522
8531,5103,Jablonec nad Nisou,47,969,493,476
8532,5103,Jablonec nad Nisou,48,819,392,427
8533,5103,Jablonec nad Nisou,49,812,415,397
8534,5103,Jablonec nad Nisou,50,800,388,412
8535,5103,Jablonec nad Nisou,51,680,339,341
8536,5103,Jablonec nad Nisou,52,722,340,382
8537,5103,Jablonec nad Nisou,53,701,334,367
8538,5103,Jablonec nad Nisou,54,698,363,335
8539,5103,Jablonec nad Nisou,55,714,359,355
8540,5103,Jablonec nad Nisou,56,715,330,385
8541,5103,Jablonec nad Nisou,57,693,337,356
8542,5103,Jablonec nad Nisou,58,628,305,323
8543,5103,Jablonec nad Nisou,59,599,280,319
8544,5103,Jablonec nad Nisou,60,571,269,302
8545,5103,Jablonec nad Nisou,61,551,253,298
8546,5103,Jablonec nad Nisou,62,588,267,321
8547,5103,Jablonec nad Nisou,63,642,307,335
8548,5103,Jablonec nad Nisou,64,693,326,367
8549,5103,Jablonec nad Nisou,65,657,302,355
8550,5103,Jablonec nad Nisou,66,664,299,365
8551,5103,Jablonec nad Nisou,67,761,365,396
8552,5103,Jablonec nad Nisou,68,736,337,399
8553,5103,Jablonec nad Nisou,69,769,323,446
8554,5103,Jablonec nad Nisou,70,731,329,402
8555,5103,Jablonec nad Nisou,71,683,295,388
8556,5103,Jablonec nad Nisou,72,711,316,395
8557,5103,Jablonec nad Nisou,73,767,321,446
8558,5103,Jablonec nad Nisou,74,659,293,366
8559,5103,Jablonec nad Nisou,75,501,211,290
8560,5103,Jablonec nad Nisou,76,466,202,264
8561,5103,Jablonec nad Nisou,77,467,195,272
8562,5103,Jablonec nad Nisou,78,410,166,244
8563,5103,Jablonec nad Nisou,79,364,132,232
8564,5103,Jablonec nad Nisou,80,292,113,179
8565,5103,Jablonec nad Nisou,81,296,114,182
8566,5103,Jablonec nad Nisou,82,229,93,136
8567,5103,Jablonec nad Nisou,83,226,76,150
8568,5103,Jablonec nad Nisou,84,179,70,109
8569,5103,Jablonec nad Nisou,85,151,50,101
8570,5103,Jablonec nad Nisou,86,154,59,95
8571,5103,Jablonec nad Nisou,87,146,40,106
8572,5103,Jablonec nad Nisou,88,125,46,79
8573,5103,Jablonec nad Nisou,89,102,33,69
8574,5103,Jablonec nad Nisou,90,75,22,53
8575,5103,Jablonec nad Nisou,91,72,19,53
8576,5103,Jablonec nad Nisou,92,58,9,49
8577,5103,Jablonec nad Nisou,93,36,5,31
8578,5103,Jablonec nad Nisou,94,28,8,20
8579,5103,Jablonec nad Nisou,95,24,7,17
8580,5103,Jablonec nad Nisou,96,14,1,13
8581,5103,Jablonec nad Nisou,97,14,4,10
8582,5103,Jablonec nad Nisou,98,5,1,4
8583,5103,Jablonec nad Nisou,99,4,0,4
8584,5103,Jablonec nad Nisou,100,5,0,5
8585,5104,Jilemnice,0,189,99,90
8586,5104,Jilemnice,1,215,102,113
8587,5104,Jilemnice,2,238,105,133
8588,5104,Jilemnice,3,214,115,99
8589,5104,Jilemnice,4,200,110,90
8590,5104,Jilemnice,5,228,126,102
8591,5104,Jilemnice,6,193,94,99
8592,5104,Jilemnice,7,197,102,95
8593,5104,Jilemnice,8,227,124,103
8594,5104,Jilemnice,9,232,112,120
8595,5104,Jilemnice,10,240,130,110
8596,5104,Jilemnice,11,271,148,123
8597,5104,Jilemnice,12,253,113,140
8598,5104,Jilemnice,13,224,115,109
8599,5104,Jilemnice,14,231,113,118
8600,5104,Jilemnice,15,234,121,113
8601,5104,Jilemnice,16,221,120,101
8602,5104,Jilemnice,17,209,119,90
8603,5104,Jilemnice,18,213,115,98
8604,5104,Jilemnice,19,221,117,104
8605,5104,Jilemnice,20,206,107,99
8606,5104,Jilemnice,21,198,112,86
8607,5104,Jilemnice,22,223,125,98
8608,5104,Jilemnice,23,194,112,82
8609,5104,Jilemnice,24,206,112,94
8610,5104,Jilemnice,25,255,138,117
8611,5104,Jilemnice,26,212,105,107
8612,5104,Jilemnice,27,283,148,135
8613,5104,Jilemnice,28,333,202,131
8614,5104,Jilemnice,29,261,151,110
8615,5104,Jilemnice,30,272,140,132
8616,5104,Jilemnice,31,244,127,117
8617,5104,Jilemnice,32,256,129,127
8618,5104,Jilemnice,33,260,134,126
8619,5104,Jilemnice,34,245,137,108
8620,5104,Jilemnice,35,276,143,133
8621,5104,Jilemnice,36,235,139,96
8622,5104,Jilemnice,37,264,132,132
8623,5104,Jilemnice,38,262,137,125
8624,5104,Jilemnice,39,263,120,143
8625,5104,Jilemnice,40,286,151,135
8626,5104,Jilemnice,41,316,161,155
8627,5104,Jilemnice,42,335,175,160
8628,5104,Jilemnice,43,367,186,181
8629,5104,Jilemnice,44,370,191,179
8630,5104,Jilemnice,45,390,200,190
8631,5104,Jilemnice,46,408,200,208
8632,5104,Jilemnice,47,378,186,192
8633,5104,Jilemnice,48,355,187,168
8634,5104,Jilemnice,49,344,189,155
8635,5104,Jilemnice,50,343,175,168
8636,5104,Jilemnice,51,297,158,139
8637,5104,Jilemnice,52,292,146,146
8638,5104,Jilemnice,53,276,141,135
8639,5104,Jilemnice,54,311,169,142
8640,5104,Jilemnice,55,279,149,130
8641,5104,Jilemnice,56,326,182,144
8642,5104,Jilemnice,57,272,137,135
8643,5104,Jilemnice,58,265,137,128
8644,5104,Jilemnice,59,245,120,125
8645,5104,Jilemnice,60,234,117,117
8646,5104,Jilemnice,61,195,98,97
8647,5104,Jilemnice,62,258,122,136
8648,5104,Jilemnice,63,277,148,129
8649,5104,Jilemnice,64,292,136,156
8650,5104,Jilemnice,65,301,154,147
8651,5104,Jilemnice,66,310,151,159
8652,5104,Jilemnice,67,314,155,159
8653,5104,Jilemnice,68,290,131,159
8654,5104,Jilemnice,69,317,152,165
8655,5104,Jilemnice,70,256,124,132
8656,5104,Jilemnice,71,290,124,166
8657,5104,Jilemnice,72,279,145,134
8658,5104,Jilemnice,73,274,120,154
8659,5104,Jilemnice,74,257,114,143
8660,5104,Jilemnice,75,219,97,122
8661,5104,Jilemnice,76,209,90,119
8662,5104,Jilemnice,77,192,93,99
8663,5104,Jilemnice,78,149,55,94
8664,5104,Jilemnice,79,164,60,104
8665,5104,Jilemnice,80,128,58,70
8666,5104,Jilemnice,81,138,50,88
8667,5104,Jilemnice,82,90,29,61
8668,5104,Jilemnice,83,94,33,61
8669,5104,Jilemnice,84,82,25,57
8670,5104,Jilemnice,85,65,20,45
8671,5104,Jilemnice,86,90,39,51
8672,5104,Jilemnice,87,68,26,42
8673,5104,Jilemnice,88,69,25,44
8674,5104,Jilemnice,89,44,13,31
8675,5104,Jilemnice,90,37,13,24
8676,5104,Jilemnice,91,37,8,29
8677,5104,Jilemnice,92,23,5,18
8678,5104,Jilemnice,93,23,4,19
8679,5104,Jilemnice,94,17,5,12
8680,5104,Jilemnice,95,5,1,4
8681,5104,Jilemnice,96,8,2,6
8682,5104,Jilemnice,97,3,1,2
8683,5104,Jilemnice,98,2,0,2
8684,5104,Jilemnice,99,1,0,1
8685,5104,Jilemnice,100,0,0,0
8686,5105,Liberec,0,1533,778,755
8687,5105,Liberec,1,1608,802,806
8688,5105,Liberec,2,1607,796,811
8689,5105,Liberec,3,1632,819,813
8690,5105,Liberec,4,1663,854,809
8691,5105,Liberec,5,1649,844,805
8692,5105,Liberec,6,1513,767,746
8693,5105,Liberec,7,1588,815,773
8694,5105,Liberec,8,1595,835,760
8695,5105,Liberec,9,1572,785,787
8696,5105,Liberec,10,1816,950,866
8697,5105,Liberec,11,1764,895,869
8698,5105,Liberec,12,1819,899,920
8699,5105,Liberec,13,1688,868,820
8700,5105,Liberec,14,1567,818,749
8701,5105,Liberec,15,1390,712,678
8702,5105,Liberec,16,1422,715,707
8703,5105,Liberec,17,1282,626,656
8704,5105,Liberec,18,1357,694,663
8705,5105,Liberec,19,1363,723,640
8706,5105,Liberec,20,1366,705,661
8707,5105,Liberec,21,1272,636,636
8708,5105,Liberec,22,1311,667,644
8709,5105,Liberec,23,1279,665,614
8710,5105,Liberec,24,1351,692,659
8711,5105,Liberec,25,1446,767,679
8712,5105,Liberec,26,1545,802,743
8713,5105,Liberec,27,1803,940,863
8714,5105,Liberec,28,1707,885,822
8715,5105,Liberec,29,1828,928,900
8716,5105,Liberec,30,1933,984,949
8717,5105,Liberec,31,1958,984,974
8718,5105,Liberec,32,2032,1024,1008
8719,5105,Liberec,33,2027,1049,978
8720,5105,Liberec,34,1978,977,1001
8721,5105,Liberec,35,2019,1028,991
8722,5105,Liberec,36,1956,1004,952
8723,5105,Liberec,37,2012,1024,988
8724,5105,Liberec,38,2038,1080,958
8725,5105,Liberec,39,2083,1055,1028
8726,5105,Liberec,40,2171,1118,1053
8727,5105,Liberec,41,2332,1210,1122
8728,5105,Liberec,42,2558,1336,1222
8729,5105,Liberec,43,2495,1232,1263
8730,5105,Liberec,44,2641,1338,1303
8731,5105,Liberec,45,2680,1338,1342
8732,5105,Liberec,46,2866,1463,1403
8733,5105,Liberec,47,2577,1314,1263
8734,5105,Liberec,48,2290,1144,1146
8735,5105,Liberec,49,2140,1122,1018
8736,5105,Liberec,50,2036,1089,947
8737,5105,Liberec,51,1886,939,947
8738,5105,Liberec,52,1737,896,841
8739,5105,Liberec,53,1697,850,847
8740,5105,Liberec,54,1810,927,883
8741,5105,Liberec,55,1778,882,896
8742,5105,Liberec,56,1880,924,956
8743,5105,Liberec,57,1815,888,927
8744,5105,Liberec,58,1580,797,783
8745,5105,Liberec,59,1467,748,719
8746,5105,Liberec,60,1454,721,733
8747,5105,Liberec,61,1382,666,716
8748,5105,Liberec,62,1478,714,764
8749,5105,Liberec,63,1531,742,789
8750,5105,Liberec,64,1630,746,884
8751,5105,Liberec,65,1635,772,863
8752,5105,Liberec,66,1705,795,910
8753,5105,Liberec,67,1795,801,994
8754,5105,Liberec,68,1918,846,1072
8755,5105,Liberec,69,1879,870,1009
8756,5105,Liberec,70,1887,823,1064
8757,5105,Liberec,71,1745,750,995
8758,5105,Liberec,72,1837,781,1056
8759,5105,Liberec,73,1918,886,1032
8760,5105,Liberec,74,1681,709,972
8761,5105,Liberec,75,1164,496,668
8762,5105,Liberec,76,1268,529,739
8763,5105,Liberec,77,1186,488,698
8764,5105,Liberec,78,956,382,574
8765,5105,Liberec,79,897,348,549
8766,5105,Liberec,80,831,311,520
8767,5105,Liberec,81,710,241,469
8768,5105,Liberec,82,602,238,364
8769,5105,Liberec,83,458,165,293
8770,5105,Liberec,84,450,132,318
8771,5105,Liberec,85,444,160,284
8772,5105,Liberec,86,385,123,262
8773,5105,Liberec,87,342,114,228
8774,5105,Liberec,88,294,92,202
8775,5105,Liberec,89,266,99,167
8776,5105,Liberec,90,228,63,165
8777,5105,Liberec,91,184,49,135
8778,5105,Liberec,92,104,26,78
8779,5105,Liberec,93,105,23,82
8780,5105,Liberec,94,83,14,69
8781,5105,Liberec,95,62,10,52
8782,5105,Liberec,96,39,6,33
8783,5105,Liberec,97,19,0,19
8784,5105,Liberec,98,13,5,8
8785,5105,Liberec,99,7,2,5
8786,5105,Liberec,100,6,4,2
8787,5106,Nový Bor,0,215,112,103
8788,5106,Nový Bor,1,255,136,119
8789,5106,Nový Bor,2,231,120,111
8790,5106,Nový Bor,3,255,127,128
8791,5106,Nový Bor,4,265,128,137
8792,5106,Nový Bor,5,264,132,132
8793,5106,Nový Bor,6,261,147,114
8794,5106,Nový Bor,7,245,123,122
8795,5106,Nový Bor,8,240,129,111
8796,5106,Nový Bor,9,232,120,112
8797,5106,Nový Bor,10,337,173,164
8798,5106,Nový Bor,11,306,155,151
8799,5106,Nový Bor,12,319,169,150
8800,5106,Nový Bor,13,306,146,160
8801,5106,Nový Bor,14,287,140,147
8802,5106,Nový Bor,15,274,152,122
8803,5106,Nový Bor,16,239,122,117
8804,5106,Nový Bor,17,258,128,130
8805,5106,Nový Bor,18,250,131,119
8806,5106,Nový Bor,19,228,130,98
8807,5106,Nový Bor,20,250,134,116
8808,5106,Nový Bor,21,268,148,120
8809,5106,Nový Bor,22,249,123,126
8810,5106,Nový Bor,23,250,119,131
8811,5106,Nový Bor,24,254,125,129
8812,5106,Nový Bor,25,245,137,108
8813,5106,Nový Bor,26,268,128,140
8814,5106,Nový Bor,27,287,145,142
8815,5106,Nový Bor,28,279,152,127
8816,5106,Nový Bor,29,317,156,161
8817,5106,Nový Bor,30,297,158,139
8818,5106,Nový Bor,31,309,159,150
8819,5106,Nový Bor,32,315,152,163
8820,5106,Nový Bor,33,307,160,147
8821,5106,Nový Bor,34,302,153,149
8822,5106,Nový Bor,35,324,157,167
8823,5106,Nový Bor,36,325,191,134
8824,5106,Nový Bor,37,348,194,154
8825,5106,Nový Bor,38,342,165,177
8826,5106,Nový Bor,39,312,155,157
8827,5106,Nový Bor,40,339,171,168
8828,5106,Nový Bor,41,414,208,206
8829,5106,Nový Bor,42,453,244,209
8830,5106,Nový Bor,43,462,226,236
8831,5106,Nový Bor,44,501,266,235
8832,5106,Nový Bor,45,504,268,236
8833,5106,Nový Bor,46,557,282,275
8834,5106,Nový Bor,47,505,268,237
8835,5106,Nový Bor,48,403,193,210
8836,5106,Nový Bor,49,403,204,199
8837,5106,Nový Bor,50,347,177,170
8838,5106,Nový Bor,51,352,196,156
8839,5106,Nový Bor,52,328,152,176
8840,5106,Nový Bor,53,318,156,162
8841,5106,Nový Bor,54,343,200,143
8842,5106,Nový Bor,55,342,170,172
8843,5106,Nový Bor,56,336,174,162
8844,5106,Nový Bor,57,323,161,162
8845,5106,Nový Bor,58,302,134,168
8846,5106,Nový Bor,59,278,149,129
8847,5106,Nový Bor,60,282,139,143
8848,5106,Nový Bor,61,276,131,145
8849,5106,Nový Bor,62,307,139,168
8850,5106,Nový Bor,63,332,151,181
8851,5106,Nový Bor,64,339,159,180
8852,5106,Nový Bor,65,347,162,185
8853,5106,Nový Bor,66,376,177,199
8854,5106,Nový Bor,67,356,160,196
8855,5106,Nový Bor,68,389,173,216
8856,5106,Nový Bor,69,417,184,233
8857,5106,Nový Bor,70,419,210,209
8858,5106,Nový Bor,71,358,147,211
8859,5106,Nový Bor,72,366,168,198
8860,5106,Nový Bor,73,411,166,245
8861,5106,Nový Bor,74,350,144,206
8862,5106,Nový Bor,75,228,93,135
8863,5106,Nový Bor,76,240,102,138
8864,5106,Nový Bor,77,181,72,109
8865,5106,Nový Bor,78,160,69,91
8866,5106,Nový Bor,79,172,64,108
8867,5106,Nový Bor,80,186,80,106
8868,5106,Nový Bor,81,140,55,85
8869,5106,Nový Bor,82,117,46,71
8870,5106,Nový Bor,83,99,42,57
8871,5106,Nový Bor,84,90,20,70
8872,5106,Nový Bor,85,71,25,46
8873,5106,Nový Bor,86,79,34,45
8874,5106,Nový Bor,87,57,18,39
8875,5106,Nový Bor,88,47,16,31
8876,5106,Nový Bor,89,51,14,37
8877,5106,Nový Bor,90,29,7,22
8878,5106,Nový Bor,91,29,6,23
8879,5106,Nový Bor,92,12,5,7
8880,5106,Nový Bor,93,21,5,16
8881,5106,Nový Bor,94,10,1,9
8882,5106,Nový Bor,95,7,1,6
8883,5106,Nový Bor,96,1,0,1
8884,5106,Nový Bor,97,8,2,6
8885,5106,Nový Bor,98,4,1,3
8886,5106,Nový Bor,99,3,0,3
8887,5106,Nový Bor,100,2,1,1
8888,5107,Semily,0,234,128,106
8889,5107,Semily,1,256,134,122
8890,5107,Semily,2,249,132,117
8891,5107,Semily,3,265,155,110
8892,5107,Semily,4,308,175,133
8893,5107,Semily,5,286,134,152
8894,5107,Semily,6,245,120,125
8895,5107,Semily,7,261,128,133
8896,5107,Semily,8,239,129,110
8897,5107,Semily,9,232,117,115
8898,5107,Semily,10,291,141,150
8899,5107,Semily,11,293,152,141
8900,5107,Semily,12,316,163,153
8901,5107,Semily,13,320,163,157
8902,5107,Semily,14,260,141,119
8903,5107,Semily,15,265,138,127
8904,5107,Semily,16,238,123,115
8905,5107,Semily,17,215,117,98
8906,5107,Semily,18,246,121,125
8907,5107,Semily,19,240,124,116
8908,5107,Semily,20,223,111,112
8909,5107,Semily,21,239,120,119
8910,5107,Semily,22,229,116,113
8911,5107,Semily,23,228,101,127
8912,5107,Semily,24,219,114,105
8913,5107,Semily,25,232,120,112
8914,5107,Semily,26,271,152,119
8915,5107,Semily,27,292,149,143
8916,5107,Semily,28,343,183,160
8917,5107,Semily,29,334,176,158
8918,5107,Semily,30,300,150,150
8919,5107,Semily,31,349,172,177
8920,5107,Semily,32,311,176,135
8921,5107,Semily,33,349,180,169
8922,5107,Semily,34,316,188,128
8923,5107,Semily,35,299,168,131
8924,5107,Semily,36,329,175,154
8925,5107,Semily,37,311,170,141
8926,5107,Semily,38,326,179,147
8927,5107,Semily,39,337,187,150
8928,5107,Semily,40,348,187,161
8929,5107,Semily,41,368,214,154
8930,5107,Semily,42,413,216,197
8931,5107,Semily,43,391,210,181
8932,5107,Semily,44,420,230,190
8933,5107,Semily,45,446,217,229
8934,5107,Semily,46,417,221,196
8935,5107,Semily,47,412,228,184
8936,5107,Semily,48,387,180,207
8937,5107,Semily,49,389,196,193
8938,5107,Semily,50,354,181,173
8939,5107,Semily,51,332,176,156
8940,5107,Semily,52,308,150,158
8941,5107,Semily,53,273,142,131
8942,5107,Semily,54,305,157,148
8943,5107,Semily,55,353,175,178
8944,5107,Semily,56,343,191,152
8945,5107,Semily,57,360,164,196
8946,5107,Semily,58,300,165,135
8947,5107,Semily,59,283,133,150
8948,5107,Semily,60,286,134,152
8949,5107,Semily,61,298,142,156
8950,5107,Semily,62,339,179,160
8951,5107,Semily,63,341,168,173
8952,5107,Semily,64,378,182,196
8953,5107,Semily,65,325,180,145
8954,5107,Semily,66,360,166,194
8955,5107,Semily,67,333,175,158
8956,5107,Semily,68,326,150,176
8957,5107,Semily,69,347,149,198
8958,5107,Semily,70,338,162,176
8959,5107,Semily,71,312,151,161
8960,5107,Semily,72,362,154,208
8961,5107,Semily,73,335,163,172
8962,5107,Semily,74,313,140,173
8963,5107,Semily,75,221,83,138
8964,5107,Semily,76,254,103,151
8965,5107,Semily,77,243,95,148
8966,5107,Semily,78,187,64,123
8967,5107,Semily,79,172,62,110
8968,5107,Semily,80,166,67,99
8969,5107,Semily,81,144,56,88
8970,5107,Semily,82,108,39,69
8971,5107,Semily,83,103,45,58
8972,5107,Semily,84,95,25,70
8973,5107,Semily,85,88,25,63
8974,5107,Semily,86,108,32,76
8975,5107,Semily,87,82,27,55
8976,5107,Semily,88,79,23,56
8977,5107,Semily,89,52,14,38
8978,5107,Semily,90,57,21,36
8979,5107,Semily,91,36,13,23
8980,5107,Semily,92,24,6,18
8981,5107,Semily,93,23,6,17
8982,5107,Semily,94,16,4,12
8983,5107,Semily,95,7,0,7
8984,5107,Semily,96,2,0,2
8985,5107,Semily,97,2,0,2
8986,5107,Semily,98,4,1,3
8987,5107,Semily,99,2,0,2
8988,5107,Semily,100,4,2,2
8989,5108,Tanvald,0,197,98,99
8990,5108,Tanvald,1,190,102,88
8991,5108,Tanvald,2,211,114,97
8992,5108,Tanvald,3,209,114,95
8993,5108,Tanvald,4,224,104,120
8994,5108,Tanvald,5,203,100,103
8995,5108,Tanvald,6,168,97,71
8996,5108,Tanvald,7,160,85,75
8997,5108,Tanvald,8,167,84,83
8998,5108,Tanvald,9,216,100,116
8999,5108,Tanvald,10,229,113,116
9000,5108,Tanvald,11,210,99,111
9001,5108,Tanvald,12,257,117,140
9002,5108,Tanvald,13,233,121,112
9003,5108,Tanvald,14,213,104,109
9004,5108,Tanvald,15,174,100,74
9005,5108,Tanvald,16,162,96,66
9006,5108,Tanvald,17,185,97,88
9007,5108,Tanvald,18,195,114,81
9008,5108,Tanvald,19,179,89,90
9009,5108,Tanvald,20,183,104,79
9010,5108,Tanvald,21,199,113,86
9011,5108,Tanvald,22,208,106,102
9012,5108,Tanvald,23,201,100,101
9013,5108,Tanvald,24,187,101,86
9014,5108,Tanvald,25,198,112,86
9015,5108,Tanvald,26,213,110,103
9016,5108,Tanvald,27,242,126,116
9017,5108,Tanvald,28,225,115,110
9018,5108,Tanvald,29,256,127,129
9019,5108,Tanvald,30,230,121,109
9020,5108,Tanvald,31,232,114,118
9021,5108,Tanvald,32,227,132,95
9022,5108,Tanvald,33,242,125,117
9023,5108,Tanvald,34,238,141,97
9024,5108,Tanvald,35,269,140,129
9025,5108,Tanvald,36,235,121,114
9026,5108,Tanvald,37,256,121,135
9027,5108,Tanvald,38,281,135,146
9028,5108,Tanvald,39,252,139,113
9029,5108,Tanvald,40,294,155,139
9030,5108,Tanvald,41,290,155,135
9031,5108,Tanvald,42,330,164,166
9032,5108,Tanvald,43,314,170,144
9033,5108,Tanvald,44,321,179,142
9034,5108,Tanvald,45,348,197,151
9035,5108,Tanvald,46,392,206,186
9036,5108,Tanvald,47,350,189,161
9037,5108,Tanvald,48,332,150,182
9038,5108,Tanvald,49,358,182,176
9039,5108,Tanvald,50,317,165,152
9040,5108,Tanvald,51,290,147,143
9041,5108,Tanvald,52,253,137,116
9042,5108,Tanvald,53,253,126,127
9043,5108,Tanvald,54,228,103,125
9044,5108,Tanvald,55,262,143,119
9045,5108,Tanvald,56,285,146,139
9046,5108,Tanvald,57,255,132,123
9047,5108,Tanvald,58,237,118,119
9048,5108,Tanvald,59,246,143,103
9049,5108,Tanvald,60,234,110,124
9050,5108,Tanvald,61,201,104,97
9051,5108,Tanvald,62,264,117,147
9052,5108,Tanvald,63,293,156,137
9053,5108,Tanvald,64,269,126,143
9054,5108,Tanvald,65,261,124,137
9055,5108,Tanvald,66,282,132,150
9056,5108,Tanvald,67,260,137,123
9057,5108,Tanvald,68,339,158,181
9058,5108,Tanvald,69,282,131,151
9059,5108,Tanvald,70,295,118,177
9060,5108,Tanvald,71,274,124,150
9061,5108,Tanvald,72,297,150,147
9062,5108,Tanvald,73,284,107,177
9063,5108,Tanvald,74,243,108,135
9064,5108,Tanvald,75,190,78,112
9065,5108,Tanvald,76,191,76,115
9066,5108,Tanvald,77,196,71,125
9067,5108,Tanvald,78,143,58,85
9068,5108,Tanvald,79,128,45,83
9069,5108,Tanvald,80,139,61,78
9070,5108,Tanvald,81,125,46,79
9071,5108,Tanvald,82,81,29,52
9072,5108,Tanvald,83,74,23,51
9073,5108,Tanvald,84,57,17,40
9074,5108,Tanvald,85,59,20,39
9075,5108,Tanvald,86,64,24,40
9076,5108,Tanvald,87,46,14,32
9077,5108,Tanvald,88,43,19,24
9078,5108,Tanvald,89,40,15,25
9079,5108,Tanvald,90,24,3,21
9080,5108,Tanvald,91,15,2,13
9081,5108,Tanvald,92,19,2,17
9082,5108,Tanvald,93,12,6,6
9083,5108,Tanvald,94,12,2,10
9084,5108,Tanvald,95,9,1,8
9085,5108,Tanvald,96,9,2,7
9086,5108,Tanvald,97,3,1,2
9087,5108,Tanvald,98,3,1,2
9088,5108,Tanvald,99,2,0,2
9089,5108,Tanvald,100,1,0,1
9090,5109,Turnov,0,395,203,192
9091,5109,Turnov,1,370,186,184
9092,5109,Turnov,2,382,197,185
9093,5109,Turnov,3,371,187,184
9094,5109,Turnov,4,398,207,191
9095,5109,Turnov,5,359,184,175
9096,5109,Turnov,6,329,182,147
9097,5109,Turnov,7,360,185,175
9098,5109,Turnov,8,364,201,163
9099,5109,Turnov,9,321,163,158
9100,5109,Turnov,10,370,198,172
9101,5109,Turnov,11,432,219,213
9102,5109,Turnov,12,362,176,186
9103,5109,Turnov,13,348,194,154
9104,5109,Turnov,14,339,171,168
9105,5109,Turnov,15,332,171,161
9106,5109,Turnov,16,331,173,158
9107,5109,Turnov,17,298,161,137
9108,5109,Turnov,18,290,148,142
9109,5109,Turnov,19,288,137,151
9110,5109,Turnov,20,290,156,134
9111,5109,Turnov,21,312,145,167
9112,5109,Turnov,22,299,139,160
9113,5109,Turnov,23,281,125,156
9114,5109,Turnov,24,280,152,128
9115,5109,Turnov,25,324,164,160
9116,5109,Turnov,26,361,176,185
9117,5109,Turnov,27,371,195,176
9118,5109,Turnov,28,416,229,187
9119,5109,Turnov,29,442,241,201
9120,5109,Turnov,30,423,228,195
9121,5109,Turnov,31,430,211,219
9122,5109,Turnov,32,418,198,220
9123,5109,Turnov,33,440,216,224
9124,5109,Turnov,34,428,227,201
9125,5109,Turnov,35,451,234,217
9126,5109,Turnov,36,439,213,226
9127,5109,Turnov,37,423,228,195
9128,5109,Turnov,38,450,220,230
9129,5109,Turnov,39,461,232,229
9130,5109,Turnov,40,495,242,253
9131,5109,Turnov,41,552,285,267
9132,5109,Turnov,42,560,285,275
9133,5109,Turnov,43,562,296,266
9134,5109,Turnov,44,633,322,311
9135,5109,Turnov,45,605,323,282
9136,5109,Turnov,46,604,324,280
9137,5109,Turnov,47,597,312,285
9138,5109,Turnov,48,531,273,258
9139,5109,Turnov,49,487,246,241
9140,5109,Turnov,50,466,237,229
9141,5109,Turnov,51,405,189,216
9142,5109,Turnov,52,452,219,233
9143,5109,Turnov,53,414,213,201
9144,5109,Turnov,54,449,232,217
9145,5109,Turnov,55,417,211,206
9146,5109,Turnov,56,478,231,247
9147,5109,Turnov,57,440,220,220
9148,5109,Turnov,58,343,165,178
9149,5109,Turnov,59,381,202,179
9150,5109,Turnov,60,357,176,181
9151,5109,Turnov,61,352,181,171
9152,5109,Turnov,62,400,186,214
9153,5109,Turnov,63,430,216,214
9154,5109,Turnov,64,403,195,208
9155,5109,Turnov,65,435,204,231
9156,5109,Turnov,66,416,205,211
9157,5109,Turnov,67,412,194,218
9158,5109,Turnov,68,464,217,247
9159,5109,Turnov,69,440,198,242
9160,5109,Turnov,70,454,198,256
9161,5109,Turnov,71,393,192,201
9162,5109,Turnov,72,405,179,226
9163,5109,Turnov,73,463,204,259
9164,5109,Turnov,74,383,163,220
9165,5109,Turnov,75,317,137,180
9166,5109,Turnov,76,317,144,173
9167,5109,Turnov,77,333,135,198
9168,5109,Turnov,78,244,99,145
9169,5109,Turnov,79,216,97,119
9170,5109,Turnov,80,180,78,102
9171,5109,Turnov,81,163,58,105
9172,5109,Turnov,82,164,58,106
9173,5109,Turnov,83,137,51,86
9174,5109,Turnov,84,143,57,86
9175,5109,Turnov,85,116,33,83
9176,5109,Turnov,86,107,30,77
9177,5109,Turnov,87,111,35,76
9178,5109,Turnov,88,93,32,61
9179,5109,Turnov,89,68,18,50
9180,5109,Turnov,90,76,27,49
9181,5109,Turnov,91,52,12,40
9182,5109,Turnov,92,40,13,27
9183,5109,Turnov,93,33,8,25
9184,5109,Turnov,94,12,3,9
9185,5109,Turnov,95,12,3,9
9186,5109,Turnov,96,12,4,8
9187,5109,Turnov,97,4,0,4
9188,5109,Turnov,98,3,0,3
9189,5109,Turnov,99,1,1,0
9190,5109,Turnov,100,1,0,1
9191,5110,Železný Brod,0,125,66,59
9192,5110,Železný Brod,1,97,54,43
9193,5110,Železný Brod,2,112,51,61
9194,5110,Železný Brod,3,149,83,66
9195,5110,Železný Brod,4,148,75,73
9196,5110,Železný Brod,5,114,55,59
9197,5110,Železný Brod,6,127,65,62
9198,5110,Železný Brod,7,128,65,63
9199,5110,Železný Brod,8,121,49,72
9200,5110,Železný Brod,9,130,68,62
9201,5110,Železný Brod,10,138,70,68
9202,5110,Železný Brod,11,150,81,69
9203,5110,Železný Brod,12,146,77,69
9204,5110,Železný Brod,13,136,64,72
9205,5110,Železný Brod,14,131,55,76
9206,5110,Železný Brod,15,107,54,53
9207,5110,Železný Brod,16,128,67,61
9208,5110,Železný Brod,17,118,57,61
9209,5110,Železný Brod,18,113,51,62
9210,5110,Železný Brod,19,92,46,46
9211,5110,Železný Brod,20,106,49,57
9212,5110,Železný Brod,21,105,55,50
9213,5110,Železný Brod,22,96,53,43
9214,5110,Železný Brod,23,114,59,55
9215,5110,Železný Brod,24,108,49,59
9216,5110,Železný Brod,25,112,52,60
9217,5110,Železný Brod,26,119,55,64
9218,5110,Železný Brod,27,143,79,64
9219,5110,Železný Brod,28,118,62,56
9220,5110,Železný Brod,29,127,71,56
9221,5110,Železný Brod,30,145,76,69
9222,5110,Železný Brod,31,128,65,63
9223,5110,Železný Brod,32,142,73,69
9224,5110,Železný Brod,33,129,66,63
9225,5110,Železný Brod,34,160,90,70
9226,5110,Železný Brod,35,139,82,57
9227,5110,Železný Brod,36,162,81,81
9228,5110,Železný Brod,37,164,86,78
9229,5110,Železný Brod,38,149,81,68
9230,5110,Železný Brod,39,167,81,86
9231,5110,Železný Brod,40,184,99,85
9232,5110,Železný Brod,41,208,107,101
9233,5110,Železný Brod,42,216,116,100
9234,5110,Železný Brod,43,224,93,131
9235,5110,Železný Brod,44,232,122,110
9236,5110,Železný Brod,45,231,118,113
9237,5110,Železný Brod,46,218,114,104
9238,5110,Železný Brod,47,206,101,105
9239,5110,Železný Brod,48,170,82,88
9240,5110,Železný Brod,49,173,94,79
9241,5110,Železný Brod,50,173,102,71
9242,5110,Železný Brod,51,182,99,83
9243,5110,Železný Brod,52,150,89,61
9244,5110,Železný Brod,53,129,64,65
9245,5110,Železný Brod,54,133,62,71
9246,5110,Železný Brod,55,140,64,76
9247,5110,Železný Brod,56,160,82,78
9248,5110,Železný Brod,57,160,88,72
9249,5110,Železný Brod,58,138,67,71
9250,5110,Železný Brod,59,103,45,58
9251,5110,Železný Brod,60,121,61,60
9252,5110,Železný Brod,61,135,66,69
9253,5110,Železný Brod,62,138,77,61
9254,5110,Železný Brod,63,134,64,70
9255,5110,Železný Brod,64,152,68,84
9256,5110,Železný Brod,65,150,72,78
9257,5110,Železný Brod,66,162,81,81
9258,5110,Železný Brod,67,153,63,90
9259,5110,Železný Brod,68,168,72,96
9260,5110,Železný Brod,69,193,100,93
9261,5110,Železný Brod,70,230,117,113
9262,5110,Železný Brod,71,167,73,94
9263,5110,Železný Brod,72,156,68,88
9264,5110,Železný Brod,73,181,76,105
9265,5110,Železný Brod,74,171,76,95
9266,5110,Železný Brod,75,144,67,77
9267,5110,Železný Brod,76,134,61,73
9268,5110,Železný Brod,77,111,44,67
9269,5110,Železný Brod,78,88,38,50
9270,5110,Železný Brod,79,61,30,31
9271,5110,Železný Brod,80,66,26,40
9272,5110,Železný Brod,81,63,16,47
9273,5110,Železný Brod,82,53,18,35
9274,5110,Železný Brod,83,50,16,34
9275,5110,Železný Brod,84,43,14,29
9276,5110,Železný Brod,85,41,13,28
9277,5110,Železný Brod,86,38,11,27
9278,5110,Železný Brod,87,26,7,19
9279,5110,Železný Brod,88,35,11,24
9280,5110,Železný Brod,89,24,9,15
9281,5110,Železný Brod,90,33,6,27
9282,5110,Železný Brod,91,17,4,13
9283,5110,Železný Brod,92,14,3,11
9284,5110,Železný Brod,93,12,1,11
9285,5110,Železný Brod,94,7,0,7
9286,5110,Železný Brod,95,5,0,5
9287,5110,Železný Brod,96,3,0,3
9288,5110,Železný Brod,97,4,1,3
9289,5110,Železný Brod,98,2,0,2
9290,5110,Železný Brod,99,3,0,3
9291,5110,Železný Brod,100,0,0,0
9292,5201,Broumov,0,145,61,84
9293,5201,Broumov,1,152,67,85
9294,5201,Broumov,2,154,76,78
9295,5201,Broumov,3,146,73,73
9296,5201,Broumov,4,161,90,71
9297,5201,Broumov,5,143,76,67
9298,5201,Broumov,6,126,67,59
9299,5201,Broumov,7,143,85,58
9300,5201,Broumov,8,155,81,74
9301,5201,Broumov,9,154,73,81
9302,5201,Broumov,10,196,97,99
9303,5201,Broumov,11,166,91,75
9304,5201,Broumov,12,157,76,81
9305,5201,Broumov,13,161,81,80
9306,5201,Broumov,14,188,106,82
9307,5201,Broumov,15,179,101,78
9308,5201,Broumov,16,155,77,78
9309,5201,Broumov,17,146,73,73
9310,5201,Broumov,18,160,90,70
9311,5201,Broumov,19,167,85,82
9312,5201,Broumov,20,157,92,65
9313,5201,Broumov,21,175,94,81
9314,5201,Broumov,22,135,73,62
9315,5201,Broumov,23,171,83,88
9316,5201,Broumov,24,153,77,76
9317,5201,Broumov,25,148,77,71
9318,5201,Broumov,26,180,109,71
9319,5201,Broumov,27,196,96,100
9320,5201,Broumov,28,201,120,81
9321,5201,Broumov,29,207,103,104
9322,5201,Broumov,30,188,109,79
9323,5201,Broumov,31,190,98,92
9324,5201,Broumov,32,167,91,76
9325,5201,Broumov,33,223,114,109
9326,5201,Broumov,34,164,86,78
9327,5201,Broumov,35,150,77,73
9328,5201,Broumov,36,166,94,72
9329,5201,Broumov,37,167,74,93
9330,5201,Broumov,38,171,92,79
9331,5201,Broumov,39,180,92,88
9332,5201,Broumov,40,184,100,84
9333,5201,Broumov,41,184,99,85
9334,5201,Broumov,42,216,99,117
9335,5201,Broumov,43,234,123,111
9336,5201,Broumov,44,251,134,117
9337,5201,Broumov,45,246,119,127
9338,5201,Broumov,46,280,144,136
9339,5201,Broumov,47,293,159,134
9340,5201,Broumov,48,266,134,132
9341,5201,Broumov,49,265,124,141
9342,5201,Broumov,50,253,128,125
9343,5201,Broumov,51,229,115,114
9344,5201,Broumov,52,220,109,111
9345,5201,Broumov,53,228,100,128
9346,5201,Broumov,54,220,114,106
9347,5201,Broumov,55,193,104,89
9348,5201,Broumov,56,215,124,91
9349,5201,Broumov,57,244,124,120
9350,5201,Broumov,58,191,89,102
9351,5201,Broumov,59,188,85,103
9352,5201,Broumov,60,186,98,88
9353,5201,Broumov,61,162,85,77
9354,5201,Broumov,62,179,96,83
9355,5201,Broumov,63,203,98,105
9356,5201,Broumov,64,212,100,112
9357,5201,Broumov,65,213,111,102
9358,5201,Broumov,66,215,105,110
9359,5201,Broumov,67,195,79,116
9360,5201,Broumov,68,213,104,109
9361,5201,Broumov,69,240,91,149
9362,5201,Broumov,70,225,107,118
9363,5201,Broumov,71,244,113,131
9364,5201,Broumov,72,241,115,126
9365,5201,Broumov,73,233,113,120
9366,5201,Broumov,74,216,105,111
9367,5201,Broumov,75,149,62,87
9368,5201,Broumov,76,167,61,106
9369,5201,Broumov,77,148,69,79
9370,5201,Broumov,78,113,38,75
9371,5201,Broumov,79,101,38,63
9372,5201,Broumov,80,117,43,74
9373,5201,Broumov,81,101,38,63
9374,5201,Broumov,82,64,31,33
9375,5201,Broumov,83,68,21,47
9376,5201,Broumov,84,59,14,45
9377,5201,Broumov,85,42,9,33
9378,5201,Broumov,86,34,14,20
9379,5201,Broumov,87,35,14,21
9380,5201,Broumov,88,45,15,30
9381,5201,Broumov,89,35,18,17
9382,5201,Broumov,90,29,10,19
9383,5201,Broumov,91,17,2,15
9384,5201,Broumov,92,18,5,13
9385,5201,Broumov,93,9,4,5
9386,5201,Broumov,94,8,1,7
9387,5201,Broumov,95,7,3,4
9388,5201,Broumov,96,2,1,1
9389,5201,Broumov,97,3,0,3
9390,5201,Broumov,98,4,0,4
9391,5201,Broumov,99,1,0,1
9392,5201,Broumov,100,1,0,1
9393,5202,Dobruška,0,197,92,105
9394,5202,Dobruška,1,226,118,108
9395,5202,Dobruška,2,209,99,110
9396,5202,Dobruška,3,229,114,115
9397,5202,Dobruška,4,199,107,92
9398,5202,Dobruška,5,186,93,93
9399,5202,Dobruška,6,232,119,113
9400,5202,Dobruška,7,198,110,88
9401,5202,Dobruška,8,199,92,107
9402,5202,Dobruška,9,213,98,115
9403,5202,Dobruška,10,264,128,136
9404,5202,Dobruška,11,265,134,131
9405,5202,Dobruška,12,243,128,115
9406,5202,Dobruška,13,267,135,132
9407,5202,Dobruška,14,222,113,109
9408,5202,Dobruška,15,188,108,80
9409,5202,Dobruška,16,209,102,107
9410,5202,Dobruška,17,204,100,104
9411,5202,Dobruška,18,176,97,79
9412,5202,Dobruška,19,185,94,91
9413,5202,Dobruška,20,192,107,85
9414,5202,Dobruška,21,179,92,87
9415,5202,Dobruška,22,195,96,99
9416,5202,Dobruška,23,202,93,109
9417,5202,Dobruška,24,174,100,74
9418,5202,Dobruška,25,207,107,100
9419,5202,Dobruška,26,229,130,99
9420,5202,Dobruška,27,267,130,137
9421,5202,Dobruška,28,257,140,117
9422,5202,Dobruška,29,263,142,121
9423,5202,Dobruška,30,262,147,115
9424,5202,Dobruška,31,233,130,103
9425,5202,Dobruška,32,237,114,123
9426,5202,Dobruška,33,229,126,103
9427,5202,Dobruška,34,212,115,97
9428,5202,Dobruška,35,242,125,117
9429,5202,Dobruška,36,282,147,135
9430,5202,Dobruška,37,256,135,121
9431,5202,Dobruška,38,227,121,106
9432,5202,Dobruška,39,244,115,129
9433,5202,Dobruška,40,276,135,141
9434,5202,Dobruška,41,291,153,138
9435,5202,Dobruška,42,353,174,179
9436,5202,Dobruška,43,369,187,182
9437,5202,Dobruška,44,325,156,169
9438,5202,Dobruška,45,362,187,175
9439,5202,Dobruška,46,310,163,147
9440,5202,Dobruška,47,309,156,153
9441,5202,Dobruška,48,282,150,132
9442,5202,Dobruška,49,260,134,126
9443,5202,Dobruška,50,263,138,125
9444,5202,Dobruška,51,252,130,122
9445,5202,Dobruška,52,258,120,138
9446,5202,Dobruška,53,224,112,112
9447,5202,Dobruška,54,238,123,115
9448,5202,Dobruška,55,248,129,119
9449,5202,Dobruška,56,261,134,127
9450,5202,Dobruška,57,239,123,116
9451,5202,Dobruška,58,227,111,116
9452,5202,Dobruška,59,240,119,121
9453,5202,Dobruška,60,210,94,116
9454,5202,Dobruška,61,238,133,105
9455,5202,Dobruška,62,251,121,130
9456,5202,Dobruška,63,285,124,161
9457,5202,Dobruška,64,276,132,144
9458,5202,Dobruška,65,297,130,167
9459,5202,Dobruška,66,262,118,144
9460,5202,Dobruška,67,271,140,131
9461,5202,Dobruška,68,284,139,145
9462,5202,Dobruška,69,274,128,146
9463,5202,Dobruška,70,279,127,152
9464,5202,Dobruška,71,236,118,118
9465,5202,Dobruška,72,254,110,144
9466,5202,Dobruška,73,235,109,126
9467,5202,Dobruška,74,229,106,123
9468,5202,Dobruška,75,190,89,101
9469,5202,Dobruška,76,188,77,111
9470,5202,Dobruška,77,162,71,91
9471,5202,Dobruška,78,141,65,76
9472,5202,Dobruška,79,157,68,89
9473,5202,Dobruška,80,134,46,88
9474,5202,Dobruška,81,120,41,79
9475,5202,Dobruška,82,83,35,48
9476,5202,Dobruška,83,86,32,54
9477,5202,Dobruška,84,91,39,52
9478,5202,Dobruška,85,63,28,35
9479,5202,Dobruška,86,73,27,46
9480,5202,Dobruška,87,65,14,51
9481,5202,Dobruška,88,48,19,29
9482,5202,Dobruška,89,51,14,37
9483,5202,Dobruška,90,29,12,17
9484,5202,Dobruška,91,13,4,9
9485,5202,Dobruška,92,22,3,19
9486,5202,Dobruška,93,16,7,9
9487,5202,Dobruška,94,12,0,12
9488,5202,Dobruška,95,5,1,4
9489,5202,Dobruška,96,6,0,6
9490,5202,Dobruška,97,3,1,2
9491,5202,Dobruška,98,1,0,1
9492,5202,Dobruška,99,1,1,0
9493,5202,Dobruška,100,0,0,0
9494,5203,Dvůr Králové nad Labem,0,264,131,133
9495,5203,Dvůr Králové nad Labem,1,260,137,123
9496,5203,Dvůr Králové nad Labem,2,236,123,113
9497,5203,Dvůr Králové nad Labem,3,240,125,115
9498,5203,Dvůr Králové nad Labem,4,266,139,127
9499,5203,Dvůr Králové nad Labem,5,241,122,119
9500,5203,Dvůr Králové nad Labem,6,252,121,131
9501,5203,Dvůr Králové nad Labem,7,250,122,128
9502,5203,Dvůr Králové nad Labem,8,258,138,120
9503,5203,Dvůr Králové nad Labem,9,250,135,115
9504,5203,Dvůr Králové nad Labem,10,289,144,145
9505,5203,Dvůr Králové nad Labem,11,286,144,142
9506,5203,Dvůr Králové nad Labem,12,347,168,179
9507,5203,Dvůr Králové nad Labem,13,302,168,134
9508,5203,Dvůr Králové nad Labem,14,258,144,114
9509,5203,Dvůr Králové nad Labem,15,269,162,107
9510,5203,Dvůr Králové nad Labem,16,253,129,124
9511,5203,Dvůr Králové nad Labem,17,251,139,112
9512,5203,Dvůr Králové nad Labem,18,244,121,123
9513,5203,Dvůr Králové nad Labem,19,254,139,115
9514,5203,Dvůr Králové nad Labem,20,243,117,126
9515,5203,Dvůr Králové nad Labem,21,245,111,134
9516,5203,Dvůr Králové nad Labem,22,260,132,128
9517,5203,Dvůr Králové nad Labem,23,231,123,108
9518,5203,Dvůr Králové nad Labem,24,240,135,105
9519,5203,Dvůr Králové nad Labem,25,280,145,135
9520,5203,Dvůr Králové nad Labem,26,277,138,139
9521,5203,Dvůr Králové nad Labem,27,321,159,162
9522,5203,Dvůr Králové nad Labem,28,303,162,141
9523,5203,Dvůr Králové nad Labem,29,326,188,138
9524,5203,Dvůr Králové nad Labem,30,324,160,164
9525,5203,Dvůr Králové nad Labem,31,296,159,137
9526,5203,Dvůr Králové nad Labem,32,319,151,168
9527,5203,Dvůr Králové nad Labem,33,324,178,146
9528,5203,Dvůr Králové nad Labem,34,323,169,154
9529,5203,Dvůr Králové nad Labem,35,317,179,138
9530,5203,Dvůr Králové nad Labem,36,314,165,149
9531,5203,Dvůr Králové nad Labem,37,306,160,146
9532,5203,Dvůr Králové nad Labem,38,330,155,175
9533,5203,Dvůr Králové nad Labem,39,323,181,142
9534,5203,Dvůr Králové nad Labem,40,357,187,170
9535,5203,Dvůr Králové nad Labem,41,402,205,197
9536,5203,Dvůr Králové nad Labem,42,431,238,193
9537,5203,Dvůr Králové nad Labem,43,418,213,205
9538,5203,Dvůr Králové nad Labem,44,448,246,202
9539,5203,Dvůr Králové nad Labem,45,520,272,248
9540,5203,Dvůr Králové nad Labem,46,516,275,241
9541,5203,Dvůr Králové nad Labem,47,468,223,245
9542,5203,Dvůr Králové nad Labem,48,423,215,208
9543,5203,Dvůr Králové nad Labem,49,399,214,185
9544,5203,Dvůr Králové nad Labem,50,332,171,161
9545,5203,Dvůr Králové nad Labem,51,414,214,200
9546,5203,Dvůr Králové nad Labem,52,360,189,171
9547,5203,Dvůr Králové nad Labem,53,339,161,178
9548,5203,Dvůr Králové nad Labem,54,292,152,140
9549,5203,Dvůr Králové nad Labem,55,345,171,174
9550,5203,Dvůr Králové nad Labem,56,349,191,158
9551,5203,Dvůr Králové nad Labem,57,361,175,186
9552,5203,Dvůr Králové nad Labem,58,293,141,152
9553,5203,Dvůr Králové nad Labem,59,327,149,178
9554,5203,Dvůr Králové nad Labem,60,286,151,135
9555,5203,Dvůr Králové nad Labem,61,326,172,154
9556,5203,Dvůr Králové nad Labem,62,294,137,157
9557,5203,Dvůr Králové nad Labem,63,334,166,168
9558,5203,Dvůr Králové nad Labem,64,388,200,188
9559,5203,Dvůr Králové nad Labem,65,371,188,183
9560,5203,Dvůr Králové nad Labem,66,379,166,213
9561,5203,Dvůr Králové nad Labem,67,371,160,211
9562,5203,Dvůr Králové nad Labem,68,397,178,219
9563,5203,Dvůr Králové nad Labem,69,423,186,237
9564,5203,Dvůr Králové nad Labem,70,432,200,232
9565,5203,Dvůr Králové nad Labem,71,391,167,224
9566,5203,Dvůr Králové nad Labem,72,356,165,191
9567,5203,Dvůr Králové nad Labem,73,399,172,227
9568,5203,Dvůr Králové nad Labem,74,370,160,210
9569,5203,Dvůr Králové nad Labem,75,301,142,159
9570,5203,Dvůr Králové nad Labem,76,274,128,146
9571,5203,Dvůr Králové nad Labem,77,266,111,155
9572,5203,Dvůr Králové nad Labem,78,204,90,114
9573,5203,Dvůr Králové nad Labem,79,180,81,99
9574,5203,Dvůr Králové nad Labem,80,178,72,106
9575,5203,Dvůr Králové nad Labem,81,131,51,80
9576,5203,Dvůr Králové nad Labem,82,114,37,77
9577,5203,Dvůr Králové nad Labem,83,108,38,70
9578,5203,Dvůr Králové nad Labem,84,81,23,58
9579,5203,Dvůr Králové nad Labem,85,80,26,54
9580,5203,Dvůr Králové nad Labem,86,74,24,50
9581,5203,Dvůr Králové nad Labem,87,68,29,39
9582,5203,Dvůr Králové nad Labem,88,70,25,45
9583,5203,Dvůr Králové nad Labem,89,57,13,44
9584,5203,Dvůr Králové nad Labem,90,63,20,43
9585,5203,Dvůr Králové nad Labem,91,36,10,26
9586,5203,Dvůr Králové nad Labem,92,33,10,23
9587,5203,Dvůr Králové nad Labem,93,28,4,24
9588,5203,Dvůr Králové nad Labem,94,20,4,16
9589,5203,Dvůr Králové nad Labem,95,14,2,12
9590,5203,Dvůr Králové nad Labem,96,8,3,5
9591,5203,Dvůr Králové nad Labem,97,5,0,5
9592,5203,Dvůr Králové nad Labem,98,3,0,3
9593,5203,Dvůr Králové nad Labem,99,1,0,1
9594,5203,Dvůr Králové nad Labem,100,5,1,4
9595,5204,Hořice,0,163,84,79
9596,5204,Hořice,1,176,90,86
9597,5204,Hořice,2,200,105,95
9598,5204,Hořice,3,196,108,88
9599,5204,Hořice,4,183,86,97
9600,5204,Hořice,5,198,102,96
9601,5204,Hořice,6,158,61,97
9602,5204,Hořice,7,168,98,70
9603,5204,Hořice,8,180,82,98
9604,5204,Hořice,9,160,93,67
9605,5204,Hořice,10,185,104,81
9606,5204,Hořice,11,226,107,119
9607,5204,Hořice,12,219,107,112
9608,5204,Hořice,13,247,133,114
9609,5204,Hořice,14,182,98,84
9610,5204,Hořice,15,195,97,98
9611,5204,Hořice,16,164,89,75
9612,5204,Hořice,17,176,90,86
9613,5204,Hořice,18,167,99,68
9614,5204,Hořice,19,161,78,83
9615,5204,Hořice,20,176,92,84
9616,5204,Hořice,21,174,95,79
9617,5204,Hořice,22,192,102,90
9618,5204,Hořice,23,180,100,80
9619,5204,Hořice,24,157,75,82
9620,5204,Hořice,25,211,111,100
9621,5204,Hořice,26,188,103,85
9622,5204,Hořice,27,225,116,109
9623,5204,Hořice,28,194,95,99
9624,5204,Hořice,29,218,102,116
9625,5204,Hořice,30,215,117,98
9626,5204,Hořice,31,220,127,93
9627,5204,Hořice,32,238,119,119
9628,5204,Hořice,33,202,114,88
9629,5204,Hořice,34,215,108,107
9630,5204,Hořice,35,223,111,112
9631,5204,Hořice,36,200,109,91
9632,5204,Hořice,37,226,114,112
9633,5204,Hořice,38,232,112,120
9634,5204,Hořice,39,232,115,117
9635,5204,Hořice,40,243,117,126
9636,5204,Hořice,41,285,148,137
9637,5204,Hořice,42,284,152,132
9638,5204,Hořice,43,322,172,150
9639,5204,Hořice,44,327,174,153
9640,5204,Hořice,45,321,162,159
9641,5204,Hořice,46,313,155,158
9642,5204,Hořice,47,340,166,174
9643,5204,Hořice,48,286,162,124
9644,5204,Hořice,49,274,150,124
9645,5204,Hořice,50,266,140,126
9646,5204,Hořice,51,226,120,106
9647,5204,Hořice,52,193,102,91
9648,5204,Hořice,53,246,134,112
9649,5204,Hořice,54,221,98,123
9650,5204,Hořice,55,238,112,126
9651,5204,Hořice,56,237,117,120
9652,5204,Hořice,57,229,124,105
9653,5204,Hořice,58,231,128,103
9654,5204,Hořice,59,185,90,95
9655,5204,Hořice,60,213,103,110
9656,5204,Hořice,61,205,105,100
9657,5204,Hořice,62,214,107,107
9658,5204,Hořice,63,259,125,134
9659,5204,Hořice,64,244,112,132
9660,5204,Hořice,65,271,126,145
9661,5204,Hořice,66,282,146,136
9662,5204,Hořice,67,248,120,128
9663,5204,Hořice,68,293,147,146
9664,5204,Hořice,69,254,123,131
9665,5204,Hořice,70,232,104,128
9666,5204,Hořice,71,232,91,141
9667,5204,Hořice,72,227,103,124
9668,5204,Hořice,73,236,107,129
9669,5204,Hořice,74,249,107,142
9670,5204,Hořice,75,165,81,84
9671,5204,Hořice,76,207,82,125
9672,5204,Hořice,77,181,69,112
9673,5204,Hořice,78,121,59,62
9674,5204,Hořice,79,106,46,60
9675,5204,Hořice,80,119,54,65
9676,5204,Hořice,81,83,27,56
9677,5204,Hořice,82,79,37,42
9678,5204,Hořice,83,66,23,43
9679,5204,Hořice,84,59,14,45
9680,5204,Hořice,85,65,25,40
9681,5204,Hořice,86,63,19,44
9682,5204,Hořice,87,56,19,37
9683,5204,Hořice,88,51,15,36
9684,5204,Hořice,89,34,10,24
9685,5204,Hořice,90,53,16,37
9686,5204,Hořice,91,28,10,18
9687,5204,Hořice,92,10,2,8
9688,5204,Hořice,93,19,3,16
9689,5204,Hořice,94,17,6,11
9690,5204,Hořice,95,10,0,10
9691,5204,Hořice,96,4,0,4
9692,5204,Hořice,97,6,0,6
9693,5204,Hořice,98,1,0,1
9694,5204,Hořice,99,0,0,0
9695,5204,Hořice,100,3,1,2
9696,5205,Hradec Králové,0,1606,848,758
9697,5205,Hradec Králové,1,1546,841,705
9698,5205,Hradec Králové,2,1567,814,753
9699,5205,Hradec Králové,3,1577,818,759
9700,5205,Hradec Králové,4,1537,794,743
9701,5205,Hradec Králové,5,1529,801,728
9702,5205,Hradec Králové,6,1554,787,767
9703,5205,Hradec Králové,7,1462,718,744
9704,5205,Hradec Králové,8,1471,771,700
9705,5205,Hradec Králové,9,1452,754,698
9706,5205,Hradec Králové,10,1609,835,774
9707,5205,Hradec Králové,11,1678,851,827
9708,5205,Hradec Králové,12,1703,858,845
9709,5205,Hradec Králové,13,1629,825,804
9710,5205,Hradec Králové,14,1504,738,766
9711,5205,Hradec Králové,15,1425,737,688
9712,5205,Hradec Králové,16,1285,685,600
9713,5205,Hradec Králové,17,1244,647,597
9714,5205,Hradec Králové,18,1253,633,620
9715,5205,Hradec Králové,19,1279,647,632
9716,5205,Hradec Králové,20,1255,660,595
9717,5205,Hradec Králové,21,1309,650,659
9718,5205,Hradec Králové,22,1346,730,616
9719,5205,Hradec Králové,23,1305,669,636
9720,5205,Hradec Králové,24,1270,662,608
9721,5205,Hradec Králové,25,1323,690,633
9722,5205,Hradec Králové,26,1479,724,755
9723,5205,Hradec Králové,27,1742,870,872
9724,5205,Hradec Králové,28,1779,906,873
9725,5205,Hradec Králové,29,1944,1012,932
9726,5205,Hradec Králové,30,1865,928,937
9727,5205,Hradec Králové,31,1862,928,934
9728,5205,Hradec Králové,32,1868,937,931
9729,5205,Hradec Králové,33,1939,984,955
9730,5205,Hradec Králové,34,1897,943,954
9731,5205,Hradec Králové,35,1981,1035,946
9732,5205,Hradec Králové,36,1969,991,978
9733,5205,Hradec Králové,37,1933,994,939
9734,5205,Hradec Králové,38,2040,1053,987
9735,5205,Hradec Králové,39,1974,1014,960
9736,5205,Hradec Králové,40,2108,1074,1034
9737,5205,Hradec Králové,41,2281,1119,1162
9738,5205,Hradec Králové,42,2356,1228,1128
9739,5205,Hradec Králové,43,2399,1206,1193
9740,5205,Hradec Králové,44,2561,1295,1266
9741,5205,Hradec Králové,45,2515,1301,1214
9742,5205,Hradec Králové,46,2584,1311,1273
9743,5205,Hradec Králové,47,2368,1233,1135
9744,5205,Hradec Králové,48,2182,1096,1086
9745,5205,Hradec Králové,49,2084,1073,1011
9746,5205,Hradec Králové,50,1980,989,991
9747,5205,Hradec Králové,51,1885,924,961
9748,5205,Hradec Králové,52,1851,938,913
9749,5205,Hradec Králové,53,1717,843,874
9750,5205,Hradec Králové,54,1854,978,876
9751,5205,Hradec Králové,55,1785,908,877
9752,5205,Hradec Králové,56,1897,930,967
9753,5205,Hradec Králové,57,1877,941,936
9754,5205,Hradec Králové,58,1644,792,852
9755,5205,Hradec Králové,59,1514,756,758
9756,5205,Hradec Králové,60,1598,751,847
9757,5205,Hradec Králové,61,1551,741,810
9758,5205,Hradec Králové,62,1733,849,884
9759,5205,Hradec Králové,63,1757,866,891
9760,5205,Hradec Králové,64,1989,941,1048
9761,5205,Hradec Králové,65,2003,940,1063
9762,5205,Hradec Králové,66,1984,906,1078
9763,5205,Hradec Králové,67,1977,918,1059
9764,5205,Hradec Králové,68,1903,833,1070
9765,5205,Hradec Králové,69,1893,852,1041
9766,5205,Hradec Králové,70,1824,838,986
9767,5205,Hradec Králové,71,1756,760,996
9768,5205,Hradec Králové,72,1808,770,1038
9769,5205,Hradec Králové,73,1876,818,1058
9770,5205,Hradec Králové,74,1847,770,1077
9771,5205,Hradec Králové,75,1447,616,831
9772,5205,Hradec Králové,76,1488,633,855
9773,5205,Hradec Králové,77,1439,607,832
9774,5205,Hradec Králové,78,1164,456,708
9775,5205,Hradec Králové,79,1068,432,636
9776,5205,Hradec Králové,80,964,380,584
9777,5205,Hradec Králové,81,846,313,533
9778,5205,Hradec Králové,82,797,298,499
9779,5205,Hradec Králové,83,684,267,417
9780,5205,Hradec Králové,84,657,235,422
9781,5205,Hradec Králové,85,583,211,372
9782,5205,Hradec Králové,86,513,189,324
9783,5205,Hradec Králové,87,494,185,309
9784,5205,Hradec Králové,88,428,140,288
9785,5205,Hradec Králové,89,405,127,278
9786,5205,Hradec Králové,90,292,104,188
9787,5205,Hradec Králové,91,228,74,154
9788,5205,Hradec Králové,92,184,56,128
9789,5205,Hradec Králové,93,125,32,93
9790,5205,Hradec Králové,94,96,25,71
9791,5205,Hradec Králové,95,74,22,52
9792,5205,Hradec Králové,96,34,9,25
9793,5205,Hradec Králové,97,25,7,18
9794,5205,Hradec Králové,98,21,5,16
9795,5205,Hradec Králové,99,17,4,13
9796,5205,Hradec Králové,100,14,5,9
9797,5206,Jaroměř,0,196,107,89
9798,5206,Jaroměř,1,216,111,105
9799,5206,Jaroměř,2,233,120,113
9800,5206,Jaroměř,3,205,110,95
9801,5206,Jaroměř,4,227,117,110
9802,5206,Jaroměř,5,200,97,103
9803,5206,Jaroměř,6,182,98,84
9804,5206,Jaroměř,7,219,118,101
9805,5206,Jaroměř,8,207,100,107
9806,5206,Jaroměř,9,169,88,81
9807,5206,Jaroměř,10,208,110,98
9808,5206,Jaroměř,11,238,126,112
9809,5206,Jaroměř,12,206,112,94
9810,5206,Jaroměř,13,239,118,121
9811,5206,Jaroměř,14,174,95,79
9812,5206,Jaroměř,15,208,105,103
9813,5206,Jaroměř,16,189,98,91
9814,5206,Jaroměř,17,207,104,103
9815,5206,Jaroměř,18,191,97,94
9816,5206,Jaroměř,19,206,109,97
9817,5206,Jaroměř,20,223,118,105
9818,5206,Jaroměř,21,203,100,103
9819,5206,Jaroměř,22,177,90,87
9820,5206,Jaroměř,23,205,116,89
9821,5206,Jaroměř,24,204,103,101
9822,5206,Jaroměř,25,215,113,102
9823,5206,Jaroměř,26,221,115,106
9824,5206,Jaroměř,27,266,138,128
9825,5206,Jaroměř,28,221,101,120
9826,5206,Jaroměř,29,230,130,100
9827,5206,Jaroměř,30,249,122,127
9828,5206,Jaroměř,31,253,142,111
9829,5206,Jaroměř,32,244,126,118
9830,5206,Jaroměř,33,216,109,107
9831,5206,Jaroměř,34,233,135,98
9832,5206,Jaroměř,35,246,134,112
9833,5206,Jaroměř,36,253,132,121
9834,5206,Jaroměř,37,231,123,108
9835,5206,Jaroměř,38,268,123,145
9836,5206,Jaroměř,39,264,148,116
9837,5206,Jaroměř,40,288,174,114
9838,5206,Jaroměř,41,295,161,134
9839,5206,Jaroměř,42,310,169,141
9840,5206,Jaroměř,43,298,152,146
9841,5206,Jaroměř,44,368,179,189
9842,5206,Jaroměř,45,291,150,141
9843,5206,Jaroměř,46,355,180,175
9844,5206,Jaroměř,47,327,153,174
9845,5206,Jaroměř,48,291,139,152
9846,5206,Jaroměř,49,272,132,140
9847,5206,Jaroměř,50,267,140,127
9848,5206,Jaroměř,51,252,127,125
9849,5206,Jaroměř,52,262,137,125
9850,5206,Jaroměř,53,254,133,121
9851,5206,Jaroměř,54,226,114,112
9852,5206,Jaroměř,55,235,129,106
9853,5206,Jaroměř,56,257,124,133
9854,5206,Jaroměř,57,239,113,126
9855,5206,Jaroměř,58,230,110,120
9856,5206,Jaroměř,59,228,124,104
9857,5206,Jaroměř,60,179,87,92
9858,5206,Jaroměř,61,243,131,112
9859,5206,Jaroměř,62,212,107,105
9860,5206,Jaroměř,63,242,142,100
9861,5206,Jaroměř,64,249,124,125
9862,5206,Jaroměř,65,244,117,127
9863,5206,Jaroměř,66,264,117,147
9864,5206,Jaroměř,67,247,112,135
9865,5206,Jaroměř,68,248,113,135
9866,5206,Jaroměř,69,247,106,141
9867,5206,Jaroměř,70,204,87,117
9868,5206,Jaroměř,71,233,101,132
9869,5206,Jaroměř,72,232,85,147
9870,5206,Jaroměř,73,207,98,109
9871,5206,Jaroměř,74,196,91,105
9872,5206,Jaroměř,75,170,72,98
9873,5206,Jaroměř,76,190,75,115
9874,5206,Jaroměř,77,143,62,81
9875,5206,Jaroměř,78,126,46,80
9876,5206,Jaroměř,79,121,43,78
9877,5206,Jaroměř,80,86,29,57
9878,5206,Jaroměř,81,80,36,44
9879,5206,Jaroměř,82,83,31,52
9880,5206,Jaroměř,83,74,23,51
9881,5206,Jaroměř,84,61,28,33
9882,5206,Jaroměř,85,53,19,34
9883,5206,Jaroměř,86,62,16,46
9884,5206,Jaroměř,87,54,21,33
9885,5206,Jaroměř,88,47,18,29
9886,5206,Jaroměř,89,37,9,28
9887,5206,Jaroměř,90,33,8,25
9888,5206,Jaroměř,91,19,6,13
9889,5206,Jaroměř,92,15,2,13
9890,5206,Jaroměř,93,14,2,12
9891,5206,Jaroměř,94,5,1,4
9892,5206,Jaroměř,95,7,2,5
9893,5206,Jaroměř,96,7,2,5
9894,5206,Jaroměř,97,4,2,2
9895,5206,Jaroměř,98,3,0,3
9896,5206,Jaroměř,99,1,1,0
9897,5206,Jaroměř,100,3,1,2
9898,5207,Jičín,0,513,260,253
9899,5207,Jičín,1,464,224,240
9900,5207,Jičín,2,481,254,227
9901,5207,Jičín,3,510,253,257
9902,5207,Jičín,4,483,248,235
9903,5207,Jičín,5,535,286,249
9904,5207,Jičín,6,465,259,206
9905,5207,Jičín,7,483,247,236
9906,5207,Jičín,8,483,254,229
9907,5207,Jičín,9,508,266,242
9908,5207,Jičín,10,557,290,267
9909,5207,Jičín,11,544,292,252
9910,5207,Jičín,12,572,310,262
9911,5207,Jičín,13,551,288,263
9912,5207,Jičín,14,484,248,236
9913,5207,Jičín,15,465,238,227
9914,5207,Jičín,16,462,249,213
9915,5207,Jičín,17,445,223,222
9916,5207,Jičín,18,451,223,228
9917,5207,Jičín,19,416,204,212
9918,5207,Jičín,20,453,235,218
9919,5207,Jičín,21,415,217,198
9920,5207,Jičín,22,415,207,208
9921,5207,Jičín,23,425,219,206
9922,5207,Jičín,24,415,217,198
9923,5207,Jičín,25,510,274,236
9924,5207,Jičín,26,541,292,249
9925,5207,Jičín,27,568,280,288
9926,5207,Jičín,28,615,333,282
9927,5207,Jičín,29,631,323,308
9928,5207,Jičín,30,558,292,266
9929,5207,Jičín,31,613,316,297
9930,5207,Jičín,32,583,285,298
9931,5207,Jičín,33,622,337,285
9932,5207,Jičín,34,595,330,265
9933,5207,Jičín,35,655,341,314
9934,5207,Jičín,36,649,333,316
9935,5207,Jičín,37,690,376,314
9936,5207,Jičín,38,657,323,334
9937,5207,Jičín,39,672,354,318
9938,5207,Jičín,40,710,384,326
9939,5207,Jičín,41,778,440,338
9940,5207,Jičín,42,855,433,422
9941,5207,Jičín,43,829,432,397
9942,5207,Jičín,44,847,442,405
9943,5207,Jičín,45,867,463,404
9944,5207,Jičín,46,864,452,412
9945,5207,Jičín,47,841,421,420
9946,5207,Jičín,48,743,372,371
9947,5207,Jičín,49,663,354,309
9948,5207,Jičín,50,605,296,309
9949,5207,Jičín,51,662,337,325
9950,5207,Jičín,52,596,301,295
9951,5207,Jičín,53,605,317,288
9952,5207,Jičín,54,601,297,304
9953,5207,Jičín,55,603,300,303
9954,5207,Jičín,56,667,354,313
9955,5207,Jičín,57,617,320,297
9956,5207,Jičín,58,549,265,284
9957,5207,Jičín,59,603,300,303
9958,5207,Jičín,60,575,283,292
9959,5207,Jičín,61,516,265,251
9960,5207,Jičín,62,563,287,276
9961,5207,Jičín,63,669,340,329
9962,5207,Jičín,64,616,291,325
9963,5207,Jičín,65,708,325,383
9964,5207,Jičín,66,722,367,355
9965,5207,Jičín,67,680,332,348
9966,5207,Jičín,68,704,336,368
9967,5207,Jičín,69,616,308,308
9968,5207,Jičín,70,617,282,335
9969,5207,Jičín,71,597,263,334
9970,5207,Jičín,72,600,270,330
9971,5207,Jičín,73,602,262,340
9972,5207,Jičín,74,538,235,303
9973,5207,Jičín,75,431,179,252
9974,5207,Jičín,76,419,169,250
9975,5207,Jičín,77,379,156,223
9976,5207,Jičín,78,302,128,174
9977,5207,Jičín,79,266,90,176
9978,5207,Jičín,80,283,115,168
9979,5207,Jičín,81,241,84,157
9980,5207,Jičín,82,213,77,136
9981,5207,Jičín,83,190,69,121
9982,5207,Jičín,84,191,76,115
9983,5207,Jičín,85,170,48,122
9984,5207,Jičín,86,148,65,83
9985,5207,Jičín,87,133,45,88
9986,5207,Jičín,88,125,50,75
9987,5207,Jičín,89,100,29,71
9988,5207,Jičín,90,111,23,88
9989,5207,Jičín,91,55,16,39
9990,5207,Jičín,92,51,11,40
9991,5207,Jičín,93,26,7,19
9992,5207,Jičín,94,26,4,22
9993,5207,Jičín,95,27,4,23
9994,5207,Jičín,96,5,2,3
9995,5207,Jičín,97,6,2,4
9996,5207,Jičín,98,6,2,4
9997,5207,Jičín,99,4,2,2
9998,5207,Jičín,100,3,1,2
9999,5208,Kostelec nad Orlicí,0,247,129,118
10000,5208,Kostelec nad Orlicí,1,243,124,119
10001,5208,Kostelec nad Orlicí,2,254,126,128
10002,5208,Kostelec nad Orlicí,3,285,142,143
10003,5208,Kostelec nad Orlicí,4,242,127,115
10004,5208,Kostelec nad Orlicí,5,262,123,139
10005,5208,Kostelec nad Orlicí,6,247,117,130
10006,5208,Kostelec nad Orlicí,7,255,117,138
10007,5208,Kostelec nad Orlicí,8,236,115,121
10008,5208,Kostelec nad Orlicí,9,220,102,118
10009,5208,Kostelec nad Orlicí,10,286,162,124
10010,5208,Kostelec nad Orlicí,11,283,130,153
10011,5208,Kostelec nad Orlicí,12,274,141,133
10012,5208,Kostelec nad Orlicí,13,281,147,134
10013,5208,Kostelec nad Orlicí,14,270,138,132
10014,5208,Kostelec nad Orlicí,15,244,118,126
10015,5208,Kostelec nad Orlicí,16,278,134,144
10016,5208,Kostelec nad Orlicí,17,258,134,124
10017,5208,Kostelec nad Orlicí,18,219,116,103
10018,5208,Kostelec nad Orlicí,19,219,126,93
10019,5208,Kostelec nad Orlicí,20,243,132,111
10020,5208,Kostelec nad Orlicí,21,228,117,111
10021,5208,Kostelec nad Orlicí,22,234,134,100
10022,5208,Kostelec nad Orlicí,23,250,135,115
10023,5208,Kostelec nad Orlicí,24,218,112,106
10024,5208,Kostelec nad Orlicí,25,219,102,117
10025,5208,Kostelec nad Orlicí,26,269,133,136
10026,5208,Kostelec nad Orlicí,27,299,143,156
10027,5208,Kostelec nad Orlicí,28,332,185,147
10028,5208,Kostelec nad Orlicí,29,323,177,146
10029,5208,Kostelec nad Orlicí,30,302,159,143
10030,5208,Kostelec nad Orlicí,31,301,167,134
10031,5208,Kostelec nad Orlicí,32,327,181,146
10032,5208,Kostelec nad Orlicí,33,294,152,142
10033,5208,Kostelec nad Orlicí,34,335,165,170
10034,5208,Kostelec nad Orlicí,35,338,171,167
10035,5208,Kostelec nad Orlicí,36,346,164,182
10036,5208,Kostelec nad Orlicí,37,318,167,151
10037,5208,Kostelec nad Orlicí,38,338,197,141
10038,5208,Kostelec nad Orlicí,39,321,176,145
10039,5208,Kostelec nad Orlicí,40,343,172,171
10040,5208,Kostelec nad Orlicí,41,371,189,182
10041,5208,Kostelec nad Orlicí,42,426,221,205
10042,5208,Kostelec nad Orlicí,43,426,247,179
10043,5208,Kostelec nad Orlicí,44,429,231,198
10044,5208,Kostelec nad Orlicí,45,449,235,214
10045,5208,Kostelec nad Orlicí,46,479,234,245
10046,5208,Kostelec nad Orlicí,47,419,222,197
10047,5208,Kostelec nad Orlicí,48,380,191,189
10048,5208,Kostelec nad Orlicí,49,386,216,170
10049,5208,Kostelec nad Orlicí,50,346,165,181
10050,5208,Kostelec nad Orlicí,51,362,195,167
10051,5208,Kostelec nad Orlicí,52,306,169,137
10052,5208,Kostelec nad Orlicí,53,314,166,148
10053,5208,Kostelec nad Orlicí,54,292,143,149
10054,5208,Kostelec nad Orlicí,55,321,154,167
10055,5208,Kostelec nad Orlicí,56,318,167,151
10056,5208,Kostelec nad Orlicí,57,342,181,161
10057,5208,Kostelec nad Orlicí,58,267,142,125
10058,5208,Kostelec nad Orlicí,59,306,161,145
10059,5208,Kostelec nad Orlicí,60,253,130,123
10060,5208,Kostelec nad Orlicí,61,286,151,135
10061,5208,Kostelec nad Orlicí,62,270,131,139
10062,5208,Kostelec nad Orlicí,63,294,137,157
10063,5208,Kostelec nad Orlicí,64,328,156,172
10064,5208,Kostelec nad Orlicí,65,308,175,133
10065,5208,Kostelec nad Orlicí,66,319,146,173
10066,5208,Kostelec nad Orlicí,67,335,154,181
10067,5208,Kostelec nad Orlicí,68,329,155,174
10068,5208,Kostelec nad Orlicí,69,303,138,165
10069,5208,Kostelec nad Orlicí,70,359,158,201
10070,5208,Kostelec nad Orlicí,71,288,130,158
10071,5208,Kostelec nad Orlicí,72,320,147,173
10072,5208,Kostelec nad Orlicí,73,315,134,181
10073,5208,Kostelec nad Orlicí,74,265,120,145
10074,5208,Kostelec nad Orlicí,75,250,114,136
10075,5208,Kostelec nad Orlicí,76,261,113,148
10076,5208,Kostelec nad Orlicí,77,238,102,136
10077,5208,Kostelec nad Orlicí,78,179,73,106
10078,5208,Kostelec nad Orlicí,79,143,46,97
10079,5208,Kostelec nad Orlicí,80,165,69,96
10080,5208,Kostelec nad Orlicí,81,137,45,92
10081,5208,Kostelec nad Orlicí,82,118,43,75
10082,5208,Kostelec nad Orlicí,83,106,29,77
10083,5208,Kostelec nad Orlicí,84,92,33,59
10084,5208,Kostelec nad Orlicí,85,87,38,49
10085,5208,Kostelec nad Orlicí,86,87,26,61
10086,5208,Kostelec nad Orlicí,87,71,26,45
10087,5208,Kostelec nad Orlicí,88,67,26,41
10088,5208,Kostelec nad Orlicí,89,56,16,40
10089,5208,Kostelec nad Orlicí,90,55,16,39
10090,5208,Kostelec nad Orlicí,91,31,6,25
10091,5208,Kostelec nad Orlicí,92,28,4,24
10092,5208,Kostelec nad Orlicí,93,30,6,24
10093,5208,Kostelec nad Orlicí,94,14,2,12
10094,5208,Kostelec nad Orlicí,95,8,2,6
10095,5208,Kostelec nad Orlicí,96,5,2,3
10096,5208,Kostelec nad Orlicí,97,3,1,2
10097,5208,Kostelec nad Orlicí,98,2,0,2
10098,5208,Kostelec nad Orlicí,99,3,1,2
10099,5208,Kostelec nad Orlicí,100,4,0,4
10100,5209,Náchod,0,558,296,262
10101,5209,Náchod,1,625,319,306
10102,5209,Náchod,2,591,291,300
10103,5209,Náchod,3,586,311,275
10104,5209,Náchod,4,568,292,276
10105,5209,Náchod,5,609,314,295
10106,5209,Náchod,6,588,305,283
10107,5209,Náchod,7,600,300,300
10108,5209,Náchod,8,574,294,280
10109,5209,Náchod,9,623,339,284
10110,5209,Náchod,10,638,344,294
10111,5209,Náchod,11,739,374,365
10112,5209,Náchod,12,733,361,372
10113,5209,Náchod,13,676,361,315
10114,5209,Náchod,14,626,321,305
10115,5209,Náchod,15,589,310,279
10116,5209,Náchod,16,584,308,276
10117,5209,Náchod,17,579,290,289
10118,5209,Náchod,18,573,291,282
10119,5209,Náchod,19,535,287,248
10120,5209,Náchod,20,578,294,284
10121,5209,Náchod,21,550,277,273
10122,5209,Náchod,22,610,336,274
10123,5209,Náchod,23,564,297,267
10124,5209,Náchod,24,634,307,327
10125,5209,Náchod,25,601,327,274
10126,5209,Náchod,26,630,322,308
10127,5209,Náchod,27,666,331,335
10128,5209,Náchod,28,683,353,330
10129,5209,Náchod,29,731,362,369
10130,5209,Náchod,30,713,364,349
10131,5209,Náchod,31,735,377,358
10132,5209,Náchod,32,779,414,365
10133,5209,Náchod,33,672,342,330
10134,5209,Náchod,34,726,377,349
10135,5209,Náchod,35,736,387,349
10136,5209,Náchod,36,737,398,339
10137,5209,Náchod,37,728,390,338
10138,5209,Náchod,38,738,376,362
10139,5209,Náchod,39,695,349,346
10140,5209,Náchod,40,820,419,401
10141,5209,Náchod,41,877,431,446
10142,5209,Náchod,42,937,460,477
10143,5209,Náchod,43,983,479,504
10144,5209,Náchod,44,1001,512,489
10145,5209,Náchod,45,1010,487,523
10146,5209,Náchod,46,1082,552,530
10147,5209,Náchod,47,995,505,490
10148,5209,Náchod,48,837,403,434
10149,5209,Náchod,49,903,487,416
10150,5209,Náchod,50,850,421,429
10151,5209,Náchod,51,846,414,432
10152,5209,Náchod,52,726,369,357
10153,5209,Náchod,53,730,382,348
10154,5209,Náchod,54,781,393,388
10155,5209,Náchod,55,840,438,402
10156,5209,Náchod,56,821,399,422
10157,5209,Náchod,57,751,374,377
10158,5209,Náchod,58,742,365,377
10159,5209,Náchod,59,667,344,323
10160,5209,Náchod,60,661,318,343
10161,5209,Náchod,61,721,333,388
10162,5209,Náchod,62,727,345,382
10163,5209,Náchod,63,782,398,384
10164,5209,Náchod,64,862,403,459
10165,5209,Náchod,65,810,377,433
10166,5209,Náchod,66,835,387,448
10167,5209,Náchod,67,809,403,406
10168,5209,Náchod,68,825,385,440
10169,5209,Náchod,69,796,363,433
10170,5209,Náchod,70,805,377,428
10171,5209,Náchod,71,724,333,391
10172,5209,Náchod,72,744,338,406
10173,5209,Náchod,73,789,346,443
10174,5209,Náchod,74,729,328,401
10175,5209,Náchod,75,624,271,353
10176,5209,Náchod,76,622,255,367
10177,5209,Náchod,77,593,248,345
10178,5209,Náchod,78,503,205,298
10179,5209,Náchod,79,468,197,271
10180,5209,Náchod,80,359,144,215
10181,5209,Náchod,81,375,150,225
10182,5209,Náchod,82,321,127,194
10183,5209,Náchod,83,271,110,161
10184,5209,Náchod,84,238,97,141
10185,5209,Náchod,85,234,71,163
10186,5209,Náchod,86,217,69,148
10187,5209,Náchod,87,200,72,128
10188,5209,Náchod,88,164,50,114
10189,5209,Náchod,89,146,46,100
10190,5209,Náchod,90,148,48,100
10191,5209,Náchod,91,99,28,71
10192,5209,Náchod,92,76,21,55
10193,5209,Náchod,93,45,15,30
10194,5209,Náchod,94,39,12,27
10195,5209,Náchod,95,34,7,27
10196,5209,Náchod,96,19,2,17
10197,5209,Náchod,97,10,1,9
10198,5209,Náchod,98,11,1,10
10199,5209,Náchod,99,3,1,2
10200,5209,Náchod,100,5,1,4
10201,5210,Nová Paka,0,137,65,72
10202,5210,Nová Paka,1,149,69,80
10203,5210,Nová Paka,2,153,76,77
10204,5210,Nová Paka,3,135,70,65
10205,5210,Nová Paka,4,129,60,69
10206,5210,Nová Paka,5,143,66,77
10207,5210,Nová Paka,6,116,68,48
10208,5210,Nová Paka,7,130,60,70
10209,5210,Nová Paka,8,115,65,50
10210,5210,Nová Paka,9,123,61,62
10211,5210,Nová Paka,10,137,77,60
10212,5210,Nová Paka,11,147,70,77
10213,5210,Nová Paka,12,135,68,67
10214,5210,Nová Paka,13,146,74,72
10215,5210,Nová Paka,14,127,59,68
10216,5210,Nová Paka,15,149,69,80
10217,5210,Nová Paka,16,122,66,56
10218,5210,Nová Paka,17,119,64,55
10219,5210,Nová Paka,18,111,48,63
10220,5210,Nová Paka,19,116,64,52
10221,5210,Nová Paka,20,101,53,48
10222,5210,Nová Paka,21,112,59,53
10223,5210,Nová Paka,22,120,58,62
10224,5210,Nová Paka,23,130,66,64
10225,5210,Nová Paka,24,122,59,63
10226,5210,Nová Paka,25,134,69,65
10227,5210,Nová Paka,26,148,81,67
10228,5210,Nová Paka,27,150,85,65
10229,5210,Nová Paka,28,165,92,73
10230,5210,Nová Paka,29,157,85,72
10231,5210,Nová Paka,30,180,93,87
10232,5210,Nová Paka,31,172,89,83
10233,5210,Nová Paka,32,162,85,77
10234,5210,Nová Paka,33,179,83,96
10235,5210,Nová Paka,34,151,76,75
10236,5210,Nová Paka,35,200,91,109
10237,5210,Nová Paka,36,170,96,74
10238,5210,Nová Paka,37,164,88,76
10239,5210,Nová Paka,38,174,94,80
10240,5210,Nová Paka,39,152,76,76
10241,5210,Nová Paka,40,177,95,82
10242,5210,Nová Paka,41,172,103,69
10243,5210,Nová Paka,42,203,105,98
10244,5210,Nová Paka,43,239,126,113
10245,5210,Nová Paka,44,208,107,101
10246,5210,Nová Paka,45,236,120,116
10247,5210,Nová Paka,46,229,113,116
10248,5210,Nová Paka,47,198,104,94
10249,5210,Nová Paka,48,185,97,88
10250,5210,Nová Paka,49,192,92,100
10251,5210,Nová Paka,50,169,91,78
10252,5210,Nová Paka,51,167,99,68
10253,5210,Nová Paka,52,159,82,77
10254,5210,Nová Paka,53,152,82,70
10255,5210,Nová Paka,54,187,98,89
10256,5210,Nová Paka,55,192,89,103
10257,5210,Nová Paka,56,216,108,108
10258,5210,Nová Paka,57,185,86,99
10259,5210,Nová Paka,58,191,106,85
10260,5210,Nová Paka,59,173,91,82
10261,5210,Nová Paka,60,160,76,84
10262,5210,Nová Paka,61,164,84,80
10263,5210,Nová Paka,62,155,80,75
10264,5210,Nová Paka,63,211,99,112
10265,5210,Nová Paka,64,166,92,74
10266,5210,Nová Paka,65,169,78,91
10267,5210,Nová Paka,66,156,73,83
10268,5210,Nová Paka,67,154,77,77
10269,5210,Nová Paka,68,161,62,99
10270,5210,Nová Paka,69,155,81,74
10271,5210,Nová Paka,70,170,61,109
10272,5210,Nová Paka,71,177,92,85
10273,5210,Nová Paka,72,178,89,89
10274,5210,Nová Paka,73,154,69,85
10275,5210,Nová Paka,74,161,68,93
10276,5210,Nová Paka,75,133,52,81
10277,5210,Nová Paka,76,148,60,88
10278,5210,Nová Paka,77,116,51,65
10279,5210,Nová Paka,78,105,43,62
10280,5210,Nová Paka,79,107,35,72
10281,5210,Nová Paka,80,85,31,54
10282,5210,Nová Paka,81,74,27,47
10283,5210,Nová Paka,82,70,26,44
10284,5210,Nová Paka,83,67,22,45
10285,5210,Nová Paka,84,46,18,28
10286,5210,Nová Paka,85,62,23,39
10287,5210,Nová Paka,86,48,14,34
10288,5210,Nová Paka,87,44,18,26
10289,5210,Nová Paka,88,43,17,26
10290,5210,Nová Paka,89,23,8,15
10291,5210,Nová Paka,90,23,8,15
10292,5210,Nová Paka,91,27,11,16
10293,5210,Nová Paka,92,18,1,17
10294,5210,Nová Paka,93,11,2,9
10295,5210,Nová Paka,94,13,7,6
10296,5210,Nová Paka,95,8,2,6
10297,5210,Nová Paka,96,2,0,2
10298,5210,Nová Paka,97,4,1,3
10299,5210,Nová Paka,98,2,0,2
10300,5210,Nová Paka,99,2,0,2
10301,5210,Nová Paka,100,3,0,3
10302,5211,Nové Město nad Metují,0,125,74,51
10303,5211,Nové Město nad Metují,1,112,70,42
10304,5211,Nové Město nad Metují,2,154,79,75
10305,5211,Nové Město nad Metují,3,141,70,71
10306,5211,Nové Město nad Metují,4,130,67,63
10307,5211,Nové Město nad Metují,5,129,68,61
10308,5211,Nové Město nad Metují,6,126,59,67
10309,5211,Nové Město nad Metují,7,140,73,67
10310,5211,Nové Město nad Metují,8,123,69,54
10311,5211,Nové Město nad Metují,9,131,70,61
10312,5211,Nové Město nad Metují,10,166,89,77
10313,5211,Nové Město nad Metují,11,164,79,85
10314,5211,Nové Město nad Metují,12,182,96,86
10315,5211,Nové Město nad Metují,13,138,71,67
10316,5211,Nové Město nad Metují,14,160,77,83
10317,5211,Nové Město nad Metují,15,138,78,60
10318,5211,Nové Město nad Metují,16,135,61,74
10319,5211,Nové Město nad Metují,17,156,86,70
10320,5211,Nové Město nad Metují,18,114,62,52
10321,5211,Nové Město nad Metují,19,132,59,73
10322,5211,Nové Město nad Metují,20,129,65,64
10323,5211,Nové Město nad Metují,21,131,68,63
10324,5211,Nové Město nad Metují,22,121,66,55
10325,5211,Nové Město nad Metují,23,144,71,73
10326,5211,Nové Město nad Metují,24,145,78,67
10327,5211,Nové Město nad Metují,25,128,72,56
10328,5211,Nové Město nad Metují,26,113,59,54
10329,5211,Nové Město nad Metují,27,172,88,84
10330,5211,Nové Město nad Metují,28,154,82,72
10331,5211,Nové Město nad Metují,29,186,97,89
10332,5211,Nové Město nad Metují,30,165,89,76
10333,5211,Nové Město nad Metují,31,157,79,78
10334,5211,Nové Město nad Metují,32,167,82,85
10335,5211,Nové Město nad Metují,33,169,92,77
10336,5211,Nové Město nad Metují,34,186,103,83
10337,5211,Nové Město nad Metují,35,180,88,92
10338,5211,Nové Město nad Metují,36,162,79,83
10339,5211,Nové Město nad Metují,37,152,72,80
10340,5211,Nové Město nad Metují,38,168,84,84
10341,5211,Nové Město nad Metují,39,170,82,88
10342,5211,Nové Město nad Metují,40,187,92,95
10343,5211,Nové Město nad Metují,41,221,118,103
10344,5211,Nové Město nad Metují,42,187,99,88
10345,5211,Nové Město nad Metují,43,226,122,104
10346,5211,Nové Město nad Metují,44,253,135,118
10347,5211,Nové Město nad Metují,45,218,107,111
10348,5211,Nové Město nad Metují,46,271,124,147
10349,5211,Nové Město nad Metují,47,225,119,106
10350,5211,Nové Město nad Metují,48,231,128,103
10351,5211,Nové Město nad Metují,49,182,95,87
10352,5211,Nové Město nad Metují,50,195,97,98
10353,5211,Nové Město nad Metují,51,174,79,95
10354,5211,Nové Město nad Metují,52,165,77,88
10355,5211,Nové Město nad Metují,53,192,101,91
10356,5211,Nové Město nad Metují,54,170,83,87
10357,5211,Nové Město nad Metují,55,207,101,106
10358,5211,Nové Město nad Metují,56,206,105,101
10359,5211,Nové Město nad Metují,57,195,93,102
10360,5211,Nové Město nad Metují,58,167,79,88
10361,5211,Nové Město nad Metují,59,183,98,85
10362,5211,Nové Město nad Metují,60,162,92,70
10363,5211,Nové Město nad Metují,61,149,72,77
10364,5211,Nové Město nad Metují,62,169,89,80
10365,5211,Nové Město nad Metují,63,162,92,70
10366,5211,Nové Město nad Metují,64,184,91,93
10367,5211,Nové Město nad Metují,65,183,81,102
10368,5211,Nové Město nad Metují,66,216,100,116
10369,5211,Nové Město nad Metují,67,180,84,96
10370,5211,Nové Město nad Metují,68,197,103,94
10371,5211,Nové Město nad Metují,69,207,83,124
10372,5211,Nové Město nad Metují,70,218,97,121
10373,5211,Nové Město nad Metují,71,187,98,89
10374,5211,Nové Město nad Metují,72,169,79,90
10375,5211,Nové Město nad Metují,73,173,81,92
10376,5211,Nové Město nad Metují,74,177,75,102
10377,5211,Nové Město nad Metují,75,154,63,91
10378,5211,Nové Město nad Metují,76,152,63,89
10379,5211,Nové Město nad Metují,77,153,59,94
10380,5211,Nové Město nad Metují,78,123,45,78
10381,5211,Nové Město nad Metují,79,110,49,61
10382,5211,Nové Město nad Metují,80,112,40,72
10383,5211,Nové Město nad Metují,81,65,24,41
10384,5211,Nové Město nad Metují,82,77,35,42
10385,5211,Nové Město nad Metují,83,81,31,50
10386,5211,Nové Město nad Metují,84,74,28,46
10387,5211,Nové Město nad Metují,85,49,18,31
10388,5211,Nové Město nad Metují,86,56,14,42
10389,5211,Nové Město nad Metují,87,50,18,32
10390,5211,Nové Město nad Metují,88,36,13,23
10391,5211,Nové Město nad Metují,89,29,10,19
10392,5211,Nové Město nad Metují,90,36,13,23
10393,5211,Nové Město nad Metují,91,21,8,13
10394,5211,Nové Město nad Metují,92,23,6,17
10395,5211,Nové Město nad Metují,93,11,5,6
10396,5211,Nové Město nad Metují,94,4,1,3
10397,5211,Nové Město nad Metují,95,5,2,3
10398,5211,Nové Město nad Metují,96,3,1,2
10399,5211,Nové Město nad Metují,97,5,2,3
10400,5211,Nové Město nad Metují,98,1,0,1
10401,5211,Nové Město nad Metují,99,1,0,1
10402,5211,Nové Město nad Metují,100,2,0,2
10403,5212,Nový Bydžov,0,169,90,79
10404,5212,Nový Bydžov,1,165,77,88
10405,5212,Nový Bydžov,2,166,86,80
10406,5212,Nový Bydžov,3,163,81,82
10407,5212,Nový Bydžov,4,171,83,88
10408,5212,Nový Bydžov,5,153,83,70
10409,5212,Nový Bydžov,6,155,76,79
10410,5212,Nový Bydžov,7,187,89,98
10411,5212,Nový Bydžov,8,155,87,68
10412,5212,Nový Bydžov,9,163,89,74
10413,5212,Nový Bydžov,10,192,87,105
10414,5212,Nový Bydžov,11,199,93,106
10415,5212,Nový Bydžov,12,194,107,87
10416,5212,Nový Bydžov,13,218,103,115
10417,5212,Nový Bydžov,14,176,103,73
10418,5212,Nový Bydžov,15,167,82,85
10419,5212,Nový Bydžov,16,165,73,92
10420,5212,Nový Bydžov,17,141,73,68
10421,5212,Nový Bydžov,18,161,84,77
10422,5212,Nový Bydžov,19,144,80,64
10423,5212,Nový Bydžov,20,148,73,75
10424,5212,Nový Bydžov,21,176,96,80
10425,5212,Nový Bydžov,22,165,99,66
10426,5212,Nový Bydžov,23,163,78,85
10427,5212,Nový Bydžov,24,195,102,93
10428,5212,Nový Bydžov,25,199,99,100
10429,5212,Nový Bydžov,26,237,125,112
10430,5212,Nový Bydžov,27,216,110,106
10431,5212,Nový Bydžov,28,250,130,120
10432,5212,Nový Bydžov,29,216,129,87
10433,5212,Nový Bydžov,30,199,104,95
10434,5212,Nový Bydžov,31,203,118,85
10435,5212,Nový Bydžov,32,223,119,104
10436,5212,Nový Bydžov,33,219,126,93
10437,5212,Nový Bydžov,34,224,114,110
10438,5212,Nový Bydžov,35,238,132,106
10439,5212,Nový Bydžov,36,204,100,104
10440,5212,Nový Bydžov,37,200,101,99
10441,5212,Nový Bydžov,38,197,98,99
10442,5212,Nový Bydžov,39,234,125,109
10443,5212,Nový Bydžov,40,228,121,107
10444,5212,Nový Bydžov,41,270,130,140
10445,5212,Nový Bydžov,42,293,144,149
10446,5212,Nový Bydžov,43,298,166,132
10447,5212,Nový Bydžov,44,311,171,140
10448,5212,Nový Bydžov,45,296,153,143
10449,5212,Nový Bydžov,46,298,149,149
10450,5212,Nový Bydžov,47,280,144,136
10451,5212,Nový Bydžov,48,271,132,139
10452,5212,Nový Bydžov,49,289,154,135
10453,5212,Nový Bydžov,50,232,122,110
10454,5212,Nový Bydžov,51,230,111,119
10455,5212,Nový Bydžov,52,228,104,124
10456,5212,Nový Bydžov,53,238,130,108
10457,5212,Nový Bydžov,54,221,109,112
10458,5212,Nový Bydžov,55,226,106,120
10459,5212,Nový Bydžov,56,215,114,101
10460,5212,Nový Bydžov,57,223,106,117
10461,5212,Nový Bydžov,58,244,132,112
10462,5212,Nový Bydžov,59,216,99,117
10463,5212,Nový Bydžov,60,204,107,97
10464,5212,Nový Bydžov,61,195,96,99
10465,5212,Nový Bydžov,62,222,107,115
10466,5212,Nový Bydžov,63,233,112,121
10467,5212,Nový Bydžov,64,245,131,114
10468,5212,Nový Bydžov,65,264,125,139
10469,5212,Nový Bydžov,66,232,107,125
10470,5212,Nový Bydžov,67,242,110,132
10471,5212,Nový Bydžov,68,223,106,117
10472,5212,Nový Bydžov,69,222,116,106
10473,5212,Nový Bydžov,70,236,108,128
10474,5212,Nový Bydžov,71,229,99,130
10475,5212,Nový Bydžov,72,232,108,124
10476,5212,Nový Bydžov,73,233,106,127
10477,5212,Nový Bydžov,74,196,88,108
10478,5212,Nový Bydžov,75,152,69,83
10479,5212,Nový Bydžov,76,148,70,78
10480,5212,Nový Bydžov,77,152,65,87
10481,5212,Nový Bydžov,78,89,32,57
10482,5212,Nový Bydžov,79,100,36,64
10483,5212,Nový Bydžov,80,110,36,74
10484,5212,Nový Bydžov,81,83,34,49
10485,5212,Nový Bydžov,82,91,25,66
10486,5212,Nový Bydžov,83,55,22,33
10487,5212,Nový Bydžov,84,71,22,49
10488,5212,Nový Bydžov,85,51,19,32
10489,5212,Nový Bydžov,86,59,16,43
10490,5212,Nový Bydžov,87,48,16,32
10491,5212,Nový Bydžov,88,39,10,29
10492,5212,Nový Bydžov,89,34,12,22
10493,5212,Nový Bydžov,90,34,7,27
10494,5212,Nový Bydžov,91,23,5,18
10495,5212,Nový Bydžov,92,22,6,16
10496,5212,Nový Bydžov,93,7,1,6
10497,5212,Nový Bydžov,94,10,2,8
10498,5212,Nový Bydžov,95,4,0,4
10499,5212,Nový Bydžov,96,3,0,3
10500,5212,Nový Bydžov,97,2,0,2
10501,5212,Nový Bydžov,98,2,0,2
10502,5212,Nový Bydžov,99,1,0,1
10503,5212,Nový Bydžov,100,2,1,1
10504,5213,Rychnov nad Kněžnou,0,335,164,171
10505,5213,Rychnov nad Kněžnou,1,327,165,162
10506,5213,Rychnov nad Kněžnou,2,372,178,194
10507,5213,Rychnov nad Kněžnou,3,374,199,175
10508,5213,Rychnov nad Kněžnou,4,389,195,194
10509,5213,Rychnov nad Kněžnou,5,348,176,172
10510,5213,Rychnov nad Kněžnou,6,372,192,180
10511,5213,Rychnov nad Kněžnou,7,362,184,178
10512,5213,Rychnov nad Kněžnou,8,383,196,187
10513,5213,Rychnov nad Kněžnou,9,353,180,173
10514,5213,Rychnov nad Kněžnou,10,339,174,165
10515,5213,Rychnov nad Kněžnou,11,394,212,182
10516,5213,Rychnov nad Kněžnou,12,367,195,172
10517,5213,Rychnov nad Kněžnou,13,356,185,171
10518,5213,Rychnov nad Kněžnou,14,367,182,185
10519,5213,Rychnov nad Kněžnou,15,313,177,136
10520,5213,Rychnov nad Kněžnou,16,353,190,163
10521,5213,Rychnov nad Kněžnou,17,338,164,174
10522,5213,Rychnov nad Kněžnou,18,317,157,160
10523,5213,Rychnov nad Kněžnou,19,315,160,155
10524,5213,Rychnov nad Kněžnou,20,312,151,161
10525,5213,Rychnov nad Kněžnou,21,311,167,144
10526,5213,Rychnov nad Kněžnou,22,299,147,152
10527,5213,Rychnov nad Kněžnou,23,386,201,185
10528,5213,Rychnov nad Kněžnou,24,323,173,150
10529,5213,Rychnov nad Kněžnou,25,360,211,149
10530,5213,Rychnov nad Kněžnou,26,329,198,131
10531,5213,Rychnov nad Kněžnou,27,437,247,190
10532,5213,Rychnov nad Kněžnou,28,440,229,211
10533,5213,Rychnov nad Kněžnou,29,479,244,235
10534,5213,Rychnov nad Kněžnou,30,442,240,202
10535,5213,Rychnov nad Kněžnou,31,468,248,220
10536,5213,Rychnov nad Kněžnou,32,425,214,211
10537,5213,Rychnov nad Kněžnou,33,437,232,205
10538,5213,Rychnov nad Kněžnou,34,446,246,200
10539,5213,Rychnov nad Kněžnou,35,461,259,202
10540,5213,Rychnov nad Kněžnou,36,478,264,214
10541,5213,Rychnov nad Kněžnou,37,483,264,219
10542,5213,Rychnov nad Kněžnou,38,439,225,214
10543,5213,Rychnov nad Kněžnou,39,441,222,219
10544,5213,Rychnov nad Kněžnou,40,483,258,225
10545,5213,Rychnov nad Kněžnou,41,531,295,236
10546,5213,Rychnov nad Kněžnou,42,558,300,258
10547,5213,Rychnov nad Kněžnou,43,564,297,267
10548,5213,Rychnov nad Kněžnou,44,644,344,300
10549,5213,Rychnov nad Kněžnou,45,621,319,302
10550,5213,Rychnov nad Kněžnou,46,653,347,306
10551,5213,Rychnov nad Kněžnou,47,606,327,279
10552,5213,Rychnov nad Kněžnou,48,554,288,266
10553,5213,Rychnov nad Kněžnou,49,517,255,262
10554,5213,Rychnov nad Kněžnou,50,503,273,230
10555,5213,Rychnov nad Kněžnou,51,432,240,192
10556,5213,Rychnov nad Kněžnou,52,399,218,181
10557,5213,Rychnov nad Kněžnou,53,428,209,219
10558,5213,Rychnov nad Kněžnou,54,394,214,180
10559,5213,Rychnov nad Kněžnou,55,454,210,244
10560,5213,Rychnov nad Kněžnou,56,435,219,216
10561,5213,Rychnov nad Kněžnou,57,399,192,207
10562,5213,Rychnov nad Kněžnou,58,411,220,191
10563,5213,Rychnov nad Kněžnou,59,399,187,212
10564,5213,Rychnov nad Kněžnou,60,374,194,180
10565,5213,Rychnov nad Kněžnou,61,346,178,168
10566,5213,Rychnov nad Kněžnou,62,391,193,198
10567,5213,Rychnov nad Kněžnou,63,420,204,216
10568,5213,Rychnov nad Kněžnou,64,430,204,226
10569,5213,Rychnov nad Kněžnou,65,468,219,249
10570,5213,Rychnov nad Kněžnou,66,438,206,232
10571,5213,Rychnov nad Kněžnou,67,433,190,243
10572,5213,Rychnov nad Kněžnou,68,454,222,232
10573,5213,Rychnov nad Kněžnou,69,436,209,227
10574,5213,Rychnov nad Kněžnou,70,446,203,243
10575,5213,Rychnov nad Kněžnou,71,404,183,221
10576,5213,Rychnov nad Kněžnou,72,426,205,221
10577,5213,Rychnov nad Kněžnou,73,404,179,225
10578,5213,Rychnov nad Kněžnou,74,380,164,216
10579,5213,Rychnov nad Kněžnou,75,303,128,175
10580,5213,Rychnov nad Kněžnou,76,261,107,154
10581,5213,Rychnov nad Kněžnou,77,299,121,178
10582,5213,Rychnov nad Kněžnou,78,216,79,137
10583,5213,Rychnov nad Kněžnou,79,217,88,129
10584,5213,Rychnov nad Kněžnou,80,189,78,111
10585,5213,Rychnov nad Kněžnou,81,140,61,79
10586,5213,Rychnov nad Kněžnou,82,150,56,94
10587,5213,Rychnov nad Kněžnou,83,116,40,76
10588,5213,Rychnov nad Kněžnou,84,116,39,77
10589,5213,Rychnov nad Kněžnou,85,116,33,83
10590,5213,Rychnov nad Kněžnou,86,102,46,56
10591,5213,Rychnov nad Kněžnou,87,77,31,46
10592,5213,Rychnov nad Kněžnou,88,68,14,54
10593,5213,Rychnov nad Kněžnou,89,73,22,51
10594,5213,Rychnov nad Kněžnou,90,62,19,43
10595,5213,Rychnov nad Kněžnou,91,45,8,37
10596,5213,Rychnov nad Kněžnou,92,29,9,20
10597,5213,Rychnov nad Kněžnou,93,39,13,26
10598,5213,Rychnov nad Kněžnou,94,19,4,15
10599,5213,Rychnov nad Kněžnou,95,7,1,6
10600,5213,Rychnov nad Kněžnou,96,7,3,4
10601,5213,Rychnov nad Kněžnou,97,6,1,5
10602,5213,Rychnov nad Kněžnou,98,3,0,3
10603,5213,Rychnov nad Kněžnou,99,7,3,4
10604,5213,Rychnov nad Kněžnou,100,1,0,1
10605,5214,Trutnov,0,600,297,303
10606,5214,Trutnov,1,610,311,299
10607,5214,Trutnov,2,652,331,321
10608,5214,Trutnov,3,588,299,289
10609,5214,Trutnov,4,601,307,294
10610,5214,Trutnov,5,581,289,292
10611,5214,Trutnov,6,619,323,296
10612,5214,Trutnov,7,598,310,288
10613,5214,Trutnov,8,610,283,327
10614,5214,Trutnov,9,631,326,305
10615,5214,Trutnov,10,671,359,312
10616,5214,Trutnov,11,703,358,345
10617,5214,Trutnov,12,747,413,334
10618,5214,Trutnov,13,771,384,387
10619,5214,Trutnov,14,645,308,337
10620,5214,Trutnov,15,644,328,316
10621,5214,Trutnov,16,593,297,296
10622,5214,Trutnov,17,580,289,291
10623,5214,Trutnov,18,579,313,266
10624,5214,Trutnov,19,611,324,287
10625,5214,Trutnov,20,614,314,300
10626,5214,Trutnov,21,590,312,278
10627,5214,Trutnov,22,571,297,274
10628,5214,Trutnov,23,583,331,252
10629,5214,Trutnov,24,608,325,283
10630,5214,Trutnov,25,613,318,295
10631,5214,Trutnov,26,668,354,314
10632,5214,Trutnov,27,762,386,376
10633,5214,Trutnov,28,730,360,370
10634,5214,Trutnov,29,754,407,347
10635,5214,Trutnov,30,756,401,355
10636,5214,Trutnov,31,777,405,372
10637,5214,Trutnov,32,811,450,361
10638,5214,Trutnov,33,761,393,368
10639,5214,Trutnov,34,792,425,367
10640,5214,Trutnov,35,782,409,373
10641,5214,Trutnov,36,768,384,384
10642,5214,Trutnov,37,748,401,347
10643,5214,Trutnov,38,766,410,356
10644,5214,Trutnov,39,867,444,423
10645,5214,Trutnov,40,881,503,378
10646,5214,Trutnov,41,989,491,498
10647,5214,Trutnov,42,1010,540,470
10648,5214,Trutnov,43,1034,527,507
10649,5214,Trutnov,44,1128,546,582
10650,5214,Trutnov,45,1113,563,550
10651,5214,Trutnov,46,1133,602,531
10652,5214,Trutnov,47,1061,542,519
10653,5214,Trutnov,48,1004,511,493
10654,5214,Trutnov,49,914,468,446
10655,5214,Trutnov,50,963,470,493
10656,5214,Trutnov,51,905,467,438
10657,5214,Trutnov,52,835,439,396
10658,5214,Trutnov,53,823,399,424
10659,5214,Trutnov,54,823,427,396
10660,5214,Trutnov,55,875,418,457
10661,5214,Trutnov,56,877,464,413
10662,5214,Trutnov,57,842,421,421
10663,5214,Trutnov,58,754,362,392
10664,5214,Trutnov,59,649,305,344
10665,5214,Trutnov,60,641,326,315
10666,5214,Trutnov,61,735,362,373
10667,5214,Trutnov,62,789,410,379
10668,5214,Trutnov,63,794,387,407
10669,5214,Trutnov,64,830,424,406
10670,5214,Trutnov,65,862,421,441
10671,5214,Trutnov,66,835,395,440
10672,5214,Trutnov,67,818,380,438
10673,5214,Trutnov,68,857,387,470
10674,5214,Trutnov,69,906,407,499
10675,5214,Trutnov,70,886,406,480
10676,5214,Trutnov,71,798,351,447
10677,5214,Trutnov,72,846,361,485
10678,5214,Trutnov,73,909,372,537
10679,5214,Trutnov,74,694,302,392
10680,5214,Trutnov,75,581,246,335
10681,5214,Trutnov,76,578,237,341
10682,5214,Trutnov,77,550,214,336
10683,5214,Trutnov,78,477,184,293
10684,5214,Trutnov,79,425,176,249
10685,5214,Trutnov,80,427,162,265
10686,5214,Trutnov,81,307,122,185
10687,5214,Trutnov,82,265,86,179
10688,5214,Trutnov,83,261,85,176
10689,5214,Trutnov,84,226,74,152
10690,5214,Trutnov,85,206,66,140
10691,5214,Trutnov,86,168,56,112
10692,5214,Trutnov,87,191,74,117
10693,5214,Trutnov,88,134,47,87
10694,5214,Trutnov,89,113,29,84
10695,5214,Trutnov,90,103,28,75
10696,5214,Trutnov,91,90,22,68
10697,5214,Trutnov,92,55,10,45
10698,5214,Trutnov,93,50,8,42
10699,5214,Trutnov,94,21,6,15
10700,5214,Trutnov,95,16,3,13
10701,5214,Trutnov,96,15,1,14
10702,5214,Trutnov,97,6,2,4
10703,5214,Trutnov,98,5,1,4
10704,5214,Trutnov,99,4,0,4
10705,5214,Trutnov,100,4,1,3
10706,5215,Vrchlabí,0,255,115,140
10707,5215,Vrchlabí,1,222,114,108
10708,5215,Vrchlabí,2,273,129,144
10709,5215,Vrchlabí,3,263,132,131
10710,5215,Vrchlabí,4,284,160,124
10711,5215,Vrchlabí,5,270,142,128
10712,5215,Vrchlabí,6,305,148,157
10713,5215,Vrchlabí,7,292,153,139
10714,5215,Vrchlabí,8,303,142,161
10715,5215,Vrchlabí,9,307,160,147
10716,5215,Vrchlabí,10,331,178,153
10717,5215,Vrchlabí,11,316,145,171
10718,5215,Vrchlabí,12,308,150,158
10719,5215,Vrchlabí,13,328,163,165
10720,5215,Vrchlabí,14,301,150,151
10721,5215,Vrchlabí,15,293,144,149
10722,5215,Vrchlabí,16,254,130,124
10723,5215,Vrchlabí,17,255,126,129
10724,5215,Vrchlabí,18,250,119,131
10725,5215,Vrchlabí,19,239,121,118
10726,5215,Vrchlabí,20,249,144,105
10727,5215,Vrchlabí,21,253,132,121
10728,5215,Vrchlabí,22,256,144,112
10729,5215,Vrchlabí,23,260,133,127
10730,5215,Vrchlabí,24,253,116,137
10731,5215,Vrchlabí,25,230,137,93
10732,5215,Vrchlabí,26,270,125,145
10733,5215,Vrchlabí,27,307,162,145
10734,5215,Vrchlabí,28,318,180,138
10735,5215,Vrchlabí,29,335,181,154
10736,5215,Vrchlabí,30,321,175,146
10737,5215,Vrchlabí,31,319,177,142
10738,5215,Vrchlabí,32,338,171,167
10739,5215,Vrchlabí,33,342,164,178
10740,5215,Vrchlabí,34,350,194,156
10741,5215,Vrchlabí,35,352,182,170
10742,5215,Vrchlabí,36,356,188,168
10743,5215,Vrchlabí,37,357,184,173
10744,5215,Vrchlabí,38,344,172,172
10745,5215,Vrchlabí,39,351,180,171
10746,5215,Vrchlabí,40,357,175,182
10747,5215,Vrchlabí,41,461,247,214
10748,5215,Vrchlabí,42,481,241,240
10749,5215,Vrchlabí,43,471,247,224
10750,5215,Vrchlabí,44,501,246,255
10751,5215,Vrchlabí,45,477,261,216
10752,5215,Vrchlabí,46,475,246,229
10753,5215,Vrchlabí,47,443,228,215
10754,5215,Vrchlabí,48,421,215,206
10755,5215,Vrchlabí,49,408,228,180
10756,5215,Vrchlabí,50,424,223,201
10757,5215,Vrchlabí,51,344,171,173
10758,5215,Vrchlabí,52,388,200,188
10759,5215,Vrchlabí,53,347,184,163
10760,5215,Vrchlabí,54,357,193,164
10761,5215,Vrchlabí,55,374,197,177
10762,5215,Vrchlabí,56,370,204,166
10763,5215,Vrchlabí,57,375,188,187
10764,5215,Vrchlabí,58,306,138,168
10765,5215,Vrchlabí,59,294,149,145
10766,5215,Vrchlabí,60,301,159,142
10767,5215,Vrchlabí,61,295,148,147
10768,5215,Vrchlabí,62,294,138,156
10769,5215,Vrchlabí,63,341,177,164
10770,5215,Vrchlabí,64,362,156,206
10771,5215,Vrchlabí,65,354,152,202
10772,5215,Vrchlabí,66,343,153,190
10773,5215,Vrchlabí,67,399,194,205
10774,5215,Vrchlabí,68,383,178,205
10775,5215,Vrchlabí,69,389,188,201
10776,5215,Vrchlabí,70,444,195,249
10777,5215,Vrchlabí,71,358,154,204
10778,5215,Vrchlabí,72,393,182,211
10779,5215,Vrchlabí,73,348,150,198
10780,5215,Vrchlabí,74,359,149,210
10781,5215,Vrchlabí,75,243,87,156
10782,5215,Vrchlabí,76,232,109,123
10783,5215,Vrchlabí,77,249,107,142
10784,5215,Vrchlabí,78,203,72,131
10785,5215,Vrchlabí,79,185,71,114
10786,5215,Vrchlabí,80,163,54,109
10787,5215,Vrchlabí,81,143,65,78
10788,5215,Vrchlabí,82,128,43,85
10789,5215,Vrchlabí,83,109,39,70
10790,5215,Vrchlabí,84,94,37,57
10791,5215,Vrchlabí,85,80,30,50
10792,5215,Vrchlabí,86,78,27,51
10793,5215,Vrchlabí,87,68,25,43
10794,5215,Vrchlabí,88,48,13,35
10795,5215,Vrchlabí,89,55,25,30
10796,5215,Vrchlabí,90,55,14,41
10797,5215,Vrchlabí,91,27,4,23
10798,5215,Vrchlabí,92,20,3,17
10799,5215,Vrchlabí,93,17,4,13
10800,5215,Vrchlabí,94,8,2,6
10801,5215,Vrchlabí,95,10,1,9
10802,5215,Vrchlabí,96,4,0,4
10803,5215,Vrchlabí,97,6,1,5
10804,5215,Vrchlabí,98,6,2,4
10805,5215,Vrchlabí,99,3,1,2
10806,5215,Vrchlabí,100,2,0,2
10807,5301,Česká Třebová,0,178,93,85
10808,5301,Česká Třebová,1,153,72,81
10809,5301,Česká Třebová,2,173,90,83
10810,5301,Česká Třebová,3,166,79,87
10811,5301,Česká Třebová,4,208,95,113
10812,5301,Česká Třebová,5,166,74,92
10813,5301,Česká Třebová,6,198,112,86
10814,5301,Česká Třebová,7,183,76,107
10815,5301,Česká Třebová,8,163,82,81
10816,5301,Česká Třebová,9,164,85,79
10817,5301,Česká Třebová,10,193,95,98
10818,5301,Česká Třebová,11,206,102,104
10819,5301,Česká Třebová,12,193,109,84
10820,5301,Česká Třebová,13,186,97,89
10821,5301,Česká Třebová,14,180,90,90
10822,5301,Česká Třebová,15,175,89,86
10823,5301,Česká Třebová,16,193,88,105
10824,5301,Česká Třebová,17,167,92,75
10825,5301,Česká Třebová,18,165,86,79
10826,5301,Česká Třebová,19,181,91,90
10827,5301,Česká Třebová,20,155,92,63
10828,5301,Česká Třebová,21,172,88,84
10829,5301,Česká Třebová,22,172,88,84
10830,5301,Česká Třebová,23,160,84,76
10831,5301,Česká Třebová,24,153,72,81
10832,5301,Česká Třebová,25,195,104,91
10833,5301,Česká Třebová,26,187,106,81
10834,5301,Česká Třebová,27,233,122,111
10835,5301,Česká Třebová,28,248,122,126
10836,5301,Česká Třebová,29,245,137,108
10837,5301,Česká Třebová,30,222,114,108
10838,5301,Česká Třebová,31,188,100,88
10839,5301,Česká Třebová,32,234,119,115
10840,5301,Česká Třebová,33,219,125,94
10841,5301,Česká Třebová,34,208,113,95
10842,5301,Česká Třebová,35,243,129,114
10843,5301,Česká Třebová,36,213,107,106
10844,5301,Česká Třebová,37,206,110,96
10845,5301,Česká Třebová,38,205,87,118
10846,5301,Česká Třebová,39,209,114,95
10847,5301,Česká Třebová,40,228,128,100
10848,5301,Česká Třebová,41,267,141,126
10849,5301,Česká Třebová,42,275,137,138
10850,5301,Česká Třebová,43,283,149,134
10851,5301,Česká Třebová,44,293,159,134
10852,5301,Česká Třebová,45,293,134,159
10853,5301,Česká Třebová,46,334,174,160
10854,5301,Česká Třebová,47,315,160,155
10855,5301,Česká Třebová,48,287,158,129
10856,5301,Česká Třebová,49,273,128,145
10857,5301,Česká Třebová,50,226,115,111
10858,5301,Česká Třebová,51,245,128,117
10859,5301,Česká Třebová,52,212,116,96
10860,5301,Česká Třebová,53,231,124,107
10861,5301,Česká Třebová,54,231,118,113
10862,5301,Česká Třebová,55,243,117,126
10863,5301,Česká Třebová,56,237,113,124
10864,5301,Česká Třebová,57,247,122,125
10865,5301,Česká Třebová,58,230,109,121
10866,5301,Česká Třebová,59,224,118,106
10867,5301,Česká Třebová,60,173,92,81
10868,5301,Česká Třebová,61,209,98,111
10869,5301,Česká Třebová,62,225,106,119
10870,5301,Česká Třebová,63,269,125,144
10871,5301,Česká Třebová,64,248,113,135
10872,5301,Česká Třebová,65,248,119,129
10873,5301,Česká Třebová,66,212,91,121
10874,5301,Česká Třebová,67,238,107,131
10875,5301,Česká Třebová,68,248,97,151
10876,5301,Česká Třebová,69,239,109,130
10877,5301,Česká Třebová,70,228,86,142
10878,5301,Česká Třebová,71,250,120,130
10879,5301,Česká Třebová,72,218,100,118
10880,5301,Česká Třebová,73,249,106,143
10881,5301,Česká Třebová,74,239,107,132
10882,5301,Česká Třebová,75,160,63,97
10883,5301,Česká Třebová,76,157,67,90
10884,5301,Česká Třebová,77,162,67,95
10885,5301,Česká Třebová,78,153,65,88
10886,5301,Česká Třebová,79,132,62,70
10887,5301,Česká Třebová,80,102,40,62
10888,5301,Česká Třebová,81,107,48,59
10889,5301,Česká Třebová,82,81,33,48
10890,5301,Česká Třebová,83,68,25,43
10891,5301,Česká Třebová,84,57,12,45
10892,5301,Česká Třebová,85,56,20,36
10893,5301,Česká Třebová,86,56,13,43
10894,5301,Česká Třebová,87,45,17,28
10895,5301,Česká Třebová,88,40,11,29
10896,5301,Česká Třebová,89,38,7,31
10897,5301,Česká Třebová,90,37,18,19
10898,5301,Česká Třebová,91,23,5,18
10899,5301,Česká Třebová,92,21,7,14
10900,5301,Česká Třebová,93,10,1,9
10901,5301,Česká Třebová,94,10,0,10
10902,5301,Česká Třebová,95,2,2,0
10903,5301,Česká Třebová,96,5,1,4
10904,5301,Česká Třebová,97,4,1,3
10905,5301,Česká Třebová,98,1,0,1
10906,5301,Česká Třebová,99,0,0,0
10907,5301,Česká Třebová,100,1,0,1
10908,5302,Hlinsko,0,228,125,103
10909,5302,Hlinsko,1,238,112,126
10910,5302,Hlinsko,2,219,115,104
10911,5302,Hlinsko,3,220,105,115
10912,5302,Hlinsko,4,204,96,108
10913,5302,Hlinsko,5,205,102,103
10914,5302,Hlinsko,6,206,99,107
10915,5302,Hlinsko,7,195,105,90
10916,5302,Hlinsko,8,211,125,86
10917,5302,Hlinsko,9,211,100,111
10918,5302,Hlinsko,10,214,121,93
10919,5302,Hlinsko,11,207,106,101
10920,5302,Hlinsko,12,224,115,109
10921,5302,Hlinsko,13,198,107,91
10922,5302,Hlinsko,14,211,111,100
10923,5302,Hlinsko,15,193,106,87
10924,5302,Hlinsko,16,208,113,95
10925,5302,Hlinsko,17,212,113,99
10926,5302,Hlinsko,18,199,107,92
10927,5302,Hlinsko,19,210,106,104
10928,5302,Hlinsko,20,216,116,100
10929,5302,Hlinsko,21,217,107,110
10930,5302,Hlinsko,22,209,112,97
10931,5302,Hlinsko,23,175,88,87
10932,5302,Hlinsko,24,221,121,100
10933,5302,Hlinsko,25,240,132,108
10934,5302,Hlinsko,26,269,126,143
10935,5302,Hlinsko,27,285,148,137
10936,5302,Hlinsko,28,249,126,123
10937,5302,Hlinsko,29,288,152,136
10938,5302,Hlinsko,30,302,155,147
10939,5302,Hlinsko,31,274,135,139
10940,5302,Hlinsko,32,265,141,124
10941,5302,Hlinsko,33,267,135,132
10942,5302,Hlinsko,34,293,164,129
10943,5302,Hlinsko,35,277,138,139
10944,5302,Hlinsko,36,262,143,119
10945,5302,Hlinsko,37,263,148,115
10946,5302,Hlinsko,38,269,147,122
10947,5302,Hlinsko,39,255,136,119
10948,5302,Hlinsko,40,264,130,134
10949,5302,Hlinsko,41,296,162,134
10950,5302,Hlinsko,42,339,181,158
10951,5302,Hlinsko,43,320,174,146
10952,5302,Hlinsko,44,349,192,157
10953,5302,Hlinsko,45,325,186,139
10954,5302,Hlinsko,46,327,181,146
10955,5302,Hlinsko,47,331,156,175
10956,5302,Hlinsko,48,330,171,159
10957,5302,Hlinsko,49,258,130,128
10958,5302,Hlinsko,50,300,141,159
10959,5302,Hlinsko,51,258,132,126
10960,5302,Hlinsko,52,252,117,135
10961,5302,Hlinsko,53,253,126,127
10962,5302,Hlinsko,54,265,144,121
10963,5302,Hlinsko,55,270,119,151
10964,5302,Hlinsko,56,291,148,143
10965,5302,Hlinsko,57,279,143,136
10966,5302,Hlinsko,58,279,148,131
10967,5302,Hlinsko,59,263,122,141
10968,5302,Hlinsko,60,224,114,110
10969,5302,Hlinsko,61,234,105,129
10970,5302,Hlinsko,62,253,128,125
10971,5302,Hlinsko,63,287,161,126
10972,5302,Hlinsko,64,273,130,143
10973,5302,Hlinsko,65,311,142,169
10974,5302,Hlinsko,66,286,143,143
10975,5302,Hlinsko,67,275,133,142
10976,5302,Hlinsko,68,289,135,154
10977,5302,Hlinsko,69,282,135,147
10978,5302,Hlinsko,70,244,118,126
10979,5302,Hlinsko,71,243,101,142
10980,5302,Hlinsko,72,232,110,122
10981,5302,Hlinsko,73,248,113,135
10982,5302,Hlinsko,74,250,114,136
10983,5302,Hlinsko,75,194,84,110
10984,5302,Hlinsko,76,210,70,140
10985,5302,Hlinsko,77,159,64,95
10986,5302,Hlinsko,78,153,51,102
10987,5302,Hlinsko,79,158,67,91
10988,5302,Hlinsko,80,146,62,84
10989,5302,Hlinsko,81,132,52,80
10990,5302,Hlinsko,82,117,50,67
10991,5302,Hlinsko,83,105,42,63
10992,5302,Hlinsko,84,96,28,68
10993,5302,Hlinsko,85,88,34,54
10994,5302,Hlinsko,86,65,18,47
10995,5302,Hlinsko,87,66,18,48
10996,5302,Hlinsko,88,70,20,50
10997,5302,Hlinsko,89,54,17,37
10998,5302,Hlinsko,90,28,13,15
10999,5302,Hlinsko,91,22,7,15
11000,5302,Hlinsko,92,16,6,10
11001,5302,Hlinsko,93,17,6,11
11002,5302,Hlinsko,94,9,5,4
11003,5302,Hlinsko,95,9,1,8
11004,5302,Hlinsko,96,7,1,6
11005,5302,Hlinsko,97,1,0,1
11006,5302,Hlinsko,98,2,0,2
11007,5302,Hlinsko,99,2,0,2
11008,5302,Hlinsko,100,1,1,0
11009,5303,Holice,0,177,105,72
11010,5303,Holice,1,201,101,100
11011,5303,Holice,2,193,93,100
11012,5303,Holice,3,185,81,104
11013,5303,Holice,4,205,99,106
11014,5303,Holice,5,163,99,64
11015,5303,Holice,6,208,101,107
11016,5303,Holice,7,191,105,86
11017,5303,Holice,8,202,101,101
11018,5303,Holice,9,204,103,101
11019,5303,Holice,10,218,113,105
11020,5303,Holice,11,238,124,114
11021,5303,Holice,12,216,113,103
11022,5303,Holice,13,221,126,95
11023,5303,Holice,14,237,114,123
11024,5303,Holice,15,177,97,80
11025,5303,Holice,16,159,77,82
11026,5303,Holice,17,179,91,88
11027,5303,Holice,18,198,102,96
11028,5303,Holice,19,161,85,76
11029,5303,Holice,20,186,97,89
11030,5303,Holice,21,188,108,80
11031,5303,Holice,22,167,84,83
11032,5303,Holice,23,142,80,62
11033,5303,Holice,24,150,79,71
11034,5303,Holice,25,180,96,84
11035,5303,Holice,26,190,102,88
11036,5303,Holice,27,223,115,108
11037,5303,Holice,28,223,106,117
11038,5303,Holice,29,211,106,105
11039,5303,Holice,30,224,121,103
11040,5303,Holice,31,207,113,94
11041,5303,Holice,32,236,122,114
11042,5303,Holice,33,218,108,110
11043,5303,Holice,34,221,120,101
11044,5303,Holice,35,228,112,116
11045,5303,Holice,36,252,127,125
11046,5303,Holice,37,233,124,109
11047,5303,Holice,38,260,145,115
11048,5303,Holice,39,228,124,104
11049,5303,Holice,40,247,136,111
11050,5303,Holice,41,297,159,138
11051,5303,Holice,42,334,174,160
11052,5303,Holice,43,312,166,146
11053,5303,Holice,44,352,172,180
11054,5303,Holice,45,374,200,174
11055,5303,Holice,46,368,185,183
11056,5303,Holice,47,332,165,167
11057,5303,Holice,48,296,149,147
11058,5303,Holice,49,282,133,149
11059,5303,Holice,50,249,127,122
11060,5303,Holice,51,247,134,113
11061,5303,Holice,52,223,113,110
11062,5303,Holice,53,230,124,106
11063,5303,Holice,54,209,111,98
11064,5303,Holice,55,193,101,92
11065,5303,Holice,56,232,115,117
11066,5303,Holice,57,227,116,111
11067,5303,Holice,58,216,110,106
11068,5303,Holice,59,180,85,95
11069,5303,Holice,60,194,106,88
11070,5303,Holice,61,193,100,93
11071,5303,Holice,62,196,93,103
11072,5303,Holice,63,196,96,100
11073,5303,Holice,64,233,114,119
11074,5303,Holice,65,235,107,128
11075,5303,Holice,66,221,106,115
11076,5303,Holice,67,202,93,109
11077,5303,Holice,68,238,100,138
11078,5303,Holice,69,221,107,114
11079,5303,Holice,70,223,102,121
11080,5303,Holice,71,212,101,111
11081,5303,Holice,72,208,94,114
11082,5303,Holice,73,198,81,117
11083,5303,Holice,74,191,84,107
11084,5303,Holice,75,152,62,90
11085,5303,Holice,76,147,64,83
11086,5303,Holice,77,146,64,82
11087,5303,Holice,78,127,62,65
11088,5303,Holice,79,89,41,48
11089,5303,Holice,80,99,46,53
11090,5303,Holice,81,84,28,56
11091,5303,Holice,82,75,33,42
11092,5303,Holice,83,59,14,45
11093,5303,Holice,84,79,32,47
11094,5303,Holice,85,55,17,38
11095,5303,Holice,86,40,14,26
11096,5303,Holice,87,50,12,38
11097,5303,Holice,88,41,12,29
11098,5303,Holice,89,28,8,20
11099,5303,Holice,90,37,10,27
11100,5303,Holice,91,22,5,17
11101,5303,Holice,92,13,3,10
11102,5303,Holice,93,16,6,10
11103,5303,Holice,94,5,1,4
11104,5303,Holice,95,7,2,5
11105,5303,Holice,96,2,0,2
11106,5303,Holice,97,4,0,4
11107,5303,Holice,98,5,0,5
11108,5303,Holice,99,0,0,0
11109,5303,Holice,100,1,0,1
11110,5304,Chrudim,0,891,454,437
11111,5304,Chrudim,1,917,506,411
11112,5304,Chrudim,2,870,443,427
11113,5304,Chrudim,3,899,448,451
11114,5304,Chrudim,4,894,468,426
11115,5304,Chrudim,5,840,449,391
11116,5304,Chrudim,6,885,445,440
11117,5304,Chrudim,7,818,442,376
11118,5304,Chrudim,8,903,469,434
11119,5304,Chrudim,9,884,464,420
11120,5304,Chrudim,10,900,464,436
11121,5304,Chrudim,11,918,448,470
11122,5304,Chrudim,12,925,472,453
11123,5304,Chrudim,13,929,501,428
11124,5304,Chrudim,14,848,433,415
11125,5304,Chrudim,15,878,447,431
11126,5304,Chrudim,16,760,397,363
11127,5304,Chrudim,17,776,402,374
11128,5304,Chrudim,18,776,427,349
11129,5304,Chrudim,19,774,393,381
11130,5304,Chrudim,20,736,375,361
11131,5304,Chrudim,21,825,440,385
11132,5304,Chrudim,22,820,423,397
11133,5304,Chrudim,23,819,422,397
11134,5304,Chrudim,24,829,436,393
11135,5304,Chrudim,25,839,432,407
11136,5304,Chrudim,26,926,460,466
11137,5304,Chrudim,27,1039,563,476
11138,5304,Chrudim,28,1067,572,495
11139,5304,Chrudim,29,1088,595,493
11140,5304,Chrudim,30,1044,537,507
11141,5304,Chrudim,31,1032,512,520
11142,5304,Chrudim,32,1139,565,574
11143,5304,Chrudim,33,1044,544,500
11144,5304,Chrudim,34,1071,547,524
11145,5304,Chrudim,35,1115,591,524
11146,5304,Chrudim,36,1095,571,524
11147,5304,Chrudim,37,1038,553,485
11148,5304,Chrudim,38,1095,571,524
11149,5304,Chrudim,39,1118,582,536
11150,5304,Chrudim,40,1229,656,573
11151,5304,Chrudim,41,1362,685,677
11152,5304,Chrudim,42,1349,727,622
11153,5304,Chrudim,43,1418,758,660
11154,5304,Chrudim,44,1448,743,705
11155,5304,Chrudim,45,1405,747,658
11156,5304,Chrudim,46,1421,735,686
11157,5304,Chrudim,47,1426,739,687
11158,5304,Chrudim,48,1211,618,593
11159,5304,Chrudim,49,1134,558,576
11160,5304,Chrudim,50,1081,561,520
11161,5304,Chrudim,51,1055,527,528
11162,5304,Chrudim,52,989,484,505
11163,5304,Chrudim,53,1045,535,510
11164,5304,Chrudim,54,1033,508,525
11165,5304,Chrudim,55,1126,568,558
11166,5304,Chrudim,56,1115,541,574
11167,5304,Chrudim,57,1073,532,541
11168,5304,Chrudim,58,1055,530,525
11169,5304,Chrudim,59,1021,504,517
11170,5304,Chrudim,60,958,485,473
11171,5304,Chrudim,61,945,454,491
11172,5304,Chrudim,62,1025,514,511
11173,5304,Chrudim,63,1040,507,533
11174,5304,Chrudim,64,1196,588,608
11175,5304,Chrudim,65,1153,550,603
11176,5304,Chrudim,66,1165,553,612
11177,5304,Chrudim,67,1122,568,554
11178,5304,Chrudim,68,1133,541,592
11179,5304,Chrudim,69,1104,491,613
11180,5304,Chrudim,70,1050,517,533
11181,5304,Chrudim,71,934,427,507
11182,5304,Chrudim,72,1001,462,539
11183,5304,Chrudim,73,963,423,540
11184,5304,Chrudim,74,938,418,520
11185,5304,Chrudim,75,717,308,409
11186,5304,Chrudim,76,768,307,461
11187,5304,Chrudim,77,694,289,405
11188,5304,Chrudim,78,567,229,338
11189,5304,Chrudim,79,515,213,302
11190,5304,Chrudim,80,538,212,326
11191,5304,Chrudim,81,422,163,259
11192,5304,Chrudim,82,391,144,247
11193,5304,Chrudim,83,336,106,230
11194,5304,Chrudim,84,303,110,193
11195,5304,Chrudim,85,275,97,178
11196,5304,Chrudim,86,275,90,185
11197,5304,Chrudim,87,229,65,164
11198,5304,Chrudim,88,215,64,151
11199,5304,Chrudim,89,180,54,126
11200,5304,Chrudim,90,129,41,88
11201,5304,Chrudim,91,86,17,69
11202,5304,Chrudim,92,85,31,54
11203,5304,Chrudim,93,57,25,32
11204,5304,Chrudim,94,39,13,26
11205,5304,Chrudim,95,26,8,18
11206,5304,Chrudim,96,22,5,17
11207,5304,Chrudim,97,17,4,13
11208,5304,Chrudim,98,6,2,4
11209,5304,Chrudim,99,7,1,6
11210,5304,Chrudim,100,6,4,2
11211,5305,Králíky,0,79,38,41
11212,5305,Králíky,1,75,40,35
11213,5305,Králíky,2,106,47,59
11214,5305,Králíky,3,96,48,48
11215,5305,Králíky,4,79,43,36
11216,5305,Králíky,5,93,43,50
11217,5305,Králíky,6,83,37,46
11218,5305,Králíky,7,76,37,39
11219,5305,Králíky,8,83,41,42
11220,5305,Králíky,9,83,40,43
11221,5305,Králíky,10,89,40,49
11222,5305,Králíky,11,96,40,56
11223,5305,Králíky,12,95,53,42
11224,5305,Králíky,13,86,43,43
11225,5305,Králíky,14,106,59,47
11226,5305,Králíky,15,88,40,48
11227,5305,Králíky,16,73,32,41
11228,5305,Králíky,17,80,42,38
11229,5305,Králíky,18,74,33,41
11230,5305,Králíky,19,91,44,47
11231,5305,Králíky,20,79,51,28
11232,5305,Králíky,21,86,44,42
11233,5305,Králíky,22,107,49,58
11234,5305,Králíky,23,90,41,49
11235,5305,Králíky,24,75,43,32
11236,5305,Králíky,25,83,50,33
11237,5305,Králíky,26,122,61,61
11238,5305,Králíky,27,120,60,60
11239,5305,Králíky,28,117,65,52
11240,5305,Králíky,29,107,57,50
11241,5305,Králíky,30,110,58,52
11242,5305,Králíky,31,132,74,58
11243,5305,Králíky,32,102,61,41
11244,5305,Králíky,33,114,66,48
11245,5305,Králíky,34,108,60,48
11246,5305,Králíky,35,122,63,59
11247,5305,Králíky,36,107,57,50
11248,5305,Králíky,37,120,69,51
11249,5305,Králíky,38,99,63,36
11250,5305,Králíky,39,106,65,41
11251,5305,Králíky,40,96,53,43
11252,5305,Králíky,41,132,65,67
11253,5305,Králíky,42,118,61,57
11254,5305,Králíky,43,129,62,67
11255,5305,Králíky,44,116,60,56
11256,5305,Králíky,45,150,78,72
11257,5305,Králíky,46,142,77,65
11258,5305,Králíky,47,146,77,69
11259,5305,Králíky,48,112,65,47
11260,5305,Králíky,49,125,69,56
11261,5305,Králíky,50,124,60,64
11262,5305,Králíky,51,119,56,63
11263,5305,Králíky,52,109,58,51
11264,5305,Králíky,53,119,66,53
11265,5305,Králíky,54,110,62,48
11266,5305,Králíky,55,128,60,68
11267,5305,Králíky,56,113,56,57
11268,5305,Králíky,57,119,60,59
11269,5305,Králíky,58,104,50,54
11270,5305,Králíky,59,102,55,47
11271,5305,Králíky,60,104,49,55
11272,5305,Králíky,61,83,44,39
11273,5305,Králíky,62,92,35,57
11274,5305,Králíky,63,108,59,49
11275,5305,Králíky,64,112,61,51
11276,5305,Králíky,65,110,52,58
11277,5305,Králíky,66,120,55,65
11278,5305,Králíky,67,97,44,53
11279,5305,Králíky,68,120,55,65
11280,5305,Králíky,69,110,58,52
11281,5305,Králíky,70,118,51,67
11282,5305,Králíky,71,107,49,58
11283,5305,Králíky,72,124,57,67
11284,5305,Králíky,73,114,51,63
11285,5305,Králíky,74,93,47,46
11286,5305,Králíky,75,80,33,47
11287,5305,Králíky,76,87,36,51
11288,5305,Králíky,77,72,23,49
11289,5305,Králíky,78,60,25,35
11290,5305,Králíky,79,56,14,42
11291,5305,Králíky,80,70,36,34
11292,5305,Králíky,81,56,23,33
11293,5305,Králíky,82,41,13,28
11294,5305,Králíky,83,35,13,22
11295,5305,Králíky,84,28,8,20
11296,5305,Králíky,85,32,16,16
11297,5305,Králíky,86,33,11,22
11298,5305,Králíky,87,15,5,10
11299,5305,Králíky,88,18,7,11
11300,5305,Králíky,89,21,9,12
11301,5305,Králíky,90,11,1,10
11302,5305,Králíky,91,10,1,9
11303,5305,Králíky,92,9,2,7
11304,5305,Králíky,93,3,1,2
11305,5305,Králíky,94,4,1,3
11306,5305,Králíky,95,5,0,5
11307,5305,Králíky,96,4,0,4
11308,5305,Králíky,97,1,0,1
11309,5305,Králíky,98,2,0,2
11310,5305,Králíky,99,2,0,2
11311,5305,Králíky,100,1,0,1
11312,5306,Lanškroun,0,243,131,112
11313,5306,Lanškroun,1,258,139,119
11314,5306,Lanškroun,2,223,115,108
11315,5306,Lanškroun,3,225,119,106
11316,5306,Lanškroun,4,279,150,129
11317,5306,Lanškroun,5,226,122,104
11318,5306,Lanškroun,6,240,131,109
11319,5306,Lanškroun,7,227,114,113
11320,5306,Lanškroun,8,245,115,130
11321,5306,Lanškroun,9,244,126,118
11322,5306,Lanškroun,10,280,158,122
11323,5306,Lanškroun,11,288,143,145
11324,5306,Lanškroun,12,275,153,122
11325,5306,Lanškroun,13,301,138,163
11326,5306,Lanškroun,14,255,125,130
11327,5306,Lanškroun,15,223,117,106
11328,5306,Lanškroun,16,220,99,121
11329,5306,Lanškroun,17,226,118,108
11330,5306,Lanškroun,18,231,128,103
11331,5306,Lanškroun,19,229,117,112
11332,5306,Lanškroun,20,227,120,107
11333,5306,Lanškroun,21,227,105,122
11334,5306,Lanškroun,22,221,104,117
11335,5306,Lanškroun,23,233,115,118
11336,5306,Lanškroun,24,200,112,88
11337,5306,Lanškroun,25,237,118,119
11338,5306,Lanškroun,26,257,127,130
11339,5306,Lanškroun,27,284,126,158
11340,5306,Lanškroun,28,304,168,136
11341,5306,Lanškroun,29,291,167,124
11342,5306,Lanškroun,30,299,163,136
11343,5306,Lanškroun,31,282,140,142
11344,5306,Lanškroun,32,298,154,144
11345,5306,Lanškroun,33,286,143,143
11346,5306,Lanškroun,34,259,148,111
11347,5306,Lanškroun,35,289,142,147
11348,5306,Lanškroun,36,298,157,141
11349,5306,Lanškroun,37,303,157,146
11350,5306,Lanškroun,38,313,163,150
11351,5306,Lanškroun,39,301,155,146
11352,5306,Lanškroun,40,347,166,181
11353,5306,Lanškroun,41,384,182,202
11354,5306,Lanškroun,42,416,219,197
11355,5306,Lanškroun,43,449,220,229
11356,5306,Lanškroun,44,430,211,219
11357,5306,Lanškroun,45,390,209,181
11358,5306,Lanškroun,46,455,229,226
11359,5306,Lanškroun,47,368,194,174
11360,5306,Lanškroun,48,383,207,176
11361,5306,Lanškroun,49,347,183,164
11362,5306,Lanškroun,50,370,184,186
11363,5306,Lanškroun,51,320,167,153
11364,5306,Lanškroun,52,294,140,154
11365,5306,Lanškroun,53,286,151,135
11366,5306,Lanškroun,54,287,137,150
11367,5306,Lanškroun,55,294,149,145
11368,5306,Lanškroun,56,280,150,130
11369,5306,Lanškroun,57,319,154,165
11370,5306,Lanškroun,58,244,117,127
11371,5306,Lanškroun,59,245,130,115
11372,5306,Lanškroun,60,247,125,122
11373,5306,Lanškroun,61,261,121,140
11374,5306,Lanškroun,62,242,104,138
11375,5306,Lanškroun,63,283,129,154
11376,5306,Lanškroun,64,270,122,148
11377,5306,Lanškroun,65,289,143,146
11378,5306,Lanškroun,66,282,124,158
11379,5306,Lanškroun,67,272,131,141
11380,5306,Lanškroun,68,289,142,147
11381,5306,Lanškroun,69,304,128,176
11382,5306,Lanškroun,70,290,119,171
11383,5306,Lanškroun,71,270,140,130
11384,5306,Lanškroun,72,276,124,152
11385,5306,Lanškroun,73,306,130,176
11386,5306,Lanškroun,74,273,123,150
11387,5306,Lanškroun,75,181,73,108
11388,5306,Lanškroun,76,215,97,118
11389,5306,Lanškroun,77,170,66,104
11390,5306,Lanškroun,78,129,52,77
11391,5306,Lanškroun,79,142,63,79
11392,5306,Lanškroun,80,123,51,72
11393,5306,Lanškroun,81,103,38,65
11394,5306,Lanškroun,82,90,33,57
11395,5306,Lanškroun,83,66,27,39
11396,5306,Lanškroun,84,81,26,55
11397,5306,Lanškroun,85,64,28,36
11398,5306,Lanškroun,86,52,19,33
11399,5306,Lanškroun,87,52,15,37
11400,5306,Lanškroun,88,32,6,26
11401,5306,Lanškroun,89,48,13,35
11402,5306,Lanškroun,90,32,8,24
11403,5306,Lanškroun,91,28,6,22
11404,5306,Lanškroun,92,16,5,11
11405,5306,Lanškroun,93,12,7,5
11406,5306,Lanškroun,94,16,5,11
11407,5306,Lanškroun,95,6,2,4
11408,5306,Lanškroun,96,5,2,3
11409,5306,Lanškroun,97,7,1,6
11410,5306,Lanškroun,98,4,0,4
11411,5306,Lanškroun,99,1,0,1
11412,5306,Lanškroun,100,1,1,0
11413,5307,Litomyšl,0,287,143,144
11414,5307,Litomyšl,1,311,149,162
11415,5307,Litomyšl,2,318,150,168
11416,5307,Litomyšl,3,287,153,134
11417,5307,Litomyšl,4,305,166,139
11418,5307,Litomyšl,5,291,159,132
11419,5307,Litomyšl,6,265,140,125
11420,5307,Litomyšl,7,275,140,135
11421,5307,Litomyšl,8,274,120,154
11422,5307,Litomyšl,9,263,128,135
11423,5307,Litomyšl,10,295,154,141
11424,5307,Litomyšl,11,296,156,140
11425,5307,Litomyšl,12,338,172,166
11426,5307,Litomyšl,13,319,172,147
11427,5307,Litomyšl,14,285,141,144
11428,5307,Litomyšl,15,282,140,142
11429,5307,Litomyšl,16,250,129,121
11430,5307,Litomyšl,17,258,133,125
11431,5307,Litomyšl,18,284,141,143
11432,5307,Litomyšl,19,230,113,117
11433,5307,Litomyšl,20,271,141,130
11434,5307,Litomyšl,21,259,133,126
11435,5307,Litomyšl,22,297,153,144
11436,5307,Litomyšl,23,285,157,128
11437,5307,Litomyšl,24,274,140,134
11438,5307,Litomyšl,25,330,167,163
11439,5307,Litomyšl,26,327,162,165
11440,5307,Litomyšl,27,381,181,200
11441,5307,Litomyšl,28,377,204,173
11442,5307,Litomyšl,29,332,170,162
11443,5307,Litomyšl,30,385,200,185
11444,5307,Litomyšl,31,301,156,145
11445,5307,Litomyšl,32,351,182,169
11446,5307,Litomyšl,33,347,177,170
11447,5307,Litomyšl,34,329,179,150
11448,5307,Litomyšl,35,336,178,158
11449,5307,Litomyšl,36,330,178,152
11450,5307,Litomyšl,37,318,167,151
11451,5307,Litomyšl,38,382,183,199
11452,5307,Litomyšl,39,367,201,166
11453,5307,Litomyšl,40,362,179,183
11454,5307,Litomyšl,41,416,219,197
11455,5307,Litomyšl,42,438,226,212
11456,5307,Litomyšl,43,466,244,222
11457,5307,Litomyšl,44,443,229,214
11458,5307,Litomyšl,45,480,235,245
11459,5307,Litomyšl,46,500,250,250
11460,5307,Litomyšl,47,447,217,230
11461,5307,Litomyšl,48,426,237,189
11462,5307,Litomyšl,49,385,198,187
11463,5307,Litomyšl,50,380,196,184
11464,5307,Litomyšl,51,391,195,196
11465,5307,Litomyšl,52,329,170,159
11466,5307,Litomyšl,53,350,165,185
11467,5307,Litomyšl,54,320,147,173
11468,5307,Litomyšl,55,347,183,164
11469,5307,Litomyšl,56,354,191,163
11470,5307,Litomyšl,57,355,177,178
11471,5307,Litomyšl,58,315,155,160
11472,5307,Litomyšl,59,323,192,131
11473,5307,Litomyšl,60,297,147,150
11474,5307,Litomyšl,61,289,144,145
11475,5307,Litomyšl,62,319,172,147
11476,5307,Litomyšl,63,355,168,187
11477,5307,Litomyšl,64,352,176,176
11478,5307,Litomyšl,65,330,162,168
11479,5307,Litomyšl,66,329,146,183
11480,5307,Litomyšl,67,317,149,168
11481,5307,Litomyšl,68,351,166,185
11482,5307,Litomyšl,69,350,161,189
11483,5307,Litomyšl,70,325,150,175
11484,5307,Litomyšl,71,307,143,164
11485,5307,Litomyšl,72,304,152,152
11486,5307,Litomyšl,73,287,149,138
11487,5307,Litomyšl,74,320,141,179
11488,5307,Litomyšl,75,238,91,147
11489,5307,Litomyšl,76,227,111,116
11490,5307,Litomyšl,77,184,80,104
11491,5307,Litomyšl,78,176,77,99
11492,5307,Litomyšl,79,177,68,109
11493,5307,Litomyšl,80,165,60,105
11494,5307,Litomyšl,81,159,54,105
11495,5307,Litomyšl,82,105,35,70
11496,5307,Litomyšl,83,116,47,69
11497,5307,Litomyšl,84,107,48,59
11498,5307,Litomyšl,85,102,35,67
11499,5307,Litomyšl,86,73,29,44
11500,5307,Litomyšl,87,70,22,48
11501,5307,Litomyšl,88,70,29,41
11502,5307,Litomyšl,89,42,10,32
11503,5307,Litomyšl,90,54,12,42
11504,5307,Litomyšl,91,30,12,18
11505,5307,Litomyšl,92,17,5,12
11506,5307,Litomyšl,93,15,1,14
11507,5307,Litomyšl,94,11,3,8
11508,5307,Litomyšl,95,5,1,4
11509,5307,Litomyšl,96,4,1,3
11510,5307,Litomyšl,97,7,4,3
11511,5307,Litomyšl,98,1,0,1
11512,5307,Litomyšl,99,2,0,2
11513,5307,Litomyšl,100,0,0,0
11514,5308,Moravská Třebová,0,243,125,118
11515,5308,Moravská Třebová,1,265,137,128
11516,5308,Moravská Třebová,2,251,121,130
11517,5308,Moravská Třebová,3,278,154,124
11518,5308,Moravská Třebová,4,256,140,116
11519,5308,Moravská Třebová,5,232,108,124
11520,5308,Moravská Třebová,6,248,119,129
11521,5308,Moravská Třebová,7,231,120,111
11522,5308,Moravská Třebová,8,239,110,129
11523,5308,Moravská Třebová,9,243,127,116
11524,5308,Moravská Třebová,10,285,142,143
11525,5308,Moravská Třebová,11,299,147,152
11526,5308,Moravská Třebová,12,265,134,131
11527,5308,Moravská Třebová,13,287,151,136
11528,5308,Moravská Třebová,14,279,162,117
11529,5308,Moravská Třebová,15,241,115,126
11530,5308,Moravská Třebová,16,259,122,137
11531,5308,Moravská Třebová,17,259,141,118
11532,5308,Moravská Třebová,18,242,127,115
11533,5308,Moravská Třebová,19,235,112,123
11534,5308,Moravská Třebová,20,267,142,125
11535,5308,Moravská Třebová,21,220,108,112
11536,5308,Moravská Třebová,22,263,139,124
11537,5308,Moravská Třebová,23,285,153,132
11538,5308,Moravská Třebová,24,255,133,122
11539,5308,Moravská Třebová,25,267,145,122
11540,5308,Moravská Třebová,26,309,171,138
11541,5308,Moravská Třebová,27,326,181,145
11542,5308,Moravská Třebová,28,324,166,158
11543,5308,Moravská Třebová,29,332,195,137
11544,5308,Moravská Třebová,30,320,173,147
11545,5308,Moravská Třebová,31,319,162,157
11546,5308,Moravská Třebová,32,341,189,152
11547,5308,Moravská Třebová,33,321,187,134
11548,5308,Moravská Třebová,34,296,166,130
11549,5308,Moravská Třebová,35,348,195,153
11550,5308,Moravská Třebová,36,314,163,151
11551,5308,Moravská Třebová,37,328,169,159
11552,5308,Moravská Třebová,38,301,151,150
11553,5308,Moravská Třebová,39,341,185,156
11554,5308,Moravská Třebová,40,331,176,155
11555,5308,Moravská Třebová,41,436,231,205
11556,5308,Moravská Třebová,42,416,212,204
11557,5308,Moravská Třebová,43,439,228,211
11558,5308,Moravská Třebová,44,441,237,204
11559,5308,Moravská Třebová,45,443,237,206
11560,5308,Moravská Třebová,46,450,225,225
11561,5308,Moravská Třebová,47,428,243,185
11562,5308,Moravská Třebová,48,381,189,192
11563,5308,Moravská Třebová,49,368,189,179
11564,5308,Moravská Třebová,50,336,177,159
11565,5308,Moravská Třebová,51,358,177,181
11566,5308,Moravská Třebová,52,334,172,162
11567,5308,Moravská Třebová,53,316,157,159
11568,5308,Moravská Třebová,54,332,171,161
11569,5308,Moravská Třebová,55,369,176,193
11570,5308,Moravská Třebová,56,376,207,169
11571,5308,Moravská Třebová,57,360,179,181
11572,5308,Moravská Třebová,58,302,137,165
11573,5308,Moravská Třebová,59,324,162,162
11574,5308,Moravská Třebová,60,321,153,168
11575,5308,Moravská Třebová,61,298,152,146
11576,5308,Moravská Třebová,62,330,169,161
11577,5308,Moravská Třebová,63,328,168,160
11578,5308,Moravská Třebová,64,362,177,185
11579,5308,Moravská Třebová,65,384,190,194
11580,5308,Moravská Třebová,66,348,156,192
11581,5308,Moravská Třebová,67,373,183,190
11582,5308,Moravská Třebová,68,344,149,195
11583,5308,Moravská Třebová,69,358,175,183
11584,5308,Moravská Třebová,70,359,171,188
11585,5308,Moravská Třebová,71,315,134,181
11586,5308,Moravská Třebová,72,328,137,191
11587,5308,Moravská Třebová,73,374,171,203
11588,5308,Moravská Třebová,74,290,127,163
11589,5308,Moravská Třebová,75,227,104,123
11590,5308,Moravská Třebová,76,226,97,129
11591,5308,Moravská Třebová,77,199,81,118
11592,5308,Moravská Třebová,78,191,75,116
11593,5308,Moravská Třebová,79,184,62,122
11594,5308,Moravská Třebová,80,170,59,111
11595,5308,Moravská Třebová,81,128,49,79
11596,5308,Moravská Třebová,82,120,38,82
11597,5308,Moravská Třebová,83,101,30,71
11598,5308,Moravská Třebová,84,85,32,53
11599,5308,Moravská Třebová,85,79,28,51
11600,5308,Moravská Třebová,86,84,31,53
11601,5308,Moravská Třebová,87,68,15,53
11602,5308,Moravská Třebová,88,71,21,50
11603,5308,Moravská Třebová,89,46,12,34
11604,5308,Moravská Třebová,90,24,5,19
11605,5308,Moravská Třebová,91,35,9,26
11606,5308,Moravská Třebová,92,21,7,14
11607,5308,Moravská Třebová,93,18,4,14
11608,5308,Moravská Třebová,94,12,2,10
11609,5308,Moravská Třebová,95,4,1,3
11610,5308,Moravská Třebová,96,5,2,3
11611,5308,Moravská Třebová,97,3,0,3
11612,5308,Moravská Třebová,98,3,0,3
11613,5308,Moravská Třebová,99,0,0,0
11614,5308,Moravská Třebová,100,2,1,1
11615,5309,Pardubice,0,1396,716,680
11616,5309,Pardubice,1,1467,790,677
11617,5309,Pardubice,2,1418,750,668
11618,5309,Pardubice,3,1379,712,667
11619,5309,Pardubice,4,1466,753,713
11620,5309,Pardubice,5,1426,726,700
11621,5309,Pardubice,6,1418,732,686
11622,5309,Pardubice,7,1392,680,712
11623,5309,Pardubice,8,1396,725,671
11624,5309,Pardubice,9,1330,686,644
11625,5309,Pardubice,10,1501,754,747
11626,5309,Pardubice,11,1498,762,736
11627,5309,Pardubice,12,1493,779,714
11628,5309,Pardubice,13,1479,734,745
11629,5309,Pardubice,14,1284,669,615
11630,5309,Pardubice,15,1141,608,533
11631,5309,Pardubice,16,1208,658,550
11632,5309,Pardubice,17,1078,573,505
11633,5309,Pardubice,18,1053,569,484
11634,5309,Pardubice,19,1059,562,497
11635,5309,Pardubice,20,1149,608,541
11636,5309,Pardubice,21,1146,603,543
11637,5309,Pardubice,22,1154,613,541
11638,5309,Pardubice,23,1248,638,610
11639,5309,Pardubice,24,1191,622,569
11640,5309,Pardubice,25,1240,623,617
11641,5309,Pardubice,26,1373,730,643
11642,5309,Pardubice,27,1596,795,801
11643,5309,Pardubice,28,1633,868,765
11644,5309,Pardubice,29,1815,965,850
11645,5309,Pardubice,30,1758,898,860
11646,5309,Pardubice,31,1837,963,874
11647,5309,Pardubice,32,1924,969,955
11648,5309,Pardubice,33,1940,1031,909
11649,5309,Pardubice,34,1956,1043,913
11650,5309,Pardubice,35,1978,1025,953
11651,5309,Pardubice,36,1947,981,966
11652,5309,Pardubice,37,1949,1063,886
11653,5309,Pardubice,38,1901,1022,879
11654,5309,Pardubice,39,1971,1034,937
11655,5309,Pardubice,40,1989,1053,936
11656,5309,Pardubice,41,2257,1153,1104
11657,5309,Pardubice,42,2308,1205,1103
11658,5309,Pardubice,43,2332,1238,1094
11659,5309,Pardubice,44,2339,1164,1175
11660,5309,Pardubice,45,2435,1283,1152
11661,5309,Pardubice,46,2275,1209,1066
11662,5309,Pardubice,47,2253,1183,1070
11663,5309,Pardubice,48,2023,1044,979
11664,5309,Pardubice,49,1851,943,908
11665,5309,Pardubice,50,1863,952,911
11666,5309,Pardubice,51,1781,893,888
11667,5309,Pardubice,52,1590,821,769
11668,5309,Pardubice,53,1638,844,794
11669,5309,Pardubice,54,1533,756,777
11670,5309,Pardubice,55,1656,825,831
11671,5309,Pardubice,56,1723,864,859
11672,5309,Pardubice,57,1632,812,820
11673,5309,Pardubice,58,1503,749,754
11674,5309,Pardubice,59,1442,693,749
11675,5309,Pardubice,60,1437,685,752
11676,5309,Pardubice,61,1346,663,683
11677,5309,Pardubice,62,1451,691,760
11678,5309,Pardubice,63,1569,764,805
11679,5309,Pardubice,64,1611,780,831
11680,5309,Pardubice,65,1666,801,865
11681,5309,Pardubice,66,1645,787,858
11682,5309,Pardubice,67,1670,780,890
11683,5309,Pardubice,68,1573,734,839
11684,5309,Pardubice,69,1498,673,825
11685,5309,Pardubice,70,1445,669,776
11686,5309,Pardubice,71,1367,596,771
11687,5309,Pardubice,72,1389,636,753
11688,5309,Pardubice,73,1457,629,828
11689,5309,Pardubice,74,1497,616,881
11690,5309,Pardubice,75,1063,438,625
11691,5309,Pardubice,76,1144,475,669
11692,5309,Pardubice,77,1086,450,636
11693,5309,Pardubice,78,921,387,534
11694,5309,Pardubice,79,828,333,495
11695,5309,Pardubice,80,813,309,504
11696,5309,Pardubice,81,736,295,441
11697,5309,Pardubice,82,648,255,393
11698,5309,Pardubice,83,547,169,378
11699,5309,Pardubice,84,566,175,391
11700,5309,Pardubice,85,498,175,323
11701,5309,Pardubice,86,492,164,328
11702,5309,Pardubice,87,424,155,269
11703,5309,Pardubice,88,405,129,276
11704,5309,Pardubice,89,318,93,225
11705,5309,Pardubice,90,267,100,167
11706,5309,Pardubice,91,223,86,137
11707,5309,Pardubice,92,148,42,106
11708,5309,Pardubice,93,112,39,73
11709,5309,Pardubice,94,86,29,57
11710,5309,Pardubice,95,55,16,39
11711,5309,Pardubice,96,33,5,28
11712,5309,Pardubice,97,26,3,23
11713,5309,Pardubice,98,16,6,10
11714,5309,Pardubice,99,7,2,5
11715,5309,Pardubice,100,9,4,5
11716,5310,Polička,0,209,104,105
11717,5310,Polička,1,200,108,92
11718,5310,Polička,2,215,102,113
11719,5310,Polička,3,202,102,100
11720,5310,Polička,4,206,105,101
11721,5310,Polička,5,230,119,111
11722,5310,Polička,6,200,102,98
11723,5310,Polička,7,203,109,94
11724,5310,Polička,8,212,117,95
11725,5310,Polička,9,216,99,117
11726,5310,Polička,10,223,111,112
11727,5310,Polička,11,192,99,93
11728,5310,Polička,12,232,122,110
11729,5310,Polička,13,222,108,114
11730,5310,Polička,14,195,103,92
11731,5310,Polička,15,206,98,108
11732,5310,Polička,16,189,89,100
11733,5310,Polička,17,207,100,107
11734,5310,Polička,18,173,98,75
11735,5310,Polička,19,204,95,109
11736,5310,Polička,20,171,88,83
11737,5310,Polička,21,206,105,101
11738,5310,Polička,22,218,125,93
11739,5310,Polička,23,199,105,94
11740,5310,Polička,24,213,127,86
11741,5310,Polička,25,207,111,96
11742,5310,Polička,26,226,114,112
11743,5310,Polička,27,275,153,122
11744,5310,Polička,28,280,151,129
11745,5310,Polička,29,259,135,124
11746,5310,Polička,30,251,130,121
11747,5310,Polička,31,219,113,106
11748,5310,Polička,32,244,130,114
11749,5310,Polička,33,223,123,100
11750,5310,Polička,34,205,115,90
11751,5310,Polička,35,239,118,121
11752,5310,Polička,36,259,136,123
11753,5310,Polička,37,241,137,104
11754,5310,Polička,38,272,142,130
11755,5310,Polička,39,276,144,132
11756,5310,Polička,40,283,134,149
11757,5310,Polička,41,295,157,138
11758,5310,Polička,42,314,154,160
11759,5310,Polička,43,285,147,138
11760,5310,Polička,44,343,166,177
11761,5310,Polička,45,354,161,193
11762,5310,Polička,46,351,182,169
11763,5310,Polička,47,355,198,157
11764,5310,Polička,48,292,144,148
11765,5310,Polička,49,259,130,129
11766,5310,Polička,50,274,138,136
11767,5310,Polička,51,244,126,118
11768,5310,Polička,52,223,124,99
11769,5310,Polička,53,242,118,124
11770,5310,Polička,54,238,114,124
11771,5310,Polička,55,256,133,123
11772,5310,Polička,56,267,137,130
11773,5310,Polička,57,240,117,123
11774,5310,Polička,58,256,145,111
11775,5310,Polička,59,223,114,109
11776,5310,Polička,60,207,108,99
11777,5310,Polička,61,208,95,113
11778,5310,Polička,62,254,121,133
11779,5310,Polička,63,250,124,126
11780,5310,Polička,64,282,135,147
11781,5310,Polička,65,224,106,118
11782,5310,Polička,66,249,131,118
11783,5310,Polička,67,245,112,133
11784,5310,Polička,68,275,136,139
11785,5310,Polička,69,259,114,145
11786,5310,Polička,70,231,96,135
11787,5310,Polička,71,219,95,124
11788,5310,Polička,72,257,115,142
11789,5310,Polička,73,223,101,122
11790,5310,Polička,74,182,81,101
11791,5310,Polička,75,145,64,81
11792,5310,Polička,76,196,86,110
11793,5310,Polička,77,156,56,100
11794,5310,Polička,78,123,48,75
11795,5310,Polička,79,136,57,79
11796,5310,Polička,80,107,37,70
11797,5310,Polička,81,88,30,58
11798,5310,Polička,82,85,30,55
11799,5310,Polička,83,87,36,51
11800,5310,Polička,84,76,25,51
11801,5310,Polička,85,68,27,41
11802,5310,Polička,86,72,19,53
11803,5310,Polička,87,60,18,42
11804,5310,Polička,88,65,21,44
11805,5310,Polička,89,46,15,31
11806,5310,Polička,90,32,6,26
11807,5310,Polička,91,27,9,18
11808,5310,Polička,92,19,8,11
11809,5310,Polička,93,20,5,15
11810,5310,Polička,94,10,3,7
11811,5310,Polička,95,7,2,5
11812,5310,Polička,96,5,1,4
11813,5310,Polička,97,4,0,4
11814,5310,Polička,98,0,0,0
11815,5310,Polička,99,2,0,2
11816,5310,Polička,100,1,1,0
11817,5311,Přelouč,0,265,135,130
11818,5311,Přelouč,1,288,150,138
11819,5311,Přelouč,2,265,145,120
11820,5311,Přelouč,3,243,123,120
11821,5311,Přelouč,4,291,139,152
11822,5311,Přelouč,5,282,150,132
11823,5311,Přelouč,6,249,120,129
11824,5311,Přelouč,7,245,126,119
11825,5311,Přelouč,8,279,142,137
11826,5311,Přelouč,9,283,159,124
11827,5311,Přelouč,10,263,142,121
11828,5311,Přelouč,11,274,134,140
11829,5311,Přelouč,12,290,152,138
11830,5311,Přelouč,13,260,123,137
11831,5311,Přelouč,14,240,134,106
11832,5311,Přelouč,15,215,105,110
11833,5311,Přelouč,16,241,119,122
11834,5311,Přelouč,17,217,106,111
11835,5311,Přelouč,18,195,108,87
11836,5311,Přelouč,19,221,110,111
11837,5311,Přelouč,20,233,113,120
11838,5311,Přelouč,21,249,108,141
11839,5311,Přelouč,22,230,126,104
11840,5311,Přelouč,23,253,141,112
11841,5311,Přelouč,24,259,139,120
11842,5311,Přelouč,25,233,133,100
11843,5311,Přelouč,26,273,141,132
11844,5311,Přelouč,27,306,181,125
11845,5311,Přelouč,28,341,180,161
11846,5311,Přelouč,29,335,189,146
11847,5311,Přelouč,30,339,185,154
11848,5311,Přelouč,31,347,184,163
11849,5311,Přelouč,32,367,192,175
11850,5311,Přelouč,33,371,200,171
11851,5311,Přelouč,34,352,169,183
11852,5311,Přelouč,35,342,174,168
11853,5311,Přelouč,36,382,220,162
11854,5311,Přelouč,37,372,199,173
11855,5311,Přelouč,38,401,209,192
11856,5311,Přelouč,39,404,227,177
11857,5311,Přelouč,40,422,232,190
11858,5311,Přelouč,41,396,214,182
11859,5311,Přelouč,42,429,233,196
11860,5311,Přelouč,43,444,222,222
11861,5311,Přelouč,44,446,243,203
11862,5311,Přelouč,45,487,250,237
11863,5311,Přelouč,46,490,253,237
11864,5311,Přelouč,47,435,239,196
11865,5311,Přelouč,48,409,227,182
11866,5311,Přelouč,49,404,224,180
11867,5311,Přelouč,50,334,177,157
11868,5311,Přelouč,51,325,191,134
11869,5311,Přelouč,52,299,152,147
11870,5311,Přelouč,53,293,164,129
11871,5311,Přelouč,54,314,161,153
11872,5311,Přelouč,55,310,152,158
11873,5311,Přelouč,56,315,155,160
11874,5311,Přelouč,57,302,154,148
11875,5311,Přelouč,58,299,153,146
11876,5311,Přelouč,59,297,134,163
11877,5311,Přelouč,60,306,159,147
11878,5311,Přelouč,61,318,155,163
11879,5311,Přelouč,62,349,177,172
11880,5311,Přelouč,63,370,172,198
11881,5311,Přelouč,64,362,179,183
11882,5311,Přelouč,65,412,191,221
11883,5311,Přelouč,66,378,192,186
11884,5311,Přelouč,67,356,182,174
11885,5311,Přelouč,68,343,170,173
11886,5311,Přelouč,69,340,155,185
11887,5311,Přelouč,70,311,148,163
11888,5311,Přelouč,71,278,132,146
11889,5311,Přelouč,72,283,127,156
11890,5311,Přelouč,73,287,120,167
11891,5311,Přelouč,74,289,128,161
11892,5311,Přelouč,75,216,100,116
11893,5311,Přelouč,76,192,79,113
11894,5311,Přelouč,77,208,86,122
11895,5311,Přelouč,78,179,84,95
11896,5311,Přelouč,79,151,67,84
11897,5311,Přelouč,80,161,53,108
11898,5311,Přelouč,81,153,59,94
11899,5311,Přelouč,82,112,49,63
11900,5311,Přelouč,83,108,44,64
11901,5311,Přelouč,84,84,28,56
11902,5311,Přelouč,85,87,33,54
11903,5311,Přelouč,86,68,24,44
11904,5311,Přelouč,87,66,19,47
11905,5311,Přelouč,88,70,16,54
11906,5311,Přelouč,89,54,18,36
11907,5311,Přelouč,90,37,9,28
11908,5311,Přelouč,91,33,8,25
11909,5311,Přelouč,92,26,8,18
11910,5311,Přelouč,93,19,3,16
11911,5311,Přelouč,94,19,2,17
11912,5311,Přelouč,95,8,1,7
11913,5311,Přelouč,96,6,0,6
11914,5311,Přelouč,97,2,0,2
11915,5311,Přelouč,98,0,0,0
11916,5311,Přelouč,99,1,0,1
11917,5311,Přelouč,100,3,0,3
11918,5312,Svitavy,0,313,153,160
11919,5312,Svitavy,1,318,173,145
11920,5312,Svitavy,2,300,137,163
11921,5312,Svitavy,3,296,159,137
11922,5312,Svitavy,4,315,155,160
11923,5312,Svitavy,5,291,133,158
11924,5312,Svitavy,6,322,155,167
11925,5312,Svitavy,7,292,131,161
11926,5312,Svitavy,8,329,148,181
11927,5312,Svitavy,9,331,159,172
11928,5312,Svitavy,10,381,193,188
11929,5312,Svitavy,11,378,188,190
11930,5312,Svitavy,12,378,186,192
11931,5312,Svitavy,13,391,188,203
11932,5312,Svitavy,14,320,175,145
11933,5312,Svitavy,15,343,168,175
11934,5312,Svitavy,16,303,159,144
11935,5312,Svitavy,17,317,170,147
11936,5312,Svitavy,18,330,175,155
11937,5312,Svitavy,19,284,142,142
11938,5312,Svitavy,20,313,155,158
11939,5312,Svitavy,21,284,145,139
11940,5312,Svitavy,22,296,145,151
11941,5312,Svitavy,23,306,165,141
11942,5312,Svitavy,24,303,164,139
11943,5312,Svitavy,25,326,174,152
11944,5312,Svitavy,26,350,175,175
11945,5312,Svitavy,27,396,209,187
11946,5312,Svitavy,28,383,196,187
11947,5312,Svitavy,29,376,205,171
11948,5312,Svitavy,30,383,209,174
11949,5312,Svitavy,31,358,197,161
11950,5312,Svitavy,32,391,190,201
11951,5312,Svitavy,33,383,214,169
11952,5312,Svitavy,34,372,198,174
11953,5312,Svitavy,35,380,188,192
11954,5312,Svitavy,36,391,215,176
11955,5312,Svitavy,37,387,198,189
11956,5312,Svitavy,38,433,235,198
11957,5312,Svitavy,39,395,188,207
11958,5312,Svitavy,40,433,217,216
11959,5312,Svitavy,41,478,247,231
11960,5312,Svitavy,42,501,241,260
11961,5312,Svitavy,43,545,288,257
11962,5312,Svitavy,44,541,285,256
11963,5312,Svitavy,45,573,309,264
11964,5312,Svitavy,46,653,325,328
11965,5312,Svitavy,47,551,299,252
11966,5312,Svitavy,48,508,256,252
11967,5312,Svitavy,49,475,234,241
11968,5312,Svitavy,50,427,222,205
11969,5312,Svitavy,51,421,225,196
11970,5312,Svitavy,52,397,195,202
11971,5312,Svitavy,53,342,178,164
11972,5312,Svitavy,54,383,186,197
11973,5312,Svitavy,55,365,184,181
11974,5312,Svitavy,56,428,208,220
11975,5312,Svitavy,57,404,205,199
11976,5312,Svitavy,58,339,166,173
11977,5312,Svitavy,59,316,164,152
11978,5312,Svitavy,60,347,159,188
11979,5312,Svitavy,61,338,155,183
11980,5312,Svitavy,62,355,168,187
11981,5312,Svitavy,63,441,203,238
11982,5312,Svitavy,64,456,216,240
11983,5312,Svitavy,65,375,184,191
11984,5312,Svitavy,66,448,200,248
11985,5312,Svitavy,67,397,171,226
11986,5312,Svitavy,68,448,206,242
11987,5312,Svitavy,69,458,215,243
11988,5312,Svitavy,70,411,192,219
11989,5312,Svitavy,71,410,171,239
11990,5312,Svitavy,72,386,177,209
11991,5312,Svitavy,73,401,171,230
11992,5312,Svitavy,74,378,153,225
11993,5312,Svitavy,75,289,113,176
11994,5312,Svitavy,76,262,116,146
11995,5312,Svitavy,77,275,111,164
11996,5312,Svitavy,78,225,93,132
11997,5312,Svitavy,79,205,83,122
11998,5312,Svitavy,80,166,63,103
11999,5312,Svitavy,81,156,57,99
12000,5312,Svitavy,82,131,56,75
12001,5312,Svitavy,83,109,41,68
12002,5312,Svitavy,84,89,32,57
12003,5312,Svitavy,85,79,21,58
12004,5312,Svitavy,86,77,26,51
12005,5312,Svitavy,87,81,24,57
12006,5312,Svitavy,88,77,22,55
12007,5312,Svitavy,89,62,15,47
12008,5312,Svitavy,90,34,8,26
12009,5312,Svitavy,91,36,6,30
12010,5312,Svitavy,92,27,6,21
12011,5312,Svitavy,93,15,5,10
12012,5312,Svitavy,94,16,3,13
12013,5312,Svitavy,95,9,2,7
12014,5312,Svitavy,96,6,1,5
12015,5312,Svitavy,97,5,0,5
12016,5312,Svitavy,98,3,1,2
12017,5312,Svitavy,99,0,0,0
12018,5312,Svitavy,100,4,2,2
12019,5313,Ústí nad Orlicí,0,255,121,134
12020,5313,Ústí nad Orlicí,1,321,173,148
12021,5313,Ústí nad Orlicí,2,302,152,150
12022,5313,Ústí nad Orlicí,3,268,136,132
12023,5313,Ústí nad Orlicí,4,275,148,127
12024,5313,Ústí nad Orlicí,5,276,153,123
12025,5313,Ústí nad Orlicí,6,265,146,119
12026,5313,Ústí nad Orlicí,7,242,138,104
12027,5313,Ústí nad Orlicí,8,274,142,132
12028,5313,Ústí nad Orlicí,9,277,146,131
12029,5313,Ústí nad Orlicí,10,263,147,116
12030,5313,Ústí nad Orlicí,11,310,153,157
12031,5313,Ústí nad Orlicí,12,310,164,146
12032,5313,Ústí nad Orlicí,13,284,142,142
12033,5313,Ústí nad Orlicí,14,308,153,155
12034,5313,Ústí nad Orlicí,15,254,133,121
12035,5313,Ústí nad Orlicí,16,265,147,118
12036,5313,Ústí nad Orlicí,17,248,133,115
12037,5313,Ústí nad Orlicí,18,267,146,121
12038,5313,Ústí nad Orlicí,19,272,142,130
12039,5313,Ústí nad Orlicí,20,250,130,120
12040,5313,Ústí nad Orlicí,21,247,119,128
12041,5313,Ústí nad Orlicí,22,242,139,103
12042,5313,Ústí nad Orlicí,23,278,140,138
12043,5313,Ústí nad Orlicí,24,242,121,121
12044,5313,Ústí nad Orlicí,25,280,148,132
12045,5313,Ústí nad Orlicí,26,271,137,134
12046,5313,Ústí nad Orlicí,27,310,163,147
12047,5313,Ústí nad Orlicí,28,340,170,170
12048,5313,Ústí nad Orlicí,29,329,173,156
12049,5313,Ústí nad Orlicí,30,398,200,198
12050,5313,Ústí nad Orlicí,31,326,170,156
12051,5313,Ústí nad Orlicí,32,342,179,163
12052,5313,Ústí nad Orlicí,33,310,161,149
12053,5313,Ústí nad Orlicí,34,329,178,151
12054,5313,Ústí nad Orlicí,35,319,176,143
12055,5313,Ústí nad Orlicí,36,317,151,166
12056,5313,Ústí nad Orlicí,37,321,191,130
12057,5313,Ústí nad Orlicí,38,334,180,154
12058,5313,Ústí nad Orlicí,39,366,187,179
12059,5313,Ústí nad Orlicí,40,385,198,187
12060,5313,Ústí nad Orlicí,41,407,209,198
12061,5313,Ústí nad Orlicí,42,418,209,209
12062,5313,Ústí nad Orlicí,43,439,234,205
12063,5313,Ústí nad Orlicí,44,472,237,235
12064,5313,Ústí nad Orlicí,45,480,237,243
12065,5313,Ústí nad Orlicí,46,434,228,206
12066,5313,Ústí nad Orlicí,47,465,246,219
12067,5313,Ústí nad Orlicí,48,409,205,204
12068,5313,Ústí nad Orlicí,49,406,216,190
12069,5313,Ústí nad Orlicí,50,365,190,175
12070,5313,Ústí nad Orlicí,51,323,170,153
12071,5313,Ústí nad Orlicí,52,344,177,167
12072,5313,Ústí nad Orlicí,53,340,178,162
12073,5313,Ústí nad Orlicí,54,347,168,179
12074,5313,Ústí nad Orlicí,55,351,178,173
12075,5313,Ústí nad Orlicí,56,361,178,183
12076,5313,Ústí nad Orlicí,57,318,158,160
12077,5313,Ústí nad Orlicí,58,300,147,153
12078,5313,Ústí nad Orlicí,59,295,149,146
12079,5313,Ústí nad Orlicí,60,267,131,136
12080,5313,Ústí nad Orlicí,61,254,130,124
12081,5313,Ústí nad Orlicí,62,315,158,157
12082,5313,Ústí nad Orlicí,63,340,160,180
12083,5313,Ústí nad Orlicí,64,319,146,173
12084,5313,Ústí nad Orlicí,65,304,150,154
12085,5313,Ústí nad Orlicí,66,357,151,206
12086,5313,Ústí nad Orlicí,67,369,156,213
12087,5313,Ústí nad Orlicí,68,364,180,184
12088,5313,Ústí nad Orlicí,69,372,159,213
12089,5313,Ústí nad Orlicí,70,342,174,168
12090,5313,Ústí nad Orlicí,71,325,141,184
12091,5313,Ústí nad Orlicí,72,333,154,179
12092,5313,Ústí nad Orlicí,73,320,147,173
12093,5313,Ústí nad Orlicí,74,384,172,212
12094,5313,Ústí nad Orlicí,75,266,116,150
12095,5313,Ústí nad Orlicí,76,217,88,129
12096,5313,Ústí nad Orlicí,77,201,85,116
12097,5313,Ústí nad Orlicí,78,180,60,120
12098,5313,Ústí nad Orlicí,79,211,85,126
12099,5313,Ústí nad Orlicí,80,157,57,100
12100,5313,Ústí nad Orlicí,81,127,46,81
12101,5313,Ústí nad Orlicí,82,115,35,80
12102,5313,Ústí nad Orlicí,83,100,41,59
12103,5313,Ústí nad Orlicí,84,109,33,76
12104,5313,Ústí nad Orlicí,85,85,28,57
12105,5313,Ústí nad Orlicí,86,78,22,56
12106,5313,Ústí nad Orlicí,87,72,21,51
12107,5313,Ústí nad Orlicí,88,57,18,39
12108,5313,Ústí nad Orlicí,89,66,25,41
12109,5313,Ústí nad Orlicí,90,49,9,40
12110,5313,Ústí nad Orlicí,91,32,12,20
12111,5313,Ústí nad Orlicí,92,30,9,21
12112,5313,Ústí nad Orlicí,93,16,7,9
12113,5313,Ústí nad Orlicí,94,13,6,7
12114,5313,Ústí nad Orlicí,95,10,2,8
12115,5313,Ústí nad Orlicí,96,5,3,2
12116,5313,Ústí nad Orlicí,97,3,1,2
12117,5313,Ústí nad Orlicí,98,1,0,1
12118,5313,Ústí nad Orlicí,99,0,0,0
12119,5313,Ústí nad Orlicí,100,0,0,0
12120,5314,Vysoké Mýto,0,337,168,169
12121,5314,Vysoké Mýto,1,329,160,169
12122,5314,Vysoké Mýto,2,324,161,163
12123,5314,Vysoké Mýto,3,333,183,150
12124,5314,Vysoké Mýto,4,318,170,148
12125,5314,Vysoké Mýto,5,327,178,149
12126,5314,Vysoké Mýto,6,355,180,175
12127,5314,Vysoké Mýto,7,358,191,167
12128,5314,Vysoké Mýto,8,344,185,159
12129,5314,Vysoké Mýto,9,365,199,166
12130,5314,Vysoké Mýto,10,400,219,181
12131,5314,Vysoké Mýto,11,343,169,174
12132,5314,Vysoké Mýto,12,419,210,209
12133,5314,Vysoké Mýto,13,370,198,172
12134,5314,Vysoké Mýto,14,361,185,176
12135,5314,Vysoké Mýto,15,320,174,146
12136,5314,Vysoké Mýto,16,337,167,170
12137,5314,Vysoké Mýto,17,302,147,155
12138,5314,Vysoké Mýto,18,307,155,152
12139,5314,Vysoké Mýto,19,294,141,153
12140,5314,Vysoké Mýto,20,292,162,130
12141,5314,Vysoké Mýto,21,337,187,150
12142,5314,Vysoké Mýto,22,354,173,181
12143,5314,Vysoké Mýto,23,310,153,157
12144,5314,Vysoké Mýto,24,335,176,159
12145,5314,Vysoké Mýto,25,354,201,153
12146,5314,Vysoké Mýto,26,348,189,159
12147,5314,Vysoké Mýto,27,373,187,186
12148,5314,Vysoké Mýto,28,378,202,176
12149,5314,Vysoké Mýto,29,408,221,187
12150,5314,Vysoké Mýto,30,361,192,169
12151,5314,Vysoké Mýto,31,387,195,192
12152,5314,Vysoké Mýto,32,384,202,182
12153,5314,Vysoké Mýto,33,434,228,206
12154,5314,Vysoké Mýto,34,371,190,181
12155,5314,Vysoké Mýto,35,414,217,197
12156,5314,Vysoké Mýto,36,383,199,184
12157,5314,Vysoké Mýto,37,392,206,186
12158,5314,Vysoké Mýto,38,393,209,184
12159,5314,Vysoké Mýto,39,389,187,202
12160,5314,Vysoké Mýto,40,466,251,215
12161,5314,Vysoké Mýto,41,561,316,245
12162,5314,Vysoké Mýto,42,561,285,276
12163,5314,Vysoké Mýto,43,603,322,281
12164,5314,Vysoké Mýto,44,630,326,304
12165,5314,Vysoké Mýto,45,624,330,294
12166,5314,Vysoké Mýto,46,631,344,287
12167,5314,Vysoké Mýto,47,534,275,259
12168,5314,Vysoké Mýto,48,484,238,246
12169,5314,Vysoké Mýto,49,452,212,240
12170,5314,Vysoké Mýto,50,416,208,208
12171,5314,Vysoké Mýto,51,426,240,186
12172,5314,Vysoké Mýto,52,427,214,213
12173,5314,Vysoké Mýto,53,382,193,189
12174,5314,Vysoké Mýto,54,398,227,171
12175,5314,Vysoké Mýto,55,437,225,212
12176,5314,Vysoké Mýto,56,372,199,173
12177,5314,Vysoké Mýto,57,382,189,193
12178,5314,Vysoké Mýto,58,370,191,179
12179,5314,Vysoké Mýto,59,359,178,181
12180,5314,Vysoké Mýto,60,336,167,169
12181,5314,Vysoké Mýto,61,379,199,180
12182,5314,Vysoké Mýto,62,370,185,185
12183,5314,Vysoké Mýto,63,433,218,215
12184,5314,Vysoké Mýto,64,432,200,232
12185,5314,Vysoké Mýto,65,432,210,222
12186,5314,Vysoké Mýto,66,432,207,225
12187,5314,Vysoké Mýto,67,430,215,215
12188,5314,Vysoké Mýto,68,465,196,269
12189,5314,Vysoké Mýto,69,416,195,221
12190,5314,Vysoké Mýto,70,429,192,237
12191,5314,Vysoké Mýto,71,408,202,206
12192,5314,Vysoké Mýto,72,374,167,207
12193,5314,Vysoké Mýto,73,359,174,185
12194,5314,Vysoké Mýto,74,340,148,192
12195,5314,Vysoké Mýto,75,281,117,164
12196,5314,Vysoké Mýto,76,256,111,145
12197,5314,Vysoké Mýto,77,254,107,147
12198,5314,Vysoké Mýto,78,212,89,123
12199,5314,Vysoké Mýto,79,199,73,126
12200,5314,Vysoké Mýto,80,185,65,120
12201,5314,Vysoké Mýto,81,159,62,97
12202,5314,Vysoké Mýto,82,138,59,79
12203,5314,Vysoké Mýto,83,158,48,110
12204,5314,Vysoké Mýto,84,103,32,71
12205,5314,Vysoké Mýto,85,121,40,81
12206,5314,Vysoké Mýto,86,128,43,85
12207,5314,Vysoké Mýto,87,107,38,69
12208,5314,Vysoké Mýto,88,102,26,76
12209,5314,Vysoké Mýto,89,73,28,45
12210,5314,Vysoké Mýto,90,65,22,43
12211,5314,Vysoké Mýto,91,38,13,25
12212,5314,Vysoké Mýto,92,35,14,21
12213,5314,Vysoké Mýto,93,19,5,14
12214,5314,Vysoké Mýto,94,20,6,14
12215,5314,Vysoké Mýto,95,11,2,9
12216,5314,Vysoké Mýto,96,17,1,16
12217,5314,Vysoké Mýto,97,5,0,5
12218,5314,Vysoké Mýto,98,2,0,2
12219,5314,Vysoké Mýto,99,2,0,2
12220,5314,Vysoké Mýto,100,2,2,0
12221,5315,Žamberk,0,337,171,166
12222,5315,Žamberk,1,347,181,166
12223,5315,Žamberk,2,373,200,173
12224,5315,Žamberk,3,329,152,177
12225,5315,Žamberk,4,337,177,160
12226,5315,Žamberk,5,302,159,143
12227,5315,Žamberk,6,332,158,174
12228,5315,Žamberk,7,305,133,172
12229,5315,Žamberk,8,324,171,153
12230,5315,Žamberk,9,274,124,150
12231,5315,Žamberk,10,366,182,184
12232,5315,Žamberk,11,302,163,139
12233,5315,Žamberk,12,323,154,169
12234,5315,Žamberk,13,333,176,157
12235,5315,Žamberk,14,325,180,145
12236,5315,Žamberk,15,329,165,164
12237,5315,Žamberk,16,295,157,138
12238,5315,Žamberk,17,274,146,128
12239,5315,Žamberk,18,317,170,147
12240,5315,Žamberk,19,261,140,121
12241,5315,Žamberk,20,270,147,123
12242,5315,Žamberk,21,291,151,140
12243,5315,Žamberk,22,272,136,136
12244,5315,Žamberk,23,290,153,137
12245,5315,Žamberk,24,294,154,140
12246,5315,Žamberk,25,292,162,130
12247,5315,Žamberk,26,365,193,172
12248,5315,Žamberk,27,401,222,179
12249,5315,Žamberk,28,416,225,191
12250,5315,Žamberk,29,406,207,199
12251,5315,Žamberk,30,409,197,212
12252,5315,Žamberk,31,344,172,172
12253,5315,Žamberk,32,357,180,177
12254,5315,Žamberk,33,366,205,161
12255,5315,Žamberk,34,384,192,192
12256,5315,Žamberk,35,383,211,172
12257,5315,Žamberk,36,388,206,182
12258,5315,Žamberk,37,356,186,170
12259,5315,Žamberk,38,410,214,196
12260,5315,Žamberk,39,415,221,194
12261,5315,Žamberk,40,426,252,174
12262,5315,Žamberk,41,454,254,200
12263,5315,Žamberk,42,450,237,213
12264,5315,Žamberk,43,469,249,220
12265,5315,Žamberk,44,496,242,254
12266,5315,Žamberk,45,502,250,252
12267,5315,Žamberk,46,496,252,244
12268,5315,Žamberk,47,466,231,235
12269,5315,Žamberk,48,464,236,228
12270,5315,Žamberk,49,431,212,219
12271,5315,Žamberk,50,367,192,175
12272,5315,Žamberk,51,398,197,201
12273,5315,Žamberk,52,394,194,200
12274,5315,Žamberk,53,389,190,199
12275,5315,Žamberk,54,350,169,181
12276,5315,Žamberk,55,388,186,202
12277,5315,Žamberk,56,404,208,196
12278,5315,Žamberk,57,403,197,206
12279,5315,Žamberk,58,352,175,177
12280,5315,Žamberk,59,359,188,171
12281,5315,Žamberk,60,329,166,163
12282,5315,Žamberk,61,322,153,169
12283,5315,Žamberk,62,369,191,178
12284,5315,Žamberk,63,355,188,167
12285,5315,Žamberk,64,356,176,180
12286,5315,Žamberk,65,378,188,190
12287,5315,Žamberk,66,353,157,196
12288,5315,Žamberk,67,388,199,189
12289,5315,Žamberk,68,373,190,183
12290,5315,Žamberk,69,339,149,190
12291,5315,Žamberk,70,366,179,187
12292,5315,Žamberk,71,332,154,178
12293,5315,Žamberk,72,331,149,182
12294,5315,Žamberk,73,331,140,191
12295,5315,Žamberk,74,303,133,170
12296,5315,Žamberk,75,254,111,143
12297,5315,Žamberk,76,267,137,130
12298,5315,Žamberk,77,216,96,120
12299,5315,Žamberk,78,197,86,111
12300,5315,Žamberk,79,181,74,107
12301,5315,Žamberk,80,157,65,92
12302,5315,Žamberk,81,146,62,84
12303,5315,Žamberk,82,114,48,66
12304,5315,Žamberk,83,134,45,89
12305,5315,Žamberk,84,105,35,70
12306,5315,Žamberk,85,90,34,56
12307,5315,Žamberk,86,76,29,47
12308,5315,Žamberk,87,74,26,48
12309,5315,Žamberk,88,60,23,37
12310,5315,Žamberk,89,58,22,36
12311,5315,Žamberk,90,35,11,24
12312,5315,Žamberk,91,30,9,21
12313,5315,Žamberk,92,27,7,20
12314,5315,Žamberk,93,18,5,13
12315,5315,Žamberk,94,13,1,12
12316,5315,Žamberk,95,14,4,10
12317,5315,Žamberk,96,4,0,4
12318,5315,Žamberk,97,6,0,6
12319,5315,Žamberk,98,5,1,4
12320,5315,Žamberk,99,1,0,1
12321,5315,Žamberk,100,3,0,3
12322,6301,Bystřice nad Pernštejnem,0,204,111,93
12323,6301,Bystřice nad Pernštejnem,1,198,84,114
12324,6301,Bystřice nad Pernštejnem,2,224,113,111
12325,6301,Bystřice nad Pernštejnem,3,170,97,73
12326,6301,Bystřice nad Pernštejnem,4,229,149,80
12327,6301,Bystřice nad Pernštejnem,5,180,79,101
12328,6301,Bystřice nad Pernštejnem,6,190,92,98
12329,6301,Bystřice nad Pernštejnem,7,188,99,89
12330,6301,Bystřice nad Pernštejnem,8,174,87,87
12331,6301,Bystřice nad Pernštejnem,9,169,89,80
12332,6301,Bystřice nad Pernštejnem,10,160,84,76
12333,6301,Bystřice nad Pernštejnem,11,199,94,105
12334,6301,Bystřice nad Pernštejnem,12,224,124,100
12335,6301,Bystřice nad Pernštejnem,13,194,102,92
12336,6301,Bystřice nad Pernštejnem,14,186,93,93
12337,6301,Bystřice nad Pernštejnem,15,194,84,110
12338,6301,Bystřice nad Pernštejnem,16,169,89,80
12339,6301,Bystřice nad Pernštejnem,17,210,105,105
12340,6301,Bystřice nad Pernštejnem,18,203,106,97
12341,6301,Bystřice nad Pernštejnem,19,182,88,94
12342,6301,Bystřice nad Pernštejnem,20,177,96,81
12343,6301,Bystřice nad Pernštejnem,21,183,97,86
12344,6301,Bystřice nad Pernštejnem,22,200,97,103
12345,6301,Bystřice nad Pernštejnem,23,222,109,113
12346,6301,Bystřice nad Pernštejnem,24,193,103,90
12347,6301,Bystřice nad Pernštejnem,25,214,125,89
12348,6301,Bystřice nad Pernštejnem,26,236,123,113
12349,6301,Bystřice nad Pernštejnem,27,256,125,131
12350,6301,Bystřice nad Pernštejnem,28,226,125,101
12351,6301,Bystřice nad Pernštejnem,29,244,127,117
12352,6301,Bystřice nad Pernštejnem,30,255,136,119
12353,6301,Bystřice nad Pernštejnem,31,240,137,103
12354,6301,Bystřice nad Pernštejnem,32,245,129,116
12355,6301,Bystřice nad Pernštejnem,33,250,126,124
12356,6301,Bystřice nad Pernštejnem,34,252,130,122
12357,6301,Bystřice nad Pernštejnem,35,227,111,116
12358,6301,Bystřice nad Pernštejnem,36,268,157,111
12359,6301,Bystřice nad Pernštejnem,37,243,144,99
12360,6301,Bystřice nad Pernštejnem,38,254,132,122
12361,6301,Bystřice nad Pernštejnem,39,247,142,105
12362,6301,Bystřice nad Pernštejnem,40,256,134,122
12363,6301,Bystřice nad Pernštejnem,41,288,155,133
12364,6301,Bystřice nad Pernštejnem,42,275,146,129
12365,6301,Bystřice nad Pernštejnem,43,305,152,153
12366,6301,Bystřice nad Pernštejnem,44,339,183,156
12367,6301,Bystřice nad Pernštejnem,45,342,172,170
12368,6301,Bystřice nad Pernštejnem,46,341,183,158
12369,6301,Bystřice nad Pernštejnem,47,318,184,134
12370,6301,Bystřice nad Pernštejnem,48,294,151,143
12371,6301,Bystřice nad Pernštejnem,49,245,119,126
12372,6301,Bystřice nad Pernštejnem,50,277,135,142
12373,6301,Bystřice nad Pernštejnem,51,251,139,112
12374,6301,Bystřice nad Pernštejnem,52,258,138,120
12375,6301,Bystřice nad Pernštejnem,53,288,141,147
12376,6301,Bystřice nad Pernštejnem,54,284,167,117
12377,6301,Bystřice nad Pernštejnem,55,297,158,139
12378,6301,Bystřice nad Pernštejnem,56,284,146,138
12379,6301,Bystřice nad Pernštejnem,57,238,129,109
12380,6301,Bystřice nad Pernštejnem,58,249,134,115
12381,6301,Bystřice nad Pernštejnem,59,251,127,124
12382,6301,Bystřice nad Pernštejnem,60,217,115,102
12383,6301,Bystřice nad Pernštejnem,61,234,116,118
12384,6301,Bystřice nad Pernštejnem,62,255,134,121
12385,6301,Bystřice nad Pernštejnem,63,255,128,127
12386,6301,Bystřice nad Pernštejnem,64,267,129,138
12387,6301,Bystřice nad Pernštejnem,65,270,136,134
12388,6301,Bystřice nad Pernštejnem,66,248,102,146
12389,6301,Bystřice nad Pernštejnem,67,267,117,150
12390,6301,Bystřice nad Pernštejnem,68,258,117,141
12391,6301,Bystřice nad Pernštejnem,69,262,123,139
12392,6301,Bystřice nad Pernštejnem,70,235,114,121
12393,6301,Bystřice nad Pernštejnem,71,244,126,118
12394,6301,Bystřice nad Pernštejnem,72,218,111,107
12395,6301,Bystřice nad Pernštejnem,73,238,111,127
12396,6301,Bystřice nad Pernštejnem,74,234,102,132
12397,6301,Bystřice nad Pernštejnem,75,201,73,128
12398,6301,Bystřice nad Pernštejnem,76,190,84,106
12399,6301,Bystřice nad Pernštejnem,77,175,60,115
12400,6301,Bystřice nad Pernštejnem,78,156,65,91
12401,6301,Bystřice nad Pernštejnem,79,136,53,83
12402,6301,Bystřice nad Pernštejnem,80,133,55,78
12403,6301,Bystřice nad Pernštejnem,81,131,46,85
12404,6301,Bystřice nad Pernštejnem,82,111,42,69
12405,6301,Bystřice nad Pernštejnem,83,96,34,62
12406,6301,Bystřice nad Pernštejnem,84,84,28,56
12407,6301,Bystřice nad Pernštejnem,85,75,26,49
12408,6301,Bystřice nad Pernštejnem,86,69,21,48
12409,6301,Bystřice nad Pernštejnem,87,59,12,47
12410,6301,Bystřice nad Pernštejnem,88,51,22,29
12411,6301,Bystřice nad Pernštejnem,89,37,8,29
12412,6301,Bystřice nad Pernštejnem,90,26,4,22
12413,6301,Bystřice nad Pernštejnem,91,16,6,10
12414,6301,Bystřice nad Pernštejnem,92,12,1,11
12415,6301,Bystřice nad Pernštejnem,93,16,3,13
12416,6301,Bystřice nad Pernštejnem,94,9,3,6
12417,6301,Bystřice nad Pernštejnem,95,7,1,6
12418,6301,Bystřice nad Pernštejnem,96,7,3,4
12419,6301,Bystřice nad Pernštejnem,97,2,1,1
12420,6301,Bystřice nad Pernštejnem,98,1,0,1
12421,6301,Bystřice nad Pernštejnem,99,1,1,0
12422,6301,Bystřice nad Pernštejnem,100,3,0,3
12423,6302,Havlíčkův Brod,0,589,292,297
12424,6302,Havlíčkův Brod,1,597,322,275
12425,6302,Havlíčkův Brod,2,601,319,282
12426,6302,Havlíčkův Brod,3,577,276,301
12427,6302,Havlíčkův Brod,4,558,287,271
12428,6302,Havlíčkův Brod,5,563,292,271
12429,6302,Havlíčkův Brod,6,602,326,276
12430,6302,Havlíčkův Brod,7,525,287,238
12431,6302,Havlíčkův Brod,8,588,317,271
12432,6302,Havlíčkův Brod,9,540,288,252
12433,6302,Havlíčkův Brod,10,627,321,306
12434,6302,Havlíčkův Brod,11,587,309,278
12435,6302,Havlíčkův Brod,12,622,324,298
12436,6302,Havlíčkův Brod,13,626,319,307
12437,6302,Havlíčkův Brod,14,545,257,288
12438,6302,Havlíčkův Brod,15,526,275,251
12439,6302,Havlíčkův Brod,16,502,265,237
12440,6302,Havlíčkův Brod,17,469,216,253
12441,6302,Havlíčkův Brod,18,485,229,256
12442,6302,Havlíčkův Brod,19,439,232,207
12443,6302,Havlíčkův Brod,20,484,265,219
12444,6302,Havlíčkův Brod,21,471,249,222
12445,6302,Havlíčkův Brod,22,520,264,256
12446,6302,Havlíčkův Brod,23,486,246,240
12447,6302,Havlíčkův Brod,24,493,253,240
12448,6302,Havlíčkův Brod,25,521,282,239
12449,6302,Havlíčkův Brod,26,599,302,297
12450,6302,Havlíčkův Brod,27,641,337,304
12451,6302,Havlíčkův Brod,28,645,350,295
12452,6302,Havlíčkův Brod,29,663,333,330
12453,6302,Havlíčkův Brod,30,673,347,326
12454,6302,Havlíčkův Brod,31,636,349,287
12455,6302,Havlíčkův Brod,32,682,347,335
12456,6302,Havlíčkův Brod,33,673,343,330
12457,6302,Havlíčkův Brod,34,663,356,307
12458,6302,Havlíčkův Brod,35,733,373,360
12459,6302,Havlíčkův Brod,36,723,368,355
12460,6302,Havlíčkův Brod,37,667,342,325
12461,6302,Havlíčkův Brod,38,756,414,342
12462,6302,Havlíčkův Brod,39,709,366,343
12463,6302,Havlíčkův Brod,40,779,418,361
12464,6302,Havlíčkův Brod,41,771,404,367
12465,6302,Havlíčkův Brod,42,809,405,404
12466,6302,Havlíčkův Brod,43,866,426,440
12467,6302,Havlíčkův Brod,44,935,484,451
12468,6302,Havlíčkův Brod,45,901,455,446
12469,6302,Havlíčkův Brod,46,941,468,473
12470,6302,Havlíčkův Brod,47,816,424,392
12471,6302,Havlíčkův Brod,48,794,396,398
12472,6302,Havlíčkův Brod,49,748,391,357
12473,6302,Havlíčkův Brod,50,713,350,363
12474,6302,Havlíčkův Brod,51,667,348,319
12475,6302,Havlíčkův Brod,52,624,301,323
12476,6302,Havlíčkův Brod,53,665,350,315
12477,6302,Havlíčkův Brod,54,648,353,295
12478,6302,Havlíčkův Brod,55,659,311,348
12479,6302,Havlíčkův Brod,56,743,371,372
12480,6302,Havlíčkův Brod,57,778,399,379
12481,6302,Havlíčkův Brod,58,630,324,306
12482,6302,Havlíčkův Brod,59,632,312,320
12483,6302,Havlíčkův Brod,60,595,299,296
12484,6302,Havlíčkův Brod,61,614,291,323
12485,6302,Havlíčkův Brod,62,648,343,305
12486,6302,Havlíčkův Brod,63,655,327,328
12487,6302,Havlíčkův Brod,64,691,344,347
12488,6302,Havlíčkův Brod,65,734,357,377
12489,6302,Havlíčkův Brod,66,620,289,331
12490,6302,Havlíčkův Brod,67,652,297,355
12491,6302,Havlíčkův Brod,68,688,341,347
12492,6302,Havlíčkův Brod,69,732,349,383
12493,6302,Havlíčkův Brod,70,622,299,323
12494,6302,Havlíčkův Brod,71,658,290,368
12495,6302,Havlíčkův Brod,72,621,292,329
12496,6302,Havlíčkův Brod,73,626,297,329
12497,6302,Havlíčkův Brod,74,593,257,336
12498,6302,Havlíčkův Brod,75,455,194,261
12499,6302,Havlíčkův Brod,76,444,186,258
12500,6302,Havlíčkův Brod,77,438,182,256
12501,6302,Havlíčkův Brod,78,380,159,221
12502,6302,Havlíčkův Brod,79,334,133,201
12503,6302,Havlíčkův Brod,80,302,111,191
12504,6302,Havlíčkův Brod,81,277,95,182
12505,6302,Havlíčkův Brod,82,261,98,163
12506,6302,Havlíčkův Brod,83,210,66,144
12507,6302,Havlíčkův Brod,84,205,69,136
12508,6302,Havlíčkův Brod,85,189,57,132
12509,6302,Havlíčkův Brod,86,154,50,104
12510,6302,Havlíčkův Brod,87,154,54,100
12511,6302,Havlíčkův Brod,88,152,42,110
12512,6302,Havlíčkův Brod,89,123,46,77
12513,6302,Havlíčkův Brod,90,94,30,64
12514,6302,Havlíčkův Brod,91,61,20,41
12515,6302,Havlíčkův Brod,92,47,15,32
12516,6302,Havlíčkův Brod,93,27,7,20
12517,6302,Havlíčkův Brod,94,29,3,26
12518,6302,Havlíčkův Brod,95,13,5,8
12519,6302,Havlíčkův Brod,96,10,1,9
12520,6302,Havlíčkův Brod,97,9,1,8
12521,6302,Havlíčkův Brod,98,5,0,5
12522,6302,Havlíčkův Brod,99,3,0,3
12523,6302,Havlíčkův Brod,100,2,0,2
12524,6303,Humpolec,0,206,108,98
12525,6303,Humpolec,1,209,105,104
12526,6303,Humpolec,2,188,99,89
12527,6303,Humpolec,3,190,97,93
12528,6303,Humpolec,4,176,94,82
12529,6303,Humpolec,5,176,91,85
12530,6303,Humpolec,6,204,113,91
12531,6303,Humpolec,7,178,90,88
12532,6303,Humpolec,8,199,91,108
12533,6303,Humpolec,9,196,99,97
12534,6303,Humpolec,10,170,88,82
12535,6303,Humpolec,11,199,112,87
12536,6303,Humpolec,12,204,98,106
12537,6303,Humpolec,13,158,83,75
12538,6303,Humpolec,14,163,87,76
12539,6303,Humpolec,15,187,102,85
12540,6303,Humpolec,16,139,71,68
12541,6303,Humpolec,17,175,88,87
12542,6303,Humpolec,18,159,88,71
12543,6303,Humpolec,19,147,82,65
12544,6303,Humpolec,20,157,75,82
12545,6303,Humpolec,21,161,76,85
12546,6303,Humpolec,22,195,98,97
12547,6303,Humpolec,23,180,92,88
12548,6303,Humpolec,24,158,77,81
12549,6303,Humpolec,25,168,98,70
12550,6303,Humpolec,26,213,112,101
12551,6303,Humpolec,27,229,128,101
12552,6303,Humpolec,28,228,119,109
12553,6303,Humpolec,29,222,112,110
12554,6303,Humpolec,30,209,111,98
12555,6303,Humpolec,31,201,112,89
12556,6303,Humpolec,32,218,112,106
12557,6303,Humpolec,33,238,120,118
12558,6303,Humpolec,34,274,138,136
12559,6303,Humpolec,35,234,106,128
12560,6303,Humpolec,36,258,131,127
12561,6303,Humpolec,37,239,119,120
12562,6303,Humpolec,38,247,123,124
12563,6303,Humpolec,39,263,123,140
12564,6303,Humpolec,40,254,142,112
12565,6303,Humpolec,41,255,145,110
12566,6303,Humpolec,42,285,160,125
12567,6303,Humpolec,43,289,167,122
12568,6303,Humpolec,44,331,172,159
12569,6303,Humpolec,45,290,153,137
12570,6303,Humpolec,46,293,163,130
12571,6303,Humpolec,47,275,138,137
12572,6303,Humpolec,48,270,121,149
12573,6303,Humpolec,49,261,139,122
12574,6303,Humpolec,50,281,148,133
12575,6303,Humpolec,51,205,119,86
12576,6303,Humpolec,52,225,121,104
12577,6303,Humpolec,53,211,101,110
12578,6303,Humpolec,54,228,116,112
12579,6303,Humpolec,55,225,119,106
12580,6303,Humpolec,56,226,110,116
12581,6303,Humpolec,57,238,122,116
12582,6303,Humpolec,58,227,112,115
12583,6303,Humpolec,59,189,97,92
12584,6303,Humpolec,60,234,136,98
12585,6303,Humpolec,61,217,100,117
12586,6303,Humpolec,62,233,114,119
12587,6303,Humpolec,63,225,122,103
12588,6303,Humpolec,64,224,119,105
12589,6303,Humpolec,65,268,126,142
12590,6303,Humpolec,66,205,114,91
12591,6303,Humpolec,67,201,96,105
12592,6303,Humpolec,68,217,110,107
12593,6303,Humpolec,69,226,109,117
12594,6303,Humpolec,70,237,114,123
12595,6303,Humpolec,71,183,91,92
12596,6303,Humpolec,72,243,111,132
12597,6303,Humpolec,73,189,74,115
12598,6303,Humpolec,74,201,89,112
12599,6303,Humpolec,75,178,72,106
12600,6303,Humpolec,76,165,71,94
12601,6303,Humpolec,77,157,59,98
12602,6303,Humpolec,78,126,56,70
12603,6303,Humpolec,79,137,48,89
12604,6303,Humpolec,80,120,45,75
12605,6303,Humpolec,81,110,37,73
12606,6303,Humpolec,82,98,30,68
12607,6303,Humpolec,83,94,35,59
12608,6303,Humpolec,84,85,30,55
12609,6303,Humpolec,85,59,16,43
12610,6303,Humpolec,86,64,22,42
12611,6303,Humpolec,87,58,27,31
12612,6303,Humpolec,88,46,11,35
12613,6303,Humpolec,89,28,7,21
12614,6303,Humpolec,90,27,8,19
12615,6303,Humpolec,91,32,8,24
12616,6303,Humpolec,92,17,4,13
12617,6303,Humpolec,93,9,1,8
12618,6303,Humpolec,94,12,3,9
12619,6303,Humpolec,95,10,4,6
12620,6303,Humpolec,96,3,0,3
12621,6303,Humpolec,97,3,0,3
12622,6303,Humpolec,98,1,1,0
12623,6303,Humpolec,99,0,0,0
12624,6303,Humpolec,100,3,1,2
12625,6304,Chotěboř,0,219,119,100
12626,6304,Chotěboř,1,209,113,96
12627,6304,Chotěboř,2,210,113,97
12628,6304,Chotěboř,3,236,115,121
12629,6304,Chotěboř,4,214,102,112
12630,6304,Chotěboř,5,194,77,117
12631,6304,Chotěboř,6,210,98,112
12632,6304,Chotěboř,7,193,93,100
12633,6304,Chotěboř,8,235,118,117
12634,6304,Chotěboř,9,222,98,124
12635,6304,Chotěboř,10,219,106,113
12636,6304,Chotěboř,11,219,112,107
12637,6304,Chotěboř,12,259,128,131
12638,6304,Chotěboř,13,248,129,119
12639,6304,Chotěboř,14,227,130,97
12640,6304,Chotěboř,15,234,126,108
12641,6304,Chotěboř,16,193,102,91
12642,6304,Chotěboř,17,226,113,113
12643,6304,Chotěboř,18,199,84,115
12644,6304,Chotěboř,19,213,122,91
12645,6304,Chotěboř,20,217,111,106
12646,6304,Chotěboř,21,205,126,79
12647,6304,Chotěboř,22,206,102,104
12648,6304,Chotěboř,23,203,110,93
12649,6304,Chotěboř,24,232,115,117
12650,6304,Chotěboř,25,252,133,119
12651,6304,Chotěboř,26,264,140,124
12652,6304,Chotěboř,27,253,135,118
12653,6304,Chotěboř,28,271,149,122
12654,6304,Chotěboř,29,278,133,145
12655,6304,Chotěboř,30,259,128,131
12656,6304,Chotěboř,31,248,141,107
12657,6304,Chotěboř,32,250,140,110
12658,6304,Chotěboř,33,240,142,98
12659,6304,Chotěboř,34,235,126,109
12660,6304,Chotěboř,35,280,143,137
12661,6304,Chotěboř,36,258,123,135
12662,6304,Chotěboř,37,251,133,118
12663,6304,Chotěboř,38,255,136,119
12664,6304,Chotěboř,39,263,135,128
12665,6304,Chotěboř,40,299,168,131
12666,6304,Chotěboř,41,294,146,148
12667,6304,Chotěboř,42,330,165,165
12668,6304,Chotěboř,43,332,191,141
12669,6304,Chotěboř,44,350,180,170
12670,6304,Chotěboř,45,370,190,180
12671,6304,Chotěboř,46,346,170,176
12672,6304,Chotěboř,47,382,210,172
12673,6304,Chotěboř,48,349,185,164
12674,6304,Chotěboř,49,337,176,161
12675,6304,Chotěboř,50,316,159,157
12676,6304,Chotěboř,51,291,146,145
12677,6304,Chotěboř,52,285,135,150
12678,6304,Chotěboř,53,292,153,139
12679,6304,Chotěboř,54,287,141,146
12680,6304,Chotěboř,55,274,139,135
12681,6304,Chotěboř,56,281,142,139
12682,6304,Chotěboř,57,267,142,125
12683,6304,Chotěboř,58,272,136,136
12684,6304,Chotěboř,59,271,125,146
12685,6304,Chotěboř,60,259,129,130
12686,6304,Chotěboř,61,262,148,114
12687,6304,Chotěboř,62,268,150,118
12688,6304,Chotěboř,63,289,142,147
12689,6304,Chotěboř,64,308,153,155
12690,6304,Chotěboř,65,292,156,136
12691,6304,Chotěboř,66,318,155,163
12692,6304,Chotěboř,67,283,140,143
12693,6304,Chotěboř,68,295,146,149
12694,6304,Chotěboř,69,267,133,134
12695,6304,Chotěboř,70,305,141,164
12696,6304,Chotěboř,71,282,120,162
12697,6304,Chotěboř,72,285,117,168
12698,6304,Chotěboř,73,277,146,131
12699,6304,Chotěboř,74,251,115,136
12700,6304,Chotěboř,75,216,81,135
12701,6304,Chotěboř,76,200,95,105
12702,6304,Chotěboř,77,215,87,128
12703,6304,Chotěboř,78,157,71,86
12704,6304,Chotěboř,79,149,65,84
12705,6304,Chotěboř,80,138,45,93
12706,6304,Chotěboř,81,132,48,84
12707,6304,Chotěboř,82,117,39,78
12708,6304,Chotěboř,83,111,44,67
12709,6304,Chotěboř,84,109,37,72
12710,6304,Chotěboř,85,83,21,62
12711,6304,Chotěboř,86,65,24,41
12712,6304,Chotěboř,87,68,23,45
12713,6304,Chotěboř,88,66,18,48
12714,6304,Chotěboř,89,43,17,26
12715,6304,Chotěboř,90,41,14,27
12716,6304,Chotěboř,91,20,7,13
12717,6304,Chotěboř,92,23,6,17
12718,6304,Chotěboř,93,20,8,12
12719,6304,Chotěboř,94,10,5,5
12720,6304,Chotěboř,95,3,1,2
12721,6304,Chotěboř,96,5,0,5
12722,6304,Chotěboř,97,4,0,4
12723,6304,Chotěboř,98,1,0,1
12724,6304,Chotěboř,99,1,0,1
12725,6304,Chotěboř,100,1,0,1
12726,6305,Jihlava,0,1067,535,532
12727,6305,Jihlava,1,1046,542,504
12728,6305,Jihlava,2,1069,562,507
12729,6305,Jihlava,3,1130,574,556
12730,6305,Jihlava,4,1085,513,572
12731,6305,Jihlava,5,1103,560,543
12732,6305,Jihlava,6,1154,609,545
12733,6305,Jihlava,7,1016,515,501
12734,6305,Jihlava,8,1077,563,514
12735,6305,Jihlava,9,1050,552,498
12736,6305,Jihlava,10,1184,589,595
12737,6305,Jihlava,11,1222,636,586
12738,6305,Jihlava,12,1220,609,611
12739,6305,Jihlava,13,1136,560,576
12740,6305,Jihlava,14,1085,567,518
12741,6305,Jihlava,15,1012,535,477
12742,6305,Jihlava,16,978,527,451
12743,6305,Jihlava,17,947,485,462
12744,6305,Jihlava,18,929,485,444
12745,6305,Jihlava,19,865,441,424
12746,6305,Jihlava,20,933,487,446
12747,6305,Jihlava,21,892,466,426
12748,6305,Jihlava,22,909,457,452
12749,6305,Jihlava,23,925,486,439
12750,6305,Jihlava,24,903,459,444
12751,6305,Jihlava,25,999,543,456
12752,6305,Jihlava,26,1148,618,530
12753,6305,Jihlava,27,1248,648,600
12754,6305,Jihlava,28,1239,654,585
12755,6305,Jihlava,29,1219,602,617
12756,6305,Jihlava,30,1329,702,627
12757,6305,Jihlava,31,1307,677,630
12758,6305,Jihlava,32,1322,698,624
12759,6305,Jihlava,33,1313,677,636
12760,6305,Jihlava,34,1412,742,670
12761,6305,Jihlava,35,1364,733,631
12762,6305,Jihlava,36,1328,700,628
12763,6305,Jihlava,37,1420,747,673
12764,6305,Jihlava,38,1462,764,698
12765,6305,Jihlava,39,1433,748,685
12766,6305,Jihlava,40,1551,813,738
12767,6305,Jihlava,41,1696,892,804
12768,6305,Jihlava,42,1657,849,808
12769,6305,Jihlava,43,1688,848,840
12770,6305,Jihlava,44,1809,967,842
12771,6305,Jihlava,45,1790,921,869
12772,6305,Jihlava,46,1802,921,881
12773,6305,Jihlava,47,1656,857,799
12774,6305,Jihlava,48,1553,811,742
12775,6305,Jihlava,49,1463,718,745
12776,6305,Jihlava,50,1406,723,683
12777,6305,Jihlava,51,1353,689,664
12778,6305,Jihlava,52,1214,625,589
12779,6305,Jihlava,53,1238,654,584
12780,6305,Jihlava,54,1244,648,596
12781,6305,Jihlava,55,1282,641,641
12782,6305,Jihlava,56,1328,678,650
12783,6305,Jihlava,57,1285,650,635
12784,6305,Jihlava,58,1238,614,624
12785,6305,Jihlava,59,1178,592,586
12786,6305,Jihlava,60,1200,623,577
12787,6305,Jihlava,61,1165,577,588
12788,6305,Jihlava,62,1244,637,607
12789,6305,Jihlava,63,1297,623,674
12790,6305,Jihlava,64,1328,635,693
12791,6305,Jihlava,65,1314,654,660
12792,6305,Jihlava,66,1236,573,663
12793,6305,Jihlava,67,1208,560,648
12794,6305,Jihlava,68,1244,586,658
12795,6305,Jihlava,69,1186,570,616
12796,6305,Jihlava,70,1220,558,662
12797,6305,Jihlava,71,1186,538,648
12798,6305,Jihlava,72,1136,514,622
12799,6305,Jihlava,73,1196,565,631
12800,6305,Jihlava,74,1139,490,649
12801,6305,Jihlava,75,757,315,442
12802,6305,Jihlava,76,823,328,495
12803,6305,Jihlava,77,757,334,423
12804,6305,Jihlava,78,639,270,369
12805,6305,Jihlava,79,614,250,364
12806,6305,Jihlava,80,622,239,383
12807,6305,Jihlava,81,463,171,292
12808,6305,Jihlava,82,479,176,303
12809,6305,Jihlava,83,418,149,269
12810,6305,Jihlava,84,358,123,235
12811,6305,Jihlava,85,373,119,254
12812,6305,Jihlava,86,311,110,201
12813,6305,Jihlava,87,271,89,182
12814,6305,Jihlava,88,252,78,174
12815,6305,Jihlava,89,198,59,139
12816,6305,Jihlava,90,160,38,122
12817,6305,Jihlava,91,124,34,90
12818,6305,Jihlava,92,105,29,76
12819,6305,Jihlava,93,70,17,53
12820,6305,Jihlava,94,57,17,40
12821,6305,Jihlava,95,33,7,26
12822,6305,Jihlava,96,23,4,19
12823,6305,Jihlava,97,7,0,7
12824,6305,Jihlava,98,10,3,7
12825,6305,Jihlava,99,5,0,5
12826,6305,Jihlava,100,5,2,3
12827,6306,Moravské Budějovice,0,230,117,113
12828,6306,Moravské Budějovice,1,259,140,119
12829,6306,Moravské Budějovice,2,215,132,83
12830,6306,Moravské Budějovice,3,239,113,126
12831,6306,Moravské Budějovice,4,233,114,119
12832,6306,Moravské Budějovice,5,235,108,127
12833,6306,Moravské Budějovice,6,200,100,100
12834,6306,Moravské Budějovice,7,200,91,109
12835,6306,Moravské Budějovice,8,191,92,99
12836,6306,Moravské Budějovice,9,192,112,80
12837,6306,Moravské Budějovice,10,226,122,104
12838,6306,Moravské Budějovice,11,233,131,102
12839,6306,Moravské Budějovice,12,228,110,118
12840,6306,Moravské Budějovice,13,248,120,128
12841,6306,Moravské Budějovice,14,200,109,91
12842,6306,Moravské Budějovice,15,197,115,82
12843,6306,Moravské Budějovice,16,202,107,95
12844,6306,Moravské Budějovice,17,249,120,129
12845,6306,Moravské Budějovice,18,200,89,111
12846,6306,Moravské Budějovice,19,235,122,113
12847,6306,Moravské Budějovice,20,229,117,112
12848,6306,Moravské Budějovice,21,212,99,113
12849,6306,Moravské Budějovice,22,248,137,111
12850,6306,Moravské Budějovice,23,236,139,97
12851,6306,Moravské Budějovice,24,258,127,131
12852,6306,Moravské Budějovice,25,257,122,135
12853,6306,Moravské Budějovice,26,282,163,119
12854,6306,Moravské Budějovice,27,337,191,146
12855,6306,Moravské Budějovice,28,286,163,123
12856,6306,Moravské Budějovice,29,276,149,127
12857,6306,Moravské Budějovice,30,318,166,152
12858,6306,Moravské Budějovice,31,301,145,156
12859,6306,Moravské Budějovice,32,296,154,142
12860,6306,Moravské Budějovice,33,299,161,138
12861,6306,Moravské Budějovice,34,292,156,136
12862,6306,Moravské Budějovice,35,299,161,138
12863,6306,Moravské Budějovice,36,283,139,144
12864,6306,Moravské Budějovice,37,305,173,132
12865,6306,Moravské Budějovice,38,268,157,111
12866,6306,Moravské Budějovice,39,302,159,143
12867,6306,Moravské Budějovice,40,294,161,133
12868,6306,Moravské Budějovice,41,351,198,153
12869,6306,Moravské Budějovice,42,358,193,165
12870,6306,Moravské Budějovice,43,365,181,184
12871,6306,Moravské Budějovice,44,352,187,165
12872,6306,Moravské Budějovice,45,389,209,180
12873,6306,Moravské Budějovice,46,368,184,184
12874,6306,Moravské Budějovice,47,372,192,180
12875,6306,Moravské Budějovice,48,371,188,183
12876,6306,Moravské Budějovice,49,295,141,154
12877,6306,Moravské Budějovice,50,313,173,140
12878,6306,Moravské Budějovice,51,303,140,163
12879,6306,Moravské Budějovice,52,255,139,116
12880,6306,Moravské Budějovice,53,309,164,145
12881,6306,Moravské Budějovice,54,331,141,190
12882,6306,Moravské Budějovice,55,328,158,170
12883,6306,Moravské Budějovice,56,327,159,168
12884,6306,Moravské Budějovice,57,305,169,136
12885,6306,Moravské Budějovice,58,268,149,119
12886,6306,Moravské Budějovice,59,300,145,155
12887,6306,Moravské Budějovice,60,274,140,134
12888,6306,Moravské Budějovice,61,308,153,155
12889,6306,Moravské Budějovice,62,311,160,151
12890,6306,Moravské Budějovice,63,318,165,153
12891,6306,Moravské Budějovice,64,312,157,155
12892,6306,Moravské Budějovice,65,320,158,162
12893,6306,Moravské Budějovice,66,279,130,149
12894,6306,Moravské Budějovice,67,273,125,148
12895,6306,Moravské Budějovice,68,305,152,153
12896,6306,Moravské Budějovice,69,293,135,158
12897,6306,Moravské Budějovice,70,244,115,129
12898,6306,Moravské Budějovice,71,269,136,133
12899,6306,Moravské Budějovice,72,241,107,134
12900,6306,Moravské Budějovice,73,288,121,167
12901,6306,Moravské Budějovice,74,258,113,145
12902,6306,Moravské Budějovice,75,206,87,119
12903,6306,Moravské Budějovice,76,207,87,120
12904,6306,Moravské Budějovice,77,173,65,108
12905,6306,Moravské Budějovice,78,175,72,103
12906,6306,Moravské Budějovice,79,159,71,88
12907,6306,Moravské Budějovice,80,150,63,87
12908,6306,Moravské Budějovice,81,131,55,76
12909,6306,Moravské Budějovice,82,108,44,64
12910,6306,Moravské Budějovice,83,100,30,70
12911,6306,Moravské Budějovice,84,92,30,62
12912,6306,Moravské Budějovice,85,79,28,51
12913,6306,Moravské Budějovice,86,88,32,56
12914,6306,Moravské Budějovice,87,88,24,64
12915,6306,Moravské Budějovice,88,87,31,56
12916,6306,Moravské Budějovice,89,61,21,40
12917,6306,Moravské Budějovice,90,50,14,36
12918,6306,Moravské Budějovice,91,37,12,25
12919,6306,Moravské Budějovice,92,19,5,14
12920,6306,Moravské Budějovice,93,22,7,15
12921,6306,Moravské Budějovice,94,13,1,12
12922,6306,Moravské Budějovice,95,9,2,7
12923,6306,Moravské Budějovice,96,5,1,4
12924,6306,Moravské Budějovice,97,5,0,5
12925,6306,Moravské Budějovice,98,1,1,0
12926,6306,Moravské Budějovice,99,5,0,5
12927,6306,Moravské Budějovice,100,2,1,1
12928,6307,Náměšť nad Oslavou,0,136,76,60
12929,6307,Náměšť nad Oslavou,1,142,79,63
12930,6307,Náměšť nad Oslavou,2,125,70,55
12931,6307,Náměšť nad Oslavou,3,143,77,66
12932,6307,Náměšť nad Oslavou,4,151,79,72
12933,6307,Náměšť nad Oslavou,5,156,74,82
12934,6307,Náměšť nad Oslavou,6,150,80,70
12935,6307,Náměšť nad Oslavou,7,129,65,64
12936,6307,Náměšť nad Oslavou,8,123,63,60
12937,6307,Náměšť nad Oslavou,9,128,62,66
12938,6307,Náměšť nad Oslavou,10,139,77,62
12939,6307,Náměšť nad Oslavou,11,130,68,62
12940,6307,Náměšť nad Oslavou,12,122,60,62
12941,6307,Náměšť nad Oslavou,13,131,73,58
12942,6307,Náměšť nad Oslavou,14,143,87,56
12943,6307,Náměšť nad Oslavou,15,139,72,67
12944,6307,Náměšť nad Oslavou,16,101,51,50
12945,6307,Náměšť nad Oslavou,17,109,56,53
12946,6307,Náměšť nad Oslavou,18,118,60,58
12947,6307,Náměšť nad Oslavou,19,111,56,55
12948,6307,Náměšť nad Oslavou,20,104,56,48
12949,6307,Náměšť nad Oslavou,21,104,55,49
12950,6307,Náměšť nad Oslavou,22,125,68,57
12951,6307,Náměšť nad Oslavou,23,112,63,49
12952,6307,Náměšť nad Oslavou,24,115,60,55
12953,6307,Náměšť nad Oslavou,25,136,70,66
12954,6307,Náměšť nad Oslavou,26,139,69,70
12955,6307,Náměšť nad Oslavou,27,201,88,113
12956,6307,Náměšť nad Oslavou,28,181,98,83
12957,6307,Náměšť nad Oslavou,29,191,94,97
12958,6307,Náměšť nad Oslavou,30,171,83,88
12959,6307,Náměšť nad Oslavou,31,185,91,94
12960,6307,Náměšť nad Oslavou,32,175,103,72
12961,6307,Náměšť nad Oslavou,33,155,72,83
12962,6307,Náměšť nad Oslavou,34,185,111,74
12963,6307,Náměšť nad Oslavou,35,214,105,109
12964,6307,Náměšť nad Oslavou,36,203,114,89
12965,6307,Náměšť nad Oslavou,37,187,104,83
12966,6307,Náměšť nad Oslavou,38,195,95,100
12967,6307,Náměšť nad Oslavou,39,182,97,85
12968,6307,Náměšť nad Oslavou,40,212,118,94
12969,6307,Náměšť nad Oslavou,41,201,115,86
12970,6307,Náměšť nad Oslavou,42,182,97,85
12971,6307,Náměšť nad Oslavou,43,221,117,104
12972,6307,Náměšť nad Oslavou,44,220,107,113
12973,6307,Náměšť nad Oslavou,45,236,135,101
12974,6307,Náměšť nad Oslavou,46,207,103,104
12975,6307,Náměšť nad Oslavou,47,218,120,98
12976,6307,Náměšť nad Oslavou,48,168,85,83
12977,6307,Náměšť nad Oslavou,49,160,72,88
12978,6307,Náměšť nad Oslavou,50,173,90,83
12979,6307,Náměšť nad Oslavou,51,159,83,76
12980,6307,Náměšť nad Oslavou,52,165,90,75
12981,6307,Náměšť nad Oslavou,53,158,81,77
12982,6307,Náměšť nad Oslavou,54,195,96,99
12983,6307,Náměšť nad Oslavou,55,183,91,92
12984,6307,Náměšť nad Oslavou,56,175,88,87
12985,6307,Náměšť nad Oslavou,57,196,103,93
12986,6307,Náměšť nad Oslavou,58,175,84,91
12987,6307,Náměšť nad Oslavou,59,178,88,90
12988,6307,Náměšť nad Oslavou,60,176,77,99
12989,6307,Náměšť nad Oslavou,61,164,87,77
12990,6307,Náměšť nad Oslavou,62,161,88,73
12991,6307,Náměšť nad Oslavou,63,196,102,94
12992,6307,Náměšť nad Oslavou,64,169,87,82
12993,6307,Náměšť nad Oslavou,65,203,118,85
12994,6307,Náměšť nad Oslavou,66,186,96,90
12995,6307,Náměšť nad Oslavou,67,183,97,86
12996,6307,Náměšť nad Oslavou,68,145,68,77
12997,6307,Náměšť nad Oslavou,69,144,72,72
12998,6307,Náměšť nad Oslavou,70,171,74,97
12999,6307,Náměšť nad Oslavou,71,140,63,77
13000,6307,Náměšť nad Oslavou,72,162,80,82
13001,6307,Náměšť nad Oslavou,73,160,72,88
13002,6307,Náměšť nad Oslavou,74,134,58,76
13003,6307,Náměšť nad Oslavou,75,134,62,72
13004,6307,Náměšť nad Oslavou,76,132,57,75
13005,6307,Náměšť nad Oslavou,77,107,47,60
13006,6307,Náměšť nad Oslavou,78,95,28,67
13007,6307,Náměšť nad Oslavou,79,76,30,46
13008,6307,Náměšť nad Oslavou,80,93,33,60
13009,6307,Náměšť nad Oslavou,81,80,31,49
13010,6307,Náměšť nad Oslavou,82,79,29,50
13011,6307,Náměšť nad Oslavou,83,70,22,48
13012,6307,Náměšť nad Oslavou,84,51,16,35
13013,6307,Náměšť nad Oslavou,85,62,20,42
13014,6307,Náměšť nad Oslavou,86,50,13,37
13015,6307,Náměšť nad Oslavou,87,49,19,30
13016,6307,Náměšť nad Oslavou,88,35,9,26
13017,6307,Náměšť nad Oslavou,89,28,9,19
13018,6307,Náměšť nad Oslavou,90,30,12,18
13019,6307,Náměšť nad Oslavou,91,26,8,18
13020,6307,Náměšť nad Oslavou,92,23,8,15
13021,6307,Náměšť nad Oslavou,93,12,4,8
13022,6307,Náměšť nad Oslavou,94,9,0,9
13023,6307,Náměšť nad Oslavou,95,6,2,4
13024,6307,Náměšť nad Oslavou,96,4,0,4
13025,6307,Náměšť nad Oslavou,97,1,0,1
13026,6307,Náměšť nad Oslavou,98,1,0,1
13027,6307,Náměšť nad Oslavou,99,1,0,1
13028,6307,Náměšť nad Oslavou,100,2,1,1
13029,6308,Nové Město na Moravě,0,200,107,93
13030,6308,Nové Město na Moravě,1,213,101,112
13031,6308,Nové Město na Moravě,2,259,138,121
13032,6308,Nové Město na Moravě,3,194,103,91
13033,6308,Nové Město na Moravě,4,196,91,105
13034,6308,Nové Město na Moravě,5,181,85,96
13035,6308,Nové Město na Moravě,6,212,114,98
13036,6308,Nové Město na Moravě,7,220,111,109
13037,6308,Nové Město na Moravě,8,194,106,88
13038,6308,Nové Město na Moravě,9,186,87,99
13039,6308,Nové Město na Moravě,10,213,106,107
13040,6308,Nové Město na Moravě,11,226,110,116
13041,6308,Nové Město na Moravě,12,216,107,109
13042,6308,Nové Město na Moravě,13,201,96,105
13043,6308,Nové Město na Moravě,14,207,114,93
13044,6308,Nové Město na Moravě,15,197,102,95
13045,6308,Nové Město na Moravě,16,220,107,113
13046,6308,Nové Město na Moravě,17,196,93,103
13047,6308,Nové Město na Moravě,18,204,108,96
13048,6308,Nové Město na Moravě,19,169,92,77
13049,6308,Nové Město na Moravě,20,190,102,88
13050,6308,Nové Město na Moravě,21,171,93,78
13051,6308,Nové Město na Moravě,22,181,90,91
13052,6308,Nové Město na Moravě,23,197,102,95
13053,6308,Nové Město na Moravě,24,176,90,86
13054,6308,Nové Město na Moravě,25,206,111,95
13055,6308,Nové Město na Moravě,26,228,108,120
13056,6308,Nové Město na Moravě,27,272,146,126
13057,6308,Nové Město na Moravě,28,224,112,112
13058,6308,Nové Město na Moravě,29,251,126,125
13059,6308,Nové Město na Moravě,30,270,147,123
13060,6308,Nové Město na Moravě,31,245,131,114
13061,6308,Nové Město na Moravě,32,271,137,134
13062,6308,Nové Město na Moravě,33,222,118,104
13063,6308,Nové Město na Moravě,34,234,130,104
13064,6308,Nové Město na Moravě,35,245,125,120
13065,6308,Nové Město na Moravě,36,239,111,128
13066,6308,Nové Město na Moravě,37,230,136,94
13067,6308,Nové Město na Moravě,38,234,133,101
13068,6308,Nové Město na Moravě,39,231,121,110
13069,6308,Nové Město na Moravě,40,264,133,131
13070,6308,Nové Město na Moravě,41,274,145,129
13071,6308,Nové Město na Moravě,42,298,148,150
13072,6308,Nové Město na Moravě,43,292,140,152
13073,6308,Nové Město na Moravě,44,334,162,172
13074,6308,Nové Město na Moravě,45,341,194,147
13075,6308,Nové Město na Moravě,46,322,160,162
13076,6308,Nové Město na Moravě,47,291,148,143
13077,6308,Nové Město na Moravě,48,281,142,139
13078,6308,Nové Město na Moravě,49,290,147,143
13079,6308,Nové Město na Moravě,50,255,138,117
13080,6308,Nové Město na Moravě,51,255,125,130
13081,6308,Nové Město na Moravě,52,255,142,113
13082,6308,Nové Město na Moravě,53,238,114,124
13083,6308,Nové Město na Moravě,54,261,141,120
13084,6308,Nové Město na Moravě,55,205,112,93
13085,6308,Nové Město na Moravě,56,282,152,130
13086,6308,Nové Město na Moravě,57,295,150,145
13087,6308,Nové Město na Moravě,58,237,124,113
13088,6308,Nové Město na Moravě,59,237,112,125
13089,6308,Nové Město na Moravě,60,213,101,112
13090,6308,Nové Město na Moravě,61,230,113,117
13091,6308,Nové Město na Moravě,62,242,128,114
13092,6308,Nové Město na Moravě,63,246,125,121
13093,6308,Nové Město na Moravě,64,219,108,111
13094,6308,Nové Město na Moravě,65,259,118,141
13095,6308,Nové Město na Moravě,66,213,90,123
13096,6308,Nové Město na Moravě,67,240,116,124
13097,6308,Nové Město na Moravě,68,243,121,122
13098,6308,Nové Město na Moravě,69,220,106,114
13099,6308,Nové Město na Moravě,70,232,110,122
13100,6308,Nové Město na Moravě,71,193,95,98
13101,6308,Nové Město na Moravě,72,232,115,117
13102,6308,Nové Město na Moravě,73,225,101,124
13103,6308,Nové Město na Moravě,74,230,92,138
13104,6308,Nové Město na Moravě,75,207,85,122
13105,6308,Nové Město na Moravě,76,181,80,101
13106,6308,Nové Město na Moravě,77,181,81,100
13107,6308,Nové Město na Moravě,78,161,60,101
13108,6308,Nové Město na Moravě,79,121,58,63
13109,6308,Nové Město na Moravě,80,126,59,67
13110,6308,Nové Město na Moravě,81,111,50,61
13111,6308,Nové Město na Moravě,82,123,44,79
13112,6308,Nové Město na Moravě,83,115,51,64
13113,6308,Nové Město na Moravě,84,98,47,51
13114,6308,Nové Město na Moravě,85,89,39,50
13115,6308,Nové Město na Moravě,86,79,26,53
13116,6308,Nové Město na Moravě,87,39,19,20
13117,6308,Nové Město na Moravě,88,37,9,28
13118,6308,Nové Město na Moravě,89,28,10,18
13119,6308,Nové Město na Moravě,90,28,8,20
13120,6308,Nové Město na Moravě,91,24,6,18
13121,6308,Nové Město na Moravě,92,15,4,11
13122,6308,Nové Město na Moravě,93,14,6,8
13123,6308,Nové Město na Moravě,94,11,1,10
13124,6308,Nové Město na Moravě,95,3,0,3
13125,6308,Nové Město na Moravě,96,7,1,6
13126,6308,Nové Město na Moravě,97,2,1,1
13127,6308,Nové Město na Moravě,98,1,0,1
13128,6308,Nové Město na Moravě,99,0,0,0
13129,6308,Nové Město na Moravě,100,0,0,0
13130,6309,Pacov,0,95,47,48
13131,6309,Pacov,1,89,46,43
13132,6309,Pacov,2,90,41,49
13133,6309,Pacov,3,87,43,44
13134,6309,Pacov,4,65,35,30
13135,6309,Pacov,5,87,49,38
13136,6309,Pacov,6,79,38,41
13137,6309,Pacov,7,75,43,32
13138,6309,Pacov,8,75,39,36
13139,6309,Pacov,9,54,32,22
13140,6309,Pacov,10,86,46,40
13141,6309,Pacov,11,77,38,39
13142,6309,Pacov,12,102,46,56
13143,6309,Pacov,13,105,51,54
13144,6309,Pacov,14,87,45,42
13145,6309,Pacov,15,76,45,31
13146,6309,Pacov,16,96,54,42
13147,6309,Pacov,17,66,41,25
13148,6309,Pacov,18,86,46,40
13149,6309,Pacov,19,98,51,47
13150,6309,Pacov,20,98,51,47
13151,6309,Pacov,21,89,45,44
13152,6309,Pacov,22,94,45,49
13153,6309,Pacov,23,100,51,49
13154,6309,Pacov,24,86,38,48
13155,6309,Pacov,25,105,59,46
13156,6309,Pacov,26,95,46,49
13157,6309,Pacov,27,108,51,57
13158,6309,Pacov,28,120,65,55
13159,6309,Pacov,29,90,44,46
13160,6309,Pacov,30,109,61,48
13161,6309,Pacov,31,119,63,56
13162,6309,Pacov,32,111,62,49
13163,6309,Pacov,33,89,50,39
13164,6309,Pacov,34,98,52,46
13165,6309,Pacov,35,105,50,55
13166,6309,Pacov,36,106,57,49
13167,6309,Pacov,37,113,66,47
13168,6309,Pacov,38,112,57,55
13169,6309,Pacov,39,107,60,47
13170,6309,Pacov,40,130,64,66
13171,6309,Pacov,41,149,80,69
13172,6309,Pacov,42,134,73,61
13173,6309,Pacov,43,143,85,58
13174,6309,Pacov,44,176,88,88
13175,6309,Pacov,45,146,85,61
13176,6309,Pacov,46,155,80,75
13177,6309,Pacov,47,171,87,84
13178,6309,Pacov,48,155,79,76
13179,6309,Pacov,49,150,77,73
13180,6309,Pacov,50,128,62,66
13181,6309,Pacov,51,135,75,60
13182,6309,Pacov,52,140,74,66
13183,6309,Pacov,53,116,58,58
13184,6309,Pacov,54,134,78,56
13185,6309,Pacov,55,142,77,65
13186,6309,Pacov,56,149,80,69
13187,6309,Pacov,57,113,63,50
13188,6309,Pacov,58,111,62,49
13189,6309,Pacov,59,124,57,67
13190,6309,Pacov,60,103,43,60
13191,6309,Pacov,61,107,58,49
13192,6309,Pacov,62,129,78,51
13193,6309,Pacov,63,129,64,65
13194,6309,Pacov,64,135,73,62
13195,6309,Pacov,65,120,54,66
13196,6309,Pacov,66,116,42,74
13197,6309,Pacov,67,130,65,65
13198,6309,Pacov,68,124,62,62
13199,6309,Pacov,69,129,64,65
13200,6309,Pacov,70,111,48,63
13201,6309,Pacov,71,103,48,55
13202,6309,Pacov,72,141,63,78
13203,6309,Pacov,73,121,50,71
13204,6309,Pacov,74,115,53,62
13205,6309,Pacov,75,98,35,63
13206,6309,Pacov,76,97,42,55
13207,6309,Pacov,77,110,46,64
13208,6309,Pacov,78,87,35,52
13209,6309,Pacov,79,71,35,36
13210,6309,Pacov,80,68,19,49
13211,6309,Pacov,81,64,27,37
13212,6309,Pacov,82,59,17,42
13213,6309,Pacov,83,49,21,28
13214,6309,Pacov,84,41,12,29
13215,6309,Pacov,85,48,17,31
13216,6309,Pacov,86,34,10,24
13217,6309,Pacov,87,30,11,19
13218,6309,Pacov,88,27,6,21
13219,6309,Pacov,89,23,6,17
13220,6309,Pacov,90,17,6,11
13221,6309,Pacov,91,11,3,8
13222,6309,Pacov,92,9,4,5
13223,6309,Pacov,93,4,1,3
13224,6309,Pacov,94,6,1,5
13225,6309,Pacov,95,5,0,5
13226,6309,Pacov,96,3,0,3
13227,6309,Pacov,97,1,0,1
13228,6309,Pacov,98,3,0,3
13229,6309,Pacov,99,1,0,1
13230,6309,Pacov,100,0,0,0
13231,6310,Pelhřimov,0,453,255,198
13232,6310,Pelhřimov,1,422,193,229
13233,6310,Pelhřimov,2,445,220,225
13234,6310,Pelhřimov,3,430,215,215
13235,6310,Pelhřimov,4,418,218,200
13236,6310,Pelhřimov,5,434,231,203
13237,6310,Pelhřimov,6,419,230,189
13238,6310,Pelhřimov,7,399,207,192
13239,6310,Pelhřimov,8,460,248,212
13240,6310,Pelhřimov,9,431,208,223
13241,6310,Pelhřimov,10,479,248,231
13242,6310,Pelhřimov,11,431,214,217
13243,6310,Pelhřimov,12,464,240,224
13244,6310,Pelhřimov,13,447,223,224
13245,6310,Pelhřimov,14,463,232,231
13246,6310,Pelhřimov,15,421,197,224
13247,6310,Pelhřimov,16,439,220,219
13248,6310,Pelhřimov,17,419,208,211
13249,6310,Pelhřimov,18,431,213,218
13250,6310,Pelhřimov,19,412,204,208
13251,6310,Pelhřimov,20,449,227,222
13252,6310,Pelhřimov,21,428,225,203
13253,6310,Pelhřimov,22,442,233,209
13254,6310,Pelhřimov,23,432,235,197
13255,6310,Pelhřimov,24,419,216,203
13256,6310,Pelhřimov,25,466,265,201
13257,6310,Pelhřimov,26,481,254,227
13258,6310,Pelhřimov,27,570,305,265
13259,6310,Pelhřimov,28,547,285,262
13260,6310,Pelhřimov,29,580,294,286
13261,6310,Pelhřimov,30,575,310,265
13262,6310,Pelhřimov,31,558,298,260
13263,6310,Pelhřimov,32,537,265,272
13264,6310,Pelhřimov,33,548,303,245
13265,6310,Pelhřimov,34,541,279,262
13266,6310,Pelhřimov,35,588,309,279
13267,6310,Pelhřimov,36,576,287,289
13268,6310,Pelhřimov,37,587,341,246
13269,6310,Pelhřimov,38,559,308,251
13270,6310,Pelhřimov,39,602,320,282
13271,6310,Pelhřimov,40,640,337,303
13272,6310,Pelhřimov,41,620,327,293
13273,6310,Pelhřimov,42,725,371,354
13274,6310,Pelhřimov,43,725,382,343
13275,6310,Pelhřimov,44,709,389,320
13276,6310,Pelhřimov,45,771,400,371
13277,6310,Pelhřimov,46,800,400,400
13278,6310,Pelhřimov,47,775,423,352
13279,6310,Pelhřimov,48,651,342,309
13280,6310,Pelhřimov,49,674,333,341
13281,6310,Pelhřimov,50,625,341,284
13282,6310,Pelhřimov,51,625,315,310
13283,6310,Pelhřimov,52,549,268,281
13284,6310,Pelhřimov,53,585,311,274
13285,6310,Pelhřimov,54,609,312,297
13286,6310,Pelhřimov,55,635,311,324
13287,6310,Pelhřimov,56,627,303,324
13288,6310,Pelhřimov,57,616,336,280
13289,6310,Pelhřimov,58,568,276,292
13290,6310,Pelhřimov,59,552,271,281
13291,6310,Pelhřimov,60,547,282,265
13292,6310,Pelhřimov,61,532,268,264
13293,6310,Pelhřimov,62,612,307,305
13294,6310,Pelhřimov,63,641,306,335
13295,6310,Pelhřimov,64,642,328,314
13296,6310,Pelhřimov,65,664,336,328
13297,6310,Pelhřimov,66,576,270,306
13298,6310,Pelhřimov,67,546,259,287
13299,6310,Pelhřimov,68,581,277,304
13300,6310,Pelhřimov,69,594,276,318
13301,6310,Pelhřimov,70,557,270,287
13302,6310,Pelhřimov,71,567,251,316
13303,6310,Pelhřimov,72,579,254,325
13304,6310,Pelhřimov,73,568,271,297
13305,6310,Pelhřimov,74,523,220,303
13306,6310,Pelhřimov,75,447,190,257
13307,6310,Pelhřimov,76,428,182,246
13308,6310,Pelhřimov,77,385,172,213
13309,6310,Pelhřimov,78,352,140,212
13310,6310,Pelhřimov,79,339,135,204
13311,6310,Pelhřimov,80,298,120,178
13312,6310,Pelhřimov,81,248,92,156
13313,6310,Pelhřimov,82,226,89,137
13314,6310,Pelhřimov,83,217,67,150
13315,6310,Pelhřimov,84,214,69,145
13316,6310,Pelhřimov,85,169,62,107
13317,6310,Pelhřimov,86,147,45,102
13318,6310,Pelhřimov,87,124,39,85
13319,6310,Pelhřimov,88,100,33,67
13320,6310,Pelhřimov,89,101,33,68
13321,6310,Pelhřimov,90,68,19,49
13322,6310,Pelhřimov,91,66,13,53
13323,6310,Pelhřimov,92,45,9,36
13324,6310,Pelhřimov,93,27,7,20
13325,6310,Pelhřimov,94,27,7,20
13326,6310,Pelhřimov,95,13,1,12
13327,6310,Pelhřimov,96,10,3,7
13328,6310,Pelhřimov,97,3,1,2
13329,6310,Pelhřimov,98,1,0,1
13330,6310,Pelhřimov,99,3,0,3
13331,6310,Pelhřimov,100,1,0,1
13332,6311,Světlá nad Sázavou,0,196,103,93
13333,6311,Světlá nad Sázavou,1,226,106,120
13334,6311,Světlá nad Sázavou,2,189,89,100
13335,6311,Světlá nad Sázavou,3,217,108,109
13336,6311,Světlá nad Sázavou,4,195,94,101
13337,6311,Světlá nad Sázavou,5,175,72,103
13338,6311,Světlá nad Sázavou,6,176,86,90
13339,6311,Světlá nad Sázavou,7,193,96,97
13340,6311,Světlá nad Sázavou,8,169,80,89
13341,6311,Světlá nad Sázavou,9,183,104,79
13342,6311,Světlá nad Sázavou,10,183,88,95
13343,6311,Světlá nad Sázavou,11,181,92,89
13344,6311,Světlá nad Sázavou,12,170,94,76
13345,6311,Světlá nad Sázavou,13,179,91,88
13346,6311,Světlá nad Sázavou,14,170,92,78
13347,6311,Světlá nad Sázavou,15,200,96,104
13348,6311,Světlá nad Sázavou,16,175,88,87
13349,6311,Světlá nad Sázavou,17,171,80,91
13350,6311,Světlá nad Sázavou,18,190,105,85
13351,6311,Světlá nad Sázavou,19,159,84,75
13352,6311,Světlá nad Sázavou,20,174,87,87
13353,6311,Světlá nad Sázavou,21,177,87,90
13354,6311,Světlá nad Sázavou,22,180,90,90
13355,6311,Světlá nad Sázavou,23,186,92,94
13356,6311,Světlá nad Sázavou,24,188,98,90
13357,6311,Světlá nad Sázavou,25,171,87,84
13358,6311,Světlá nad Sázavou,26,191,97,94
13359,6311,Světlá nad Sázavou,27,231,126,105
13360,6311,Světlá nad Sázavou,28,241,118,123
13361,6311,Světlá nad Sázavou,29,208,105,103
13362,6311,Světlá nad Sázavou,30,240,130,110
13363,6311,Světlá nad Sázavou,31,231,124,107
13364,6311,Světlá nad Sázavou,32,242,118,124
13365,6311,Světlá nad Sázavou,33,269,145,124
13366,6311,Světlá nad Sázavou,34,255,133,122
13367,6311,Světlá nad Sázavou,35,240,118,122
13368,6311,Světlá nad Sázavou,36,273,150,123
13369,6311,Světlá nad Sázavou,37,246,130,116
13370,6311,Světlá nad Sázavou,38,239,137,102
13371,6311,Světlá nad Sázavou,39,242,131,111
13372,6311,Světlá nad Sázavou,40,274,147,127
13373,6311,Světlá nad Sázavou,41,253,139,114
13374,6311,Světlá nad Sázavou,42,291,153,138
13375,6311,Světlá nad Sázavou,43,315,168,147
13376,6311,Světlá nad Sázavou,44,342,191,151
13377,6311,Světlá nad Sázavou,45,331,178,153
13378,6311,Světlá nad Sázavou,46,338,165,173
13379,6311,Světlá nad Sázavou,47,292,156,136
13380,6311,Světlá nad Sázavou,48,282,132,150
13381,6311,Světlá nad Sázavou,49,252,139,113
13382,6311,Světlá nad Sázavou,50,239,132,107
13383,6311,Světlá nad Sázavou,51,251,128,123
13384,6311,Světlá nad Sázavou,52,248,122,126
13385,6311,Světlá nad Sázavou,53,259,122,137
13386,6311,Světlá nad Sázavou,54,248,123,125
13387,6311,Světlá nad Sázavou,55,266,149,117
13388,6311,Světlá nad Sázavou,56,280,144,136
13389,6311,Světlá nad Sázavou,57,292,153,139
13390,6311,Světlá nad Sázavou,58,274,134,140
13391,6311,Světlá nad Sázavou,59,278,142,136
13392,6311,Světlá nad Sázavou,60,253,128,125
13393,6311,Světlá nad Sázavou,61,294,150,144
13394,6311,Světlá nad Sázavou,62,283,147,136
13395,6311,Světlá nad Sázavou,63,297,146,151
13396,6311,Světlá nad Sázavou,64,302,150,152
13397,6311,Světlá nad Sázavou,65,336,174,162
13398,6311,Světlá nad Sázavou,66,276,125,151
13399,6311,Světlá nad Sázavou,67,289,168,121
13400,6311,Světlá nad Sázavou,68,303,152,151
13401,6311,Světlá nad Sázavou,69,285,131,154
13402,6311,Světlá nad Sázavou,70,252,119,133
13403,6311,Světlá nad Sázavou,71,243,120,123
13404,6311,Světlá nad Sázavou,72,238,100,138
13405,6311,Světlá nad Sázavou,73,238,97,141
13406,6311,Světlá nad Sázavou,74,202,94,108
13407,6311,Světlá nad Sázavou,75,192,84,108
13408,6311,Světlá nad Sázavou,76,197,84,113
13409,6311,Světlá nad Sázavou,77,179,65,114
13410,6311,Světlá nad Sázavou,78,146,63,83
13411,6311,Světlá nad Sázavou,79,132,55,77
13412,6311,Světlá nad Sázavou,80,138,41,97
13413,6311,Světlá nad Sázavou,81,112,37,75
13414,6311,Světlá nad Sázavou,82,110,50,60
13415,6311,Světlá nad Sázavou,83,78,29,49
13416,6311,Světlá nad Sázavou,84,76,23,53
13417,6311,Světlá nad Sázavou,85,78,26,52
13418,6311,Světlá nad Sázavou,86,67,20,47
13419,6311,Světlá nad Sázavou,87,50,15,35
13420,6311,Světlá nad Sázavou,88,59,18,41
13421,6311,Světlá nad Sázavou,89,27,5,22
13422,6311,Světlá nad Sázavou,90,33,7,26
13423,6311,Světlá nad Sázavou,91,24,4,20
13424,6311,Světlá nad Sázavou,92,23,6,17
13425,6311,Světlá nad Sázavou,93,20,5,15
13426,6311,Světlá nad Sázavou,94,5,3,2
13427,6311,Světlá nad Sázavou,95,5,0,5
13428,6311,Světlá nad Sázavou,96,2,0,2
13429,6311,Světlá nad Sázavou,97,1,0,1
13430,6311,Světlá nad Sázavou,98,0,0,0
13431,6311,Světlá nad Sázavou,99,0,0,0
13432,6311,Světlá nad Sázavou,100,0,0,0
13433,6312,Telč,0,130,63,67
13434,6312,Telč,1,148,86,62
13435,6312,Telč,2,135,73,62
13436,6312,Telč,3,134,57,77
13437,6312,Telč,4,131,66,65
13438,6312,Telč,5,126,72,54
13439,6312,Telč,6,128,66,62
13440,6312,Telč,7,119,61,58
13441,6312,Telč,8,142,76,66
13442,6312,Telč,9,121,63,58
13443,6312,Telč,10,118,59,59
13444,6312,Telč,11,143,76,67
13445,6312,Telč,12,148,76,72
13446,6312,Telč,13,135,65,70
13447,6312,Telč,14,124,71,53
13448,6312,Telč,15,127,61,66
13449,6312,Telč,16,116,65,51
13450,6312,Telč,17,99,56,43
13451,6312,Telč,18,115,54,61
13452,6312,Telč,19,115,60,55
13453,6312,Telč,20,117,58,59
13454,6312,Telč,21,124,66,58
13455,6312,Telč,22,142,67,75
13456,6312,Telč,23,142,74,68
13457,6312,Telč,24,146,69,77
13458,6312,Telč,25,142,77,65
13459,6312,Telč,26,151,93,58
13460,6312,Telč,27,193,97,96
13461,6312,Telč,28,180,99,81
13462,6312,Telč,29,174,94,80
13463,6312,Telč,30,180,89,91
13464,6312,Telč,31,153,81,72
13465,6312,Telč,32,185,89,96
13466,6312,Telč,33,146,74,72
13467,6312,Telč,34,142,82,60
13468,6312,Telč,35,154,79,75
13469,6312,Telč,36,161,81,80
13470,6312,Telč,37,140,77,63
13471,6312,Telč,38,149,76,73
13472,6312,Telč,39,186,109,77
13473,6312,Telč,40,174,88,86
13474,6312,Telč,41,191,98,93
13475,6312,Telč,42,191,93,98
13476,6312,Telč,43,201,103,98
13477,6312,Telč,44,201,106,95
13478,6312,Telč,45,211,114,97
13479,6312,Telč,46,225,123,102
13480,6312,Telč,47,181,91,90
13481,6312,Telč,48,198,89,109
13482,6312,Telč,49,184,96,88
13483,6312,Telč,50,164,81,83
13484,6312,Telč,51,169,92,77
13485,6312,Telč,52,185,95,90
13486,6312,Telč,53,183,102,81
13487,6312,Telč,54,162,84,78
13488,6312,Telč,55,183,88,95
13489,6312,Telč,56,189,105,84
13490,6312,Telč,57,199,111,88
13491,6312,Telč,58,147,77,70
13492,6312,Telč,59,165,86,79
13493,6312,Telč,60,157,94,63
13494,6312,Telč,61,141,72,69
13495,6312,Telč,62,175,92,83
13496,6312,Telč,63,172,87,85
13497,6312,Telč,64,188,88,100
13498,6312,Telč,65,152,79,73
13499,6312,Telč,66,172,84,88
13500,6312,Telč,67,169,77,92
13501,6312,Telč,68,135,77,58
13502,6312,Telč,69,166,73,93
13503,6312,Telč,70,141,53,88
13504,6312,Telč,71,154,66,88
13505,6312,Telč,72,150,74,76
13506,6312,Telč,73,151,59,92
13507,6312,Telč,74,139,66,73
13508,6312,Telč,75,128,51,77
13509,6312,Telč,76,107,38,69
13510,6312,Telč,77,125,51,74
13511,6312,Telč,78,113,41,72
13512,6312,Telč,79,89,38,51
13513,6312,Telč,80,95,35,60
13514,6312,Telč,81,89,27,62
13515,6312,Telč,82,77,29,48
13516,6312,Telč,83,71,33,38
13517,6312,Telč,84,47,13,34
13518,6312,Telč,85,38,9,29
13519,6312,Telč,86,56,18,38
13520,6312,Telč,87,37,14,23
13521,6312,Telč,88,36,10,26
13522,6312,Telč,89,20,6,14
13523,6312,Telč,90,26,6,20
13524,6312,Telč,91,19,6,13
13525,6312,Telč,92,17,5,12
13526,6312,Telč,93,15,5,10
13527,6312,Telč,94,2,1,1
13528,6312,Telč,95,7,1,6
13529,6312,Telč,96,3,1,2
13530,6312,Telč,97,2,0,2
13531,6312,Telč,98,1,0,1
13532,6312,Telč,99,0,0,0
13533,6312,Telč,100,0,0,0
13534,6313,Třebíč,0,735,376,359
13535,6313,Třebíč,1,756,423,333
13536,6313,Třebíč,2,706,357,349
13537,6313,Třebíč,3,713,374,339
13538,6313,Třebíč,4,703,357,346
13539,6313,Třebíč,5,748,355,393
13540,6313,Třebíč,6,732,368,364
13541,6313,Třebíč,7,705,377,328
13542,6313,Třebíč,8,733,356,377
13543,6313,Třebíč,9,753,382,371
13544,6313,Třebíč,10,725,361,364
13545,6313,Třebíč,11,784,396,388
13546,6313,Třebíč,12,816,426,390
13547,6313,Třebíč,13,818,397,421
13548,6313,Třebíč,14,746,382,364
13549,6313,Třebíč,15,798,416,382
13550,6313,Třebíč,16,700,349,351
13551,6313,Třebíč,17,728,371,357
13552,6313,Třebíč,18,655,341,314
13553,6313,Třebíč,19,685,355,330
13554,6313,Třebíč,20,698,371,327
13555,6313,Třebíč,21,684,345,339
13556,6313,Třebíč,22,718,370,348
13557,6313,Třebíč,23,701,357,344
13558,6313,Třebíč,24,738,377,361
13559,6313,Třebíč,25,772,410,362
13560,6313,Třebíč,26,818,430,388
13561,6313,Třebíč,27,983,517,466
13562,6313,Třebíč,28,944,477,467
13563,6313,Třebíč,29,984,524,460
13564,6313,Třebíč,30,978,510,468
13565,6313,Třebíč,31,898,473,425
13566,6313,Třebíč,32,937,503,434
13567,6313,Třebíč,33,839,446,393
13568,6313,Třebíč,34,882,460,422
13569,6313,Třebíč,35,925,490,435
13570,6313,Třebíč,36,862,448,414
13571,6313,Třebíč,37,968,488,480
13572,6313,Třebíč,38,1012,509,503
13573,6313,Třebíč,39,992,525,467
13574,6313,Třebíč,40,1022,525,497
13575,6313,Třebíč,41,1119,563,556
13576,6313,Třebíč,42,1128,567,561
13577,6313,Třebíč,43,1168,623,545
13578,6313,Třebíč,44,1273,653,620
13579,6313,Třebíč,45,1339,661,678
13580,6313,Třebíč,46,1323,675,648
13581,6313,Třebíč,47,1216,647,569
13582,6313,Třebíč,48,1167,585,582
13583,6313,Třebíč,49,1060,550,510
13584,6313,Třebíč,50,990,495,495
13585,6313,Třebíč,51,946,482,464
13586,6313,Třebíč,52,1006,494,512
13587,6313,Třebíč,53,957,475,482
13588,6313,Třebíč,54,934,455,479
13589,6313,Třebíč,55,1012,525,487
13590,6313,Třebíč,56,1046,506,540
13591,6313,Třebíč,57,998,509,489
13592,6313,Třebíč,58,946,487,459
13593,6313,Třebíč,59,986,502,484
13594,6313,Třebíč,60,944,483,461
13595,6313,Třebíč,61,912,456,456
13596,6313,Třebíč,62,910,463,447
13597,6313,Třebíč,63,1006,500,506
13598,6313,Třebíč,64,1054,533,521
13599,6313,Třebíč,65,1031,497,534
13600,6313,Třebíč,66,989,463,526
13601,6313,Třebíč,67,978,476,502
13602,6313,Třebíč,68,979,463,516
13603,6313,Třebíč,69,980,437,543
13604,6313,Třebíč,70,951,452,499
13605,6313,Třebíč,71,865,409,456
13606,6313,Třebíč,72,847,401,446
13607,6313,Třebíč,73,859,372,487
13608,6313,Třebíč,74,822,379,443
13609,6313,Třebíč,75,654,278,376
13610,6313,Třebíč,76,620,242,378
13611,6313,Třebíč,77,613,248,365
13612,6313,Třebíč,78,488,195,293
13613,6313,Třebíč,79,485,182,303
13614,6313,Třebíč,80,457,177,280
13615,6313,Třebíč,81,397,156,241
13616,6313,Třebíč,82,349,127,222
13617,6313,Třebíč,83,308,119,189
13618,6313,Třebíč,84,268,102,166
13619,6313,Třebíč,85,222,74,148
13620,6313,Třebíč,86,239,78,161
13621,6313,Třebíč,87,214,73,141
13622,6313,Třebíč,88,200,54,146
13623,6313,Třebíč,89,161,47,114
13624,6313,Třebíč,90,135,37,98
13625,6313,Třebíč,91,104,31,73
13626,6313,Třebíč,92,83,20,63
13627,6313,Třebíč,93,55,12,43
13628,6313,Třebíč,94,46,10,36
13629,6313,Třebíč,95,20,3,17
13630,6313,Třebíč,96,14,1,13
13631,6313,Třebíč,97,16,5,11
13632,6313,Třebíč,98,12,1,11
13633,6313,Třebíč,99,4,1,3
13634,6313,Třebíč,100,5,1,4
13635,6314,Velké Meziříčí,0,436,227,209
13636,6314,Velké Meziříčí,1,493,235,258
13637,6314,Velké Meziříčí,2,452,236,216
13638,6314,Velké Meziříčí,3,427,213,214
13639,6314,Velké Meziříčí,4,447,238,209
13640,6314,Velké Meziříčí,5,387,197,190
13641,6314,Velké Meziříčí,6,393,216,177
13642,6314,Velké Meziříčí,7,356,189,167
13643,6314,Velké Meziříčí,8,384,206,178
13644,6314,Velké Meziříčí,9,392,198,194
13645,6314,Velké Meziříčí,10,437,226,211
13646,6314,Velké Meziříčí,11,427,231,196
13647,6314,Velké Meziříčí,12,399,222,177
13648,6314,Velké Meziříčí,13,429,218,211
13649,6314,Velké Meziříčí,14,398,222,176
13650,6314,Velké Meziříčí,15,383,202,181
13651,6314,Velké Meziříčí,16,354,178,176
13652,6314,Velké Meziříčí,17,320,156,164
13653,6314,Velké Meziříčí,18,353,176,177
13654,6314,Velké Meziříčí,19,318,168,150
13655,6314,Velké Meziříčí,20,356,199,157
13656,6314,Velké Meziříčí,21,341,175,166
13657,6314,Velké Meziříčí,22,362,187,175
13658,6314,Velké Meziříčí,23,392,193,199
13659,6314,Velké Meziříčí,24,404,205,199
13660,6314,Velké Meziříčí,25,436,202,234
13661,6314,Velké Meziříčí,26,453,243,210
13662,6314,Velké Meziříčí,27,531,254,277
13663,6314,Velké Meziříčí,28,510,253,257
13664,6314,Velké Meziříčí,29,517,255,262
13665,6314,Velké Meziříčí,30,496,284,212
13666,6314,Velké Meziříčí,31,487,260,227
13667,6314,Velké Meziříčí,32,472,247,225
13668,6314,Velké Meziříčí,33,455,219,236
13669,6314,Velké Meziříčí,34,491,272,219
13670,6314,Velké Meziříčí,35,532,305,227
13671,6314,Velké Meziříčí,36,513,267,246
13672,6314,Velké Meziříčí,37,473,269,204
13673,6314,Velké Meziříčí,38,500,250,250
13674,6314,Velké Meziříčí,39,469,247,222
13675,6314,Velké Meziříčí,40,484,249,235
13676,6314,Velké Meziříčí,41,544,266,278
13677,6314,Velké Meziříčí,42,612,322,290
13678,6314,Velké Meziříčí,43,553,276,277
13679,6314,Velké Meziříčí,44,602,296,306
13680,6314,Velké Meziříčí,45,617,335,282
13681,6314,Velké Meziříčí,46,579,287,292
13682,6314,Velké Meziříčí,47,591,319,272
13683,6314,Velké Meziříčí,48,585,303,282
13684,6314,Velké Meziříčí,49,519,275,244
13685,6314,Velké Meziříčí,50,478,235,243
13686,6314,Velké Meziříčí,51,517,266,251
13687,6314,Velké Meziříčí,52,464,251,213
13688,6314,Velké Meziříčí,53,495,255,240
13689,6314,Velké Meziříčí,54,473,242,231
13690,6314,Velké Meziříčí,55,493,247,246
13691,6314,Velké Meziříčí,56,516,275,241
13692,6314,Velké Meziříčí,57,468,232,236
13693,6314,Velké Meziříčí,58,423,204,219
13694,6314,Velké Meziříčí,59,456,230,226
13695,6314,Velké Meziříčí,60,433,231,202
13696,6314,Velké Meziříčí,61,394,195,199
13697,6314,Velké Meziříčí,62,465,214,251
13698,6314,Velké Meziříčí,63,455,248,207
13699,6314,Velké Meziříčí,64,429,218,211
13700,6314,Velké Meziříčí,65,404,203,201
13701,6314,Velké Meziříčí,66,403,209,194
13702,6314,Velké Meziříčí,67,367,188,179
13703,6314,Velké Meziříčí,68,408,166,242
13704,6314,Velké Meziříčí,69,420,198,222
13705,6314,Velké Meziříčí,70,350,162,188
13706,6314,Velké Meziříčí,71,365,160,205
13707,6314,Velké Meziříčí,72,350,148,202
13708,6314,Velké Meziříčí,73,400,178,222
13709,6314,Velké Meziříčí,74,346,162,184
13710,6314,Velké Meziříčí,75,316,131,185
13711,6314,Velké Meziříčí,76,286,122,164
13712,6314,Velké Meziříčí,77,271,106,165
13713,6314,Velké Meziříčí,78,234,97,137
13714,6314,Velké Meziříčí,79,227,87,140
13715,6314,Velké Meziříčí,80,195,61,134
13716,6314,Velké Meziříčí,81,177,62,115
13717,6314,Velké Meziříčí,82,157,52,105
13718,6314,Velké Meziříčí,83,135,39,96
13719,6314,Velké Meziříčí,84,142,52,90
13720,6314,Velké Meziříčí,85,106,31,75
13721,6314,Velké Meziříčí,86,101,27,74
13722,6314,Velké Meziříčí,87,88,24,64
13723,6314,Velké Meziříčí,88,79,34,45
13724,6314,Velké Meziříčí,89,64,16,48
13725,6314,Velké Meziříčí,90,47,11,36
13726,6314,Velké Meziříčí,91,47,15,32
13727,6314,Velké Meziříčí,92,31,8,23
13728,6314,Velké Meziříčí,93,32,7,25
13729,6314,Velké Meziříčí,94,14,3,11
13730,6314,Velké Meziříčí,95,15,4,11
13731,6314,Velké Meziříčí,96,11,3,8
13732,6314,Velké Meziříčí,97,9,1,8
13733,6314,Velké Meziříčí,98,3,1,2
13734,6314,Velké Meziříčí,99,4,1,3
13735,6314,Velké Meziříčí,100,4,1,3
13736,6315,Žďár nad Sázavou,0,429,220,209
13737,6315,Žďár nad Sázavou,1,450,226,224
13738,6315,Žďár nad Sázavou,2,471,231,240
13739,6315,Žďár nad Sázavou,3,478,245,233
13740,6315,Žďár nad Sázavou,4,449,234,215
13741,6315,Žďár nad Sázavou,5,410,220,190
13742,6315,Žďár nad Sázavou,6,443,224,219
13743,6315,Žďár nad Sázavou,7,383,178,205
13744,6315,Žďár nad Sázavou,8,434,230,204
13745,6315,Žďár nad Sázavou,9,429,231,198
13746,6315,Žďár nad Sázavou,10,476,252,224
13747,6315,Žďár nad Sázavou,11,443,219,224
13748,6315,Žďár nad Sázavou,12,501,266,235
13749,6315,Žďár nad Sázavou,13,456,242,214
13750,6315,Žďár nad Sázavou,14,432,217,215
13751,6315,Žďár nad Sázavou,15,444,234,210
13752,6315,Žďár nad Sázavou,16,460,237,223
13753,6315,Žďár nad Sázavou,17,380,183,197
13754,6315,Žďár nad Sázavou,18,404,203,201
13755,6315,Žďár nad Sázavou,19,416,229,187
13756,6315,Žďár nad Sázavou,20,378,175,203
13757,6315,Žďár nad Sázavou,21,401,219,182
13758,6315,Žďár nad Sázavou,22,418,226,192
13759,6315,Žďár nad Sázavou,23,446,228,218
13760,6315,Žďár nad Sázavou,24,415,214,201
13761,6315,Žďár nad Sázavou,25,445,215,230
13762,6315,Žďár nad Sázavou,26,495,240,255
13763,6315,Žďár nad Sázavou,27,508,250,258
13764,6315,Žďár nad Sázavou,28,532,282,250
13765,6315,Žďár nad Sázavou,29,581,306,275
13766,6315,Žďár nad Sázavou,30,570,308,262
13767,6315,Žďár nad Sázavou,31,507,258,249
13768,6315,Žďár nad Sázavou,32,506,287,219
13769,6315,Žďár nad Sázavou,33,541,303,238
13770,6315,Žďár nad Sázavou,34,556,299,257
13771,6315,Žďár nad Sázavou,35,561,289,272
13772,6315,Žďár nad Sázavou,36,469,255,214
13773,6315,Žďár nad Sázavou,37,571,307,264
13774,6315,Žďár nad Sázavou,38,520,264,256
13775,6315,Žďár nad Sázavou,39,525,255,270
13776,6315,Žďár nad Sázavou,40,573,318,255
13777,6315,Žďár nad Sázavou,41,637,327,310
13778,6315,Žďár nad Sázavou,42,678,350,328
13779,6315,Žďár nad Sázavou,43,676,355,321
13780,6315,Žďár nad Sázavou,44,649,335,314
13781,6315,Žďár nad Sázavou,45,701,352,349
13782,6315,Žďár nad Sázavou,46,722,351,371
13783,6315,Žďár nad Sázavou,47,704,360,344
13784,6315,Žďár nad Sázavou,48,626,315,311
13785,6315,Žďár nad Sázavou,49,626,331,295
13786,6315,Žďár nad Sázavou,50,567,272,295
13787,6315,Žďár nad Sázavou,51,591,284,307
13788,6315,Žďár nad Sázavou,52,514,258,256
13789,6315,Žďár nad Sázavou,53,551,298,253
13790,6315,Žďár nad Sázavou,54,558,286,272
13791,6315,Žďár nad Sázavou,55,590,302,288
13792,6315,Žďár nad Sázavou,56,607,301,306
13793,6315,Žďár nad Sázavou,57,562,277,285
13794,6315,Žďár nad Sázavou,58,554,274,280
13795,6315,Žďár nad Sázavou,59,535,285,250
13796,6315,Žďár nad Sázavou,60,507,252,255
13797,6315,Žďár nad Sázavou,61,502,249,253
13798,6315,Žďár nad Sázavou,62,562,281,281
13799,6315,Žďár nad Sázavou,63,561,273,288
13800,6315,Žďár nad Sázavou,64,561,260,301
13801,6315,Žďár nad Sázavou,65,558,259,299
13802,6315,Žďár nad Sázavou,66,484,233,251
13803,6315,Žďár nad Sázavou,67,547,279,268
13804,6315,Žďár nad Sázavou,68,534,282,252
13805,6315,Žďár nad Sázavou,69,505,239,266
13806,6315,Žďár nad Sázavou,70,492,216,276
13807,6315,Žďár nad Sázavou,71,458,187,271
13808,6315,Žďár nad Sázavou,72,505,219,286
13809,6315,Žďár nad Sázavou,73,482,208,274
13810,6315,Žďár nad Sázavou,74,467,205,262
13811,6315,Žďár nad Sázavou,75,409,168,241
13812,6315,Žďár nad Sázavou,76,385,183,202
13813,6315,Žďár nad Sázavou,77,358,144,214
13814,6315,Žďár nad Sázavou,78,300,118,182
13815,6315,Žďár nad Sázavou,79,276,109,167
13816,6315,Žďár nad Sázavou,80,286,110,176
13817,6315,Žďár nad Sázavou,81,236,84,152
13818,6315,Žďár nad Sázavou,82,257,101,156
13819,6315,Žďár nad Sázavou,83,220,79,141
13820,6315,Žďár nad Sázavou,84,204,83,121
13821,6315,Žďár nad Sázavou,85,170,73,97
13822,6315,Žďár nad Sázavou,86,130,38,92
13823,6315,Žďár nad Sázavou,87,116,40,76
13824,6315,Žďár nad Sázavou,88,106,28,78
13825,6315,Žďár nad Sázavou,89,83,29,54
13826,6315,Žďár nad Sázavou,90,67,20,47
13827,6315,Žďár nad Sázavou,91,58,15,43
13828,6315,Žďár nad Sázavou,92,52,15,37
13829,6315,Žďár nad Sázavou,93,26,11,15
13830,6315,Žďár nad Sázavou,94,19,5,14
13831,6315,Žďár nad Sázavou,95,21,2,19
13832,6315,Žďár nad Sázavou,96,6,2,4
13833,6315,Žďár nad Sázavou,97,7,1,6
13834,6315,Žďár nad Sázavou,98,6,2,4
13835,6315,Žďár nad Sázavou,99,2,0,2
13836,6315,Žďár nad Sázavou,100,3,0,3
13837,6401,Blansko,0,552,285,267
13838,6401,Blansko,1,642,327,315
13839,6401,Blansko,2,630,327,303
13840,6401,Blansko,3,680,378,302
13841,6401,Blansko,4,653,323,330
13842,6401,Blansko,5,656,338,318
13843,6401,Blansko,6,634,330,304
13844,6401,Blansko,7,685,346,339
13845,6401,Blansko,8,651,320,331
13846,6401,Blansko,9,628,342,286
13847,6401,Blansko,10,676,335,341
13848,6401,Blansko,11,657,322,335
13849,6401,Blansko,12,683,340,343
13850,6401,Blansko,13,631,323,308
13851,6401,Blansko,14,528,287,241
13852,6401,Blansko,15,515,258,257
13853,6401,Blansko,16,555,290,265
13854,6401,Blansko,17,478,242,236
13855,6401,Blansko,18,482,264,218
13856,6401,Blansko,19,433,201,232
13857,6401,Blansko,20,418,219,199
13858,6401,Blansko,21,432,230,202
13859,6401,Blansko,22,466,258,208
13860,6401,Blansko,23,473,251,222
13861,6401,Blansko,24,461,236,225
13862,6401,Blansko,25,505,259,246
13863,6401,Blansko,26,562,285,277
13864,6401,Blansko,27,696,348,348
13865,6401,Blansko,28,641,345,296
13866,6401,Blansko,29,719,376,343
13867,6401,Blansko,30,710,362,348
13868,6401,Blansko,31,747,378,369
13869,6401,Blansko,32,689,334,355
13870,6401,Blansko,33,722,363,359
13871,6401,Blansko,34,745,385,360
13872,6401,Blansko,35,721,376,345
13873,6401,Blansko,36,778,408,370
13874,6401,Blansko,37,866,418,448
13875,6401,Blansko,38,865,436,429
13876,6401,Blansko,39,820,418,402
13877,6401,Blansko,40,854,430,424
13878,6401,Blansko,41,972,464,508
13879,6401,Blansko,42,962,491,471
13880,6401,Blansko,43,1002,518,484
13881,6401,Blansko,44,966,498,468
13882,6401,Blansko,45,1059,565,494
13883,6401,Blansko,46,1043,538,505
13884,6401,Blansko,47,920,500,420
13885,6401,Blansko,48,857,466,391
13886,6401,Blansko,49,781,388,393
13887,6401,Blansko,50,797,390,407
13888,6401,Blansko,51,760,399,361
13889,6401,Blansko,52,617,315,302
13890,6401,Blansko,53,697,351,346
13891,6401,Blansko,54,703,332,371
13892,6401,Blansko,55,758,360,398
13893,6401,Blansko,56,741,380,361
13894,6401,Blansko,57,700,381,319
13895,6401,Blansko,58,662,369,293
13896,6401,Blansko,59,618,306,312
13897,6401,Blansko,60,625,326,299
13898,6401,Blansko,61,632,299,333
13899,6401,Blansko,62,645,324,321
13900,6401,Blansko,63,743,376,367
13901,6401,Blansko,64,759,367,392
13902,6401,Blansko,65,745,354,391
13903,6401,Blansko,66,713,342,371
13904,6401,Blansko,67,704,332,372
13905,6401,Blansko,68,770,336,434
13906,6401,Blansko,69,699,323,376
13907,6401,Blansko,70,667,320,347
13908,6401,Blansko,71,670,300,370
13909,6401,Blansko,72,656,285,371
13910,6401,Blansko,73,639,284,355
13911,6401,Blansko,74,664,292,372
13912,6401,Blansko,75,515,223,292
13913,6401,Blansko,76,511,203,308
13914,6401,Blansko,77,508,212,296
13915,6401,Blansko,78,424,164,260
13916,6401,Blansko,79,434,169,265
13917,6401,Blansko,80,374,138,236
13918,6401,Blansko,81,304,116,188
13919,6401,Blansko,82,289,102,187
13920,6401,Blansko,83,247,95,152
13921,6401,Blansko,84,253,93,160
13922,6401,Blansko,85,209,72,137
13923,6401,Blansko,86,189,73,116
13924,6401,Blansko,87,192,68,124
13925,6401,Blansko,88,165,50,115
13926,6401,Blansko,89,145,49,96
13927,6401,Blansko,90,120,43,77
13928,6401,Blansko,91,72,24,48
13929,6401,Blansko,92,70,18,52
13930,6401,Blansko,93,44,8,36
13931,6401,Blansko,94,30,7,23
13932,6401,Blansko,95,24,5,19
13933,6401,Blansko,96,13,1,12
13934,6401,Blansko,97,13,4,9
13935,6401,Blansko,98,10,1,9
13936,6401,Blansko,99,2,1,1
13937,6401,Blansko,100,3,0,3
13938,6402,Boskovice,0,518,272,246
13939,6402,Boskovice,1,590,293,297
13940,6402,Boskovice,2,574,279,295
13941,6402,Boskovice,3,589,298,291
13942,6402,Boskovice,4,554,286,268
13943,6402,Boskovice,5,536,277,259
13944,6402,Boskovice,6,557,272,285
13945,6402,Boskovice,7,532,288,244
13946,6402,Boskovice,8,555,276,279
13947,6402,Boskovice,9,532,266,266
13948,6402,Boskovice,10,624,329,295
13949,6402,Boskovice,11,610,320,290
13950,6402,Boskovice,12,618,319,299
13951,6402,Boskovice,13,547,272,275
13952,6402,Boskovice,14,576,288,288
13953,6402,Boskovice,15,507,252,255
13954,6402,Boskovice,16,495,242,253
13955,6402,Boskovice,17,494,257,237
13956,6402,Boskovice,18,472,255,217
13957,6402,Boskovice,19,473,234,239
13958,6402,Boskovice,20,493,258,235
13959,6402,Boskovice,21,473,222,251
13960,6402,Boskovice,22,522,265,257
13961,6402,Boskovice,23,530,270,260
13962,6402,Boskovice,24,519,271,248
13963,6402,Boskovice,25,548,263,285
13964,6402,Boskovice,26,602,283,319
13965,6402,Boskovice,27,652,342,310
13966,6402,Boskovice,28,618,322,296
13967,6402,Boskovice,29,701,393,308
13968,6402,Boskovice,30,649,334,315
13969,6402,Boskovice,31,638,323,315
13970,6402,Boskovice,32,641,320,321
13971,6402,Boskovice,33,651,337,314
13972,6402,Boskovice,34,679,344,335
13973,6402,Boskovice,35,668,352,316
13974,6402,Boskovice,36,721,368,353
13975,6402,Boskovice,37,701,354,347
13976,6402,Boskovice,38,731,384,347
13977,6402,Boskovice,39,725,368,357
13978,6402,Boskovice,40,739,384,355
13979,6402,Boskovice,41,847,430,417
13980,6402,Boskovice,42,823,418,405
13981,6402,Boskovice,43,874,476,398
13982,6402,Boskovice,44,920,484,436
13983,6402,Boskovice,45,942,492,450
13984,6402,Boskovice,46,903,470,433
13985,6402,Boskovice,47,927,476,451
13986,6402,Boskovice,48,779,401,378
13987,6402,Boskovice,49,760,403,357
13988,6402,Boskovice,50,655,326,329
13989,6402,Boskovice,51,683,332,351
13990,6402,Boskovice,52,635,333,302
13991,6402,Boskovice,53,620,330,290
13992,6402,Boskovice,54,625,330,295
13993,6402,Boskovice,55,685,349,336
13994,6402,Boskovice,56,679,373,306
13995,6402,Boskovice,57,639,322,317
13996,6402,Boskovice,58,599,301,298
13997,6402,Boskovice,59,603,311,292
13998,6402,Boskovice,60,580,301,279
13999,6402,Boskovice,61,595,304,291
14000,6402,Boskovice,62,614,290,324
14001,6402,Boskovice,63,638,295,343
14002,6402,Boskovice,64,666,317,349
14003,6402,Boskovice,65,697,334,363
14004,6402,Boskovice,66,647,280,367
14005,6402,Boskovice,67,660,314,346
14006,6402,Boskovice,68,649,305,344
14007,6402,Boskovice,69,635,298,337
14008,6402,Boskovice,70,635,304,331
14009,6402,Boskovice,71,573,247,326
14010,6402,Boskovice,72,593,251,342
14011,6402,Boskovice,73,579,257,322
14012,6402,Boskovice,74,554,242,312
14013,6402,Boskovice,75,462,185,277
14014,6402,Boskovice,76,448,195,253
14015,6402,Boskovice,77,425,188,237
14016,6402,Boskovice,78,397,174,223
14017,6402,Boskovice,79,342,134,208
14018,6402,Boskovice,80,335,135,200
14019,6402,Boskovice,81,268,89,179
14020,6402,Boskovice,82,261,84,177
14021,6402,Boskovice,83,206,63,143
14022,6402,Boskovice,84,173,62,111
14023,6402,Boskovice,85,190,68,122
14024,6402,Boskovice,86,161,48,113
14025,6402,Boskovice,87,127,40,87
14026,6402,Boskovice,88,125,39,86
14027,6402,Boskovice,89,117,33,84
14028,6402,Boskovice,90,98,30,68
14029,6402,Boskovice,91,73,22,51
14030,6402,Boskovice,92,57,13,44
14031,6402,Boskovice,93,37,6,31
14032,6402,Boskovice,94,27,2,25
14033,6402,Boskovice,95,20,2,18
14034,6402,Boskovice,96,14,3,11
14035,6402,Boskovice,97,13,2,11
14036,6402,Boskovice,98,7,1,6
14037,6402,Boskovice,99,4,0,4
14038,6402,Boskovice,100,5,2,3
14039,6403,Brno,0,4448,2299,2149
14040,6403,Brno,1,4489,2307,2182
14041,6403,Brno,2,4391,2288,2103
14042,6403,Brno,3,4265,2143,2122
14043,6403,Brno,4,4209,2119,2090
14044,6403,Brno,5,4041,2057,1984
14045,6403,Brno,6,3992,2043,1949
14046,6403,Brno,7,3809,2003,1806
14047,6403,Brno,8,3700,1883,1817
14048,6403,Brno,9,3796,1943,1853
14049,6403,Brno,10,3889,1988,1901
14050,6403,Brno,11,3906,2012,1894
14051,6403,Brno,12,3804,1936,1868
14052,6403,Brno,13,3630,1813,1817
14053,6403,Brno,14,3421,1769,1652
14054,6403,Brno,15,3199,1629,1570
14055,6403,Brno,16,2981,1552,1429
14056,6403,Brno,17,2847,1463,1384
14057,6403,Brno,18,3133,1599,1534
14058,6403,Brno,19,3203,1616,1587
14059,6403,Brno,20,3090,1564,1526
14060,6403,Brno,21,2925,1546,1379
14061,6403,Brno,22,3022,1521,1501
14062,6403,Brno,23,3145,1587,1558
14063,6403,Brno,24,3219,1600,1619
14064,6403,Brno,25,3592,1844,1748
14065,6403,Brno,26,4117,2099,2018
14066,6403,Brno,27,4809,2462,2347
14067,6403,Brno,28,5045,2595,2450
14068,6403,Brno,29,5582,2845,2737
14069,6403,Brno,30,5731,2918,2813
14070,6403,Brno,31,5914,2980,2934
14071,6403,Brno,32,6147,3145,3002
14072,6403,Brno,33,6143,3212,2931
14073,6403,Brno,34,6216,3251,2965
14074,6403,Brno,35,6369,3393,2976
14075,6403,Brno,36,6181,3267,2914
14076,6403,Brno,37,6053,3148,2905
14077,6403,Brno,38,6235,3246,2989
14078,6403,Brno,39,5913,3032,2881
14079,6403,Brno,40,6192,3257,2935
14080,6403,Brno,41,6500,3325,3175
14081,6403,Brno,42,6444,3409,3035
14082,6403,Brno,43,6422,3236,3186
14083,6403,Brno,44,6518,3322,3196
14084,6403,Brno,45,6565,3382,3183
14085,6403,Brno,46,6497,3333,3164
14086,6403,Brno,47,5891,2964,2927
14087,6403,Brno,48,5181,2638,2543
14088,6403,Brno,49,4839,2490,2349
14089,6403,Brno,50,4675,2343,2332
14090,6403,Brno,51,4487,2288,2199
14091,6403,Brno,52,4528,2257,2271
14092,6403,Brno,53,4391,2214,2177
14093,6403,Brno,54,4444,2223,2221
14094,6403,Brno,55,4760,2342,2418
14095,6403,Brno,56,4944,2415,2529
14096,6403,Brno,57,4707,2329,2378
14097,6403,Brno,58,4245,2005,2240
14098,6403,Brno,59,4170,1945,2225
14099,6403,Brno,60,4062,1936,2126
14100,6403,Brno,61,3979,1916,2063
14101,6403,Brno,62,4189,1979,2210
14102,6403,Brno,63,4460,2070,2390
14103,6403,Brno,64,4752,2183,2569
14104,6403,Brno,65,4636,2105,2531
14105,6403,Brno,66,4583,2122,2461
14106,6403,Brno,67,4505,2074,2431
14107,6403,Brno,68,4457,1979,2478
14108,6403,Brno,69,4366,1852,2514
14109,6403,Brno,70,4207,1804,2403
14110,6403,Brno,71,4030,1671,2359
14111,6403,Brno,72,4114,1744,2370
14112,6403,Brno,73,4317,1642,2675
14113,6403,Brno,74,4646,1915,2731
14114,6403,Brno,75,3513,1404,2109
14115,6403,Brno,76,3778,1555,2223
14116,6403,Brno,77,3626,1518,2108
14117,6403,Brno,78,3075,1207,1868
14118,6403,Brno,79,2815,1162,1653
14119,6403,Brno,80,2511,998,1513
14120,6403,Brno,81,2157,815,1342
14121,6403,Brno,82,1943,735,1208
14122,6403,Brno,83,1738,633,1105
14123,6403,Brno,84,1623,582,1041
14124,6403,Brno,85,1409,525,884
14125,6403,Brno,86,1284,432,852
14126,6403,Brno,87,1238,407,831
14127,6403,Brno,88,1069,359,710
14128,6403,Brno,89,946,294,652
14129,6403,Brno,90,823,234,589
14130,6403,Brno,91,676,197,479
14131,6403,Brno,92,500,130,370
14132,6403,Brno,93,426,121,305
14133,6403,Brno,94,319,83,236
14134,6403,Brno,95,211,50,161
14135,6403,Brno,96,153,26,127
14136,6403,Brno,97,102,26,76
14137,6403,Brno,98,68,16,52
14138,6403,Brno,99,43,13,30
14139,6403,Brno,100,55,19,36
14140,6404,Břeclav,0,553,291,262
14141,6404,Břeclav,1,562,278,284
14142,6404,Břeclav,2,585,323,262
14143,6404,Břeclav,3,594,312,282
14144,6404,Břeclav,4,603,305,298
14145,6404,Břeclav,5,565,286,279
14146,6404,Břeclav,6,599,307,292
14147,6404,Břeclav,7,572,282,290
14148,6404,Břeclav,8,595,319,276
14149,6404,Břeclav,9,558,289,269
14150,6404,Břeclav,10,587,284,303
14151,6404,Břeclav,11,638,342,296
14152,6404,Břeclav,12,654,324,330
14153,6404,Břeclav,13,581,279,302
14154,6404,Břeclav,14,605,298,307
14155,6404,Břeclav,15,543,256,287
14156,6404,Břeclav,16,565,304,261
14157,6404,Břeclav,17,500,239,261
14158,6404,Břeclav,18,490,271,219
14159,6404,Břeclav,19,508,278,230
14160,6404,Břeclav,20,527,262,265
14161,6404,Břeclav,21,501,282,219
14162,6404,Břeclav,22,521,277,244
14163,6404,Břeclav,23,488,268,220
14164,6404,Břeclav,24,542,297,245
14165,6404,Břeclav,25,572,294,278
14166,6404,Břeclav,26,665,334,331
14167,6404,Břeclav,27,774,391,383
14168,6404,Břeclav,28,762,379,383
14169,6404,Břeclav,29,753,385,368
14170,6404,Břeclav,30,687,357,330
14171,6404,Břeclav,31,762,388,374
14172,6404,Břeclav,32,754,420,334
14173,6404,Břeclav,33,771,409,362
14174,6404,Břeclav,34,737,367,370
14175,6404,Břeclav,35,790,408,382
14176,6404,Břeclav,36,808,419,389
14177,6404,Břeclav,37,795,409,386
14178,6404,Břeclav,38,799,416,383
14179,6404,Břeclav,39,871,456,415
14180,6404,Břeclav,40,892,456,436
14181,6404,Břeclav,41,982,504,478
14182,6404,Břeclav,42,1014,539,475
14183,6404,Břeclav,43,974,472,502
14184,6404,Břeclav,44,1056,545,511
14185,6404,Břeclav,45,1080,537,543
14186,6404,Břeclav,46,1087,529,558
14187,6404,Břeclav,47,1018,545,473
14188,6404,Břeclav,48,945,484,461
14189,6404,Břeclav,49,849,430,419
14190,6404,Břeclav,50,925,463,462
14191,6404,Břeclav,51,885,458,427
14192,6404,Břeclav,52,849,433,416
14193,6404,Břeclav,53,774,391,383
14194,6404,Břeclav,54,827,382,445
14195,6404,Břeclav,55,832,414,418
14196,6404,Břeclav,56,866,453,413
14197,6404,Břeclav,57,784,395,389
14198,6404,Břeclav,58,712,355,357
14199,6404,Břeclav,59,729,367,362
14200,6404,Břeclav,60,665,321,344
14201,6404,Břeclav,61,714,366,348
14202,6404,Břeclav,62,719,323,396
14203,6404,Břeclav,63,801,370,431
14204,6404,Břeclav,64,823,367,456
14205,6404,Břeclav,65,836,394,442
14206,6404,Břeclav,66,814,372,442
14207,6404,Břeclav,67,867,431,436
14208,6404,Břeclav,68,776,364,412
14209,6404,Břeclav,69,764,349,415
14210,6404,Břeclav,70,753,329,424
14211,6404,Břeclav,71,711,331,380
14212,6404,Břeclav,72,680,302,378
14213,6404,Břeclav,73,738,312,426
14214,6404,Břeclav,74,657,269,388
14215,6404,Břeclav,75,522,208,314
14216,6404,Břeclav,76,511,219,292
14217,6404,Břeclav,77,491,208,283
14218,6404,Břeclav,78,458,176,282
14219,6404,Břeclav,79,396,140,256
14220,6404,Břeclav,80,385,137,248
14221,6404,Břeclav,81,318,104,214
14222,6404,Břeclav,82,284,110,174
14223,6404,Břeclav,83,240,84,156
14224,6404,Břeclav,84,191,63,128
14225,6404,Břeclav,85,184,62,122
14226,6404,Břeclav,86,159,50,109
14227,6404,Břeclav,87,140,42,98
14228,6404,Břeclav,88,135,39,96
14229,6404,Břeclav,89,132,36,96
14230,6404,Břeclav,90,84,26,58
14231,6404,Břeclav,91,67,21,46
14232,6404,Břeclav,92,56,7,49
14233,6404,Břeclav,93,34,6,28
14234,6404,Břeclav,94,22,2,20
14235,6404,Břeclav,95,19,3,16
14236,6404,Břeclav,96,9,1,8
14237,6404,Břeclav,97,9,2,7
14238,6404,Břeclav,98,9,2,7
14239,6404,Břeclav,99,8,1,7
14240,6404,Břeclav,100,7,0,7
14241,6405,Bučovice,0,185,96,89
14242,6405,Bučovice,1,189,89,100
14243,6405,Bučovice,2,183,85,98
14244,6405,Bučovice,3,180,87,93
14245,6405,Bučovice,4,163,81,82
14246,6405,Bučovice,5,150,73,77
14247,6405,Bučovice,6,186,81,105
14248,6405,Bučovice,7,183,91,92
14249,6405,Bučovice,8,161,75,86
14250,6405,Bučovice,9,142,83,59
14251,6405,Bučovice,10,189,99,90
14252,6405,Bučovice,11,166,80,86
14253,6405,Bučovice,12,171,94,77
14254,6405,Bučovice,13,164,98,66
14255,6405,Bučovice,14,155,85,70
14256,6405,Bučovice,15,145,74,71
14257,6405,Bučovice,16,143,70,73
14258,6405,Bučovice,17,156,78,78
14259,6405,Bučovice,18,152,71,81
14260,6405,Bučovice,19,130,72,58
14261,6405,Bučovice,20,137,73,64
14262,6405,Bučovice,21,143,72,71
14263,6405,Bučovice,22,129,62,67
14264,6405,Bučovice,23,161,81,80
14265,6405,Bučovice,24,159,81,78
14266,6405,Bučovice,25,151,73,78
14267,6405,Bučovice,26,195,107,88
14268,6405,Bučovice,27,209,117,92
14269,6405,Bučovice,28,220,116,104
14270,6405,Bučovice,29,251,113,138
14271,6405,Bučovice,30,206,111,95
14272,6405,Bučovice,31,184,96,88
14273,6405,Bučovice,32,220,102,118
14274,6405,Bučovice,33,227,126,101
14275,6405,Bučovice,34,220,118,102
14276,6405,Bučovice,35,227,118,109
14277,6405,Bučovice,36,234,131,103
14278,6405,Bučovice,37,224,113,111
14279,6405,Bučovice,38,232,134,98
14280,6405,Bučovice,39,207,117,90
14281,6405,Bučovice,40,245,135,110
14282,6405,Bučovice,41,238,115,123
14283,6405,Bučovice,42,273,142,131
14284,6405,Bučovice,43,214,113,101
14285,6405,Bučovice,44,301,144,157
14286,6405,Bučovice,45,299,155,144
14287,6405,Bučovice,46,268,139,129
14288,6405,Bučovice,47,263,143,120
14289,6405,Bučovice,48,238,129,109
14290,6405,Bučovice,49,256,150,106
14291,6405,Bučovice,50,261,129,132
14292,6405,Bučovice,51,224,112,112
14293,6405,Bučovice,52,203,107,96
14294,6405,Bučovice,53,207,109,98
14295,6405,Bučovice,54,191,94,97
14296,6405,Bučovice,55,212,123,89
14297,6405,Bučovice,56,220,115,105
14298,6405,Bučovice,57,226,109,117
14299,6405,Bučovice,58,206,103,103
14300,6405,Bučovice,59,186,93,93
14301,6405,Bučovice,60,176,89,87
14302,6405,Bučovice,61,197,102,95
14303,6405,Bučovice,62,201,114,87
14304,6405,Bučovice,63,205,103,102
14305,6405,Bučovice,64,219,131,88
14306,6405,Bučovice,65,211,104,107
14307,6405,Bučovice,66,190,82,108
14308,6405,Bučovice,67,208,103,105
14309,6405,Bučovice,68,210,109,101
14310,6405,Bučovice,69,191,75,116
14311,6405,Bučovice,70,189,78,111
14312,6405,Bučovice,71,160,79,81
14313,6405,Bučovice,72,218,102,116
14314,6405,Bučovice,73,150,72,78
14315,6405,Bučovice,74,176,75,101
14316,6405,Bučovice,75,135,64,71
14317,6405,Bučovice,76,149,49,100
14318,6405,Bučovice,77,128,47,81
14319,6405,Bučovice,78,110,40,70
14320,6405,Bučovice,79,99,47,52
14321,6405,Bučovice,80,114,41,73
14322,6405,Bučovice,81,83,31,52
14323,6405,Bučovice,82,71,25,46
14324,6405,Bučovice,83,71,22,49
14325,6405,Bučovice,84,46,16,30
14326,6405,Bučovice,85,44,14,30
14327,6405,Bučovice,86,45,19,26
14328,6405,Bučovice,87,41,12,29
14329,6405,Bučovice,88,43,8,35
14330,6405,Bučovice,89,28,3,25
14331,6405,Bučovice,90,29,9,20
14332,6405,Bučovice,91,25,9,16
14333,6405,Bučovice,92,14,2,12
14334,6405,Bučovice,93,18,5,13
14335,6405,Bučovice,94,17,4,13
14336,6405,Bučovice,95,8,1,7
14337,6405,Bučovice,96,3,0,3
14338,6405,Bučovice,97,3,0,3
14339,6405,Bučovice,98,2,0,2
14340,6405,Bučovice,99,1,0,1
14341,6405,Bučovice,100,2,1,1
14342,6406,Hodonín,0,532,266,266
14343,6406,Hodonín,1,595,299,296
14344,6406,Hodonín,2,606,308,298
14345,6406,Hodonín,3,614,324,290
14346,6406,Hodonín,4,585,287,298
14347,6406,Hodonín,5,584,293,291
14348,6406,Hodonín,6,605,313,292
14349,6406,Hodonín,7,553,290,263
14350,6406,Hodonín,8,572,290,282
14351,6406,Hodonín,9,598,292,306
14352,6406,Hodonín,10,598,302,296
14353,6406,Hodonín,11,651,339,312
14354,6406,Hodonín,12,612,327,285
14355,6406,Hodonín,13,634,333,301
14356,6406,Hodonín,14,582,292,290
14357,6406,Hodonín,15,547,282,265
14358,6406,Hodonín,16,511,280,231
14359,6406,Hodonín,17,498,266,232
14360,6406,Hodonín,18,550,268,282
14361,6406,Hodonín,19,508,260,248
14362,6406,Hodonín,20,473,263,210
14363,6406,Hodonín,21,537,271,266
14364,6406,Hodonín,22,513,257,256
14365,6406,Hodonín,23,531,261,270
14366,6406,Hodonín,24,537,285,252
14367,6406,Hodonín,25,539,276,263
14368,6406,Hodonín,26,662,355,307
14369,6406,Hodonín,27,771,408,363
14370,6406,Hodonín,28,754,383,371
14371,6406,Hodonín,29,792,455,337
14372,6406,Hodonín,30,762,387,375
14373,6406,Hodonín,31,759,377,382
14374,6406,Hodonín,32,810,435,375
14375,6406,Hodonín,33,777,395,382
14376,6406,Hodonín,34,795,402,393
14377,6406,Hodonín,35,821,427,394
14378,6406,Hodonín,36,850,462,388
14379,6406,Hodonín,37,814,451,363
14380,6406,Hodonín,38,841,455,386
14381,6406,Hodonín,39,822,424,398
14382,6406,Hodonín,40,920,460,460
14383,6406,Hodonín,41,1015,570,445
14384,6406,Hodonín,42,1012,541,471
14385,6406,Hodonín,43,1014,509,505
14386,6406,Hodonín,44,1050,531,519
14387,6406,Hodonín,45,1016,488,528
14388,6406,Hodonín,46,981,518,463
14389,6406,Hodonín,47,966,471,495
14390,6406,Hodonín,48,971,498,473
14391,6406,Hodonín,49,843,427,416
14392,6406,Hodonín,50,845,414,431
14393,6406,Hodonín,51,877,447,430
14394,6406,Hodonín,52,790,405,385
14395,6406,Hodonín,53,838,408,430
14396,6406,Hodonín,54,885,468,417
14397,6406,Hodonín,55,848,451,397
14398,6406,Hodonín,56,932,464,468
14399,6406,Hodonín,57,836,424,412
14400,6406,Hodonín,58,849,413,436
14401,6406,Hodonín,59,762,368,394
14402,6406,Hodonín,60,796,415,381
14403,6406,Hodonín,61,787,402,385
14404,6406,Hodonín,62,831,423,408
14405,6406,Hodonín,63,828,380,448
14406,6406,Hodonín,64,852,433,419
14407,6406,Hodonín,65,826,400,426
14408,6406,Hodonín,66,812,377,435
14409,6406,Hodonín,67,790,368,422
14410,6406,Hodonín,68,830,390,440
14411,6406,Hodonín,69,805,360,445
14412,6406,Hodonín,70,744,349,395
14413,6406,Hodonín,71,707,327,380
14414,6406,Hodonín,72,682,295,387
14415,6406,Hodonín,73,637,264,373
14416,6406,Hodonín,74,641,264,377
14417,6406,Hodonín,75,551,219,332
14418,6406,Hodonín,76,508,197,311
14419,6406,Hodonín,77,525,222,303
14420,6406,Hodonín,78,487,183,304
14421,6406,Hodonín,79,393,142,251
14422,6406,Hodonín,80,396,159,237
14423,6406,Hodonín,81,276,96,180
14424,6406,Hodonín,82,312,108,204
14425,6406,Hodonín,83,241,84,157
14426,6406,Hodonín,84,218,68,150
14427,6406,Hodonín,85,212,63,149
14428,6406,Hodonín,86,189,45,144
14429,6406,Hodonín,87,151,33,118
14430,6406,Hodonín,88,133,26,107
14431,6406,Hodonín,89,122,20,102
14432,6406,Hodonín,90,101,19,82
14433,6406,Hodonín,91,80,18,62
14434,6406,Hodonín,92,50,15,35
14435,6406,Hodonín,93,44,11,33
14436,6406,Hodonín,94,24,4,20
14437,6406,Hodonín,95,21,4,17
14438,6406,Hodonín,96,15,1,14
14439,6406,Hodonín,97,8,2,6
14440,6406,Hodonín,98,5,1,4
14441,6406,Hodonín,99,1,0,1
14442,6406,Hodonín,100,3,1,2
14443,6407,Hustopeče,0,379,192,187
14444,6407,Hustopeče,1,425,221,204
14445,6407,Hustopeče,2,422,217,205
14446,6407,Hustopeče,3,414,209,205
14447,6407,Hustopeče,4,430,222,208
14448,6407,Hustopeče,5,358,191,167
14449,6407,Hustopeče,6,365,186,179
14450,6407,Hustopeče,7,391,205,186
14451,6407,Hustopeče,8,385,206,179
14452,6407,Hustopeče,9,358,193,165
14453,6407,Hustopeče,10,426,209,217
14454,6407,Hustopeče,11,425,221,204
14455,6407,Hustopeče,12,377,185,192
14456,6407,Hustopeče,13,372,183,189
14457,6407,Hustopeče,14,367,200,167
14458,6407,Hustopeče,15,333,158,175
14459,6407,Hustopeče,16,358,180,178
14460,6407,Hustopeče,17,324,180,144
14461,6407,Hustopeče,18,304,148,156
14462,6407,Hustopeče,19,304,160,144
14463,6407,Hustopeče,20,298,165,133
14464,6407,Hustopeče,21,369,201,168
14465,6407,Hustopeče,22,338,160,178
14466,6407,Hustopeče,23,345,173,172
14467,6407,Hustopeče,24,345,174,171
14468,6407,Hustopeče,25,352,187,165
14469,6407,Hustopeče,26,414,208,206
14470,6407,Hustopeče,27,462,219,243
14471,6407,Hustopeče,28,478,251,227
14472,6407,Hustopeče,29,438,229,209
14473,6407,Hustopeče,30,492,266,226
14474,6407,Hustopeče,31,475,246,229
14475,6407,Hustopeče,32,488,248,240
14476,6407,Hustopeče,33,466,236,230
14477,6407,Hustopeče,34,505,257,248
14478,6407,Hustopeče,35,489,247,242
14479,6407,Hustopeče,36,529,297,232
14480,6407,Hustopeče,37,527,275,252
14481,6407,Hustopeče,38,525,259,266
14482,6407,Hustopeče,39,536,271,265
14483,6407,Hustopeče,40,601,316,285
14484,6407,Hustopeče,41,603,321,282
14485,6407,Hustopeče,42,567,279,288
14486,6407,Hustopeče,43,600,330,270
14487,6407,Hustopeče,44,619,322,297
14488,6407,Hustopeče,45,600,314,286
14489,6407,Hustopeče,46,674,355,319
14490,6407,Hustopeče,47,588,308,280
14491,6407,Hustopeče,48,538,276,262
14492,6407,Hustopeče,49,538,287,251
14493,6407,Hustopeče,50,530,269,261
14494,6407,Hustopeče,51,482,257,225
14495,6407,Hustopeče,52,463,248,215
14496,6407,Hustopeče,53,480,259,221
14497,6407,Hustopeče,54,486,261,225
14498,6407,Hustopeče,55,505,262,243
14499,6407,Hustopeče,56,477,238,239
14500,6407,Hustopeče,57,483,242,241
14501,6407,Hustopeče,58,438,222,216
14502,6407,Hustopeče,59,448,230,218
14503,6407,Hustopeče,60,436,239,197
14504,6407,Hustopeče,61,449,231,218
14505,6407,Hustopeče,62,429,216,213
14506,6407,Hustopeče,63,482,237,245
14507,6407,Hustopeče,64,446,222,224
14508,6407,Hustopeče,65,454,215,239
14509,6407,Hustopeče,66,461,206,255
14510,6407,Hustopeče,67,426,232,194
14511,6407,Hustopeče,68,420,201,219
14512,6407,Hustopeče,69,429,194,235
14513,6407,Hustopeče,70,430,193,237
14514,6407,Hustopeče,71,398,174,224
14515,6407,Hustopeče,72,438,194,244
14516,6407,Hustopeče,73,416,173,243
14517,6407,Hustopeče,74,403,170,233
14518,6407,Hustopeče,75,299,124,175
14519,6407,Hustopeče,76,289,123,166
14520,6407,Hustopeče,77,278,108,170
14521,6407,Hustopeče,78,258,108,150
14522,6407,Hustopeče,79,235,97,138
14523,6407,Hustopeče,80,194,73,121
14524,6407,Hustopeče,81,172,60,112
14525,6407,Hustopeče,82,175,55,120
14526,6407,Hustopeče,83,118,40,78
14527,6407,Hustopeče,84,135,40,95
14528,6407,Hustopeče,85,122,33,89
14529,6407,Hustopeče,86,89,31,58
14530,6407,Hustopeče,87,86,23,63
14531,6407,Hustopeče,88,72,18,54
14532,6407,Hustopeče,89,69,20,49
14533,6407,Hustopeče,90,73,20,53
14534,6407,Hustopeče,91,55,10,45
14535,6407,Hustopeče,92,36,7,29
14536,6407,Hustopeče,93,28,5,23
14537,6407,Hustopeče,94,21,4,17
14538,6407,Hustopeče,95,16,3,13
14539,6407,Hustopeče,96,10,2,8
14540,6407,Hustopeče,97,7,3,4
14541,6407,Hustopeče,98,1,0,1
14542,6407,Hustopeče,99,4,0,4
14543,6407,Hustopeče,100,2,1,1
14544,6408,Ivančice,0,268,124,144
14545,6408,Ivančice,1,257,128,129
14546,6408,Ivančice,2,287,157,130
14547,6408,Ivančice,3,273,158,115
14548,6408,Ivančice,4,274,149,125
14549,6408,Ivančice,5,254,114,140
14550,6408,Ivančice,6,277,160,117
14551,6408,Ivančice,7,228,113,115
14552,6408,Ivančice,8,211,114,97
14553,6408,Ivančice,9,241,122,119
14554,6408,Ivančice,10,293,140,153
14555,6408,Ivančice,11,262,128,134
14556,6408,Ivančice,12,276,137,139
14557,6408,Ivančice,13,257,113,144
14558,6408,Ivančice,14,255,121,134
14559,6408,Ivančice,15,244,125,119
14560,6408,Ivančice,16,226,105,121
14561,6408,Ivančice,17,223,111,112
14562,6408,Ivančice,18,207,104,103
14563,6408,Ivančice,19,224,124,100
14564,6408,Ivančice,20,232,113,119
14565,6408,Ivančice,21,203,106,97
14566,6408,Ivančice,22,215,107,108
14567,6408,Ivančice,23,231,131,100
14568,6408,Ivančice,24,230,120,110
14569,6408,Ivančice,25,255,128,127
14570,6408,Ivančice,26,256,129,127
14571,6408,Ivančice,27,320,163,157
14572,6408,Ivančice,28,317,180,137
14573,6408,Ivančice,29,336,194,142
14574,6408,Ivančice,30,329,168,161
14575,6408,Ivančice,31,357,179,178
14576,6408,Ivančice,32,338,162,176
14577,6408,Ivančice,33,292,151,141
14578,6408,Ivančice,34,340,172,168
14579,6408,Ivančice,35,362,187,175
14580,6408,Ivančice,36,373,207,166
14581,6408,Ivančice,37,320,164,156
14582,6408,Ivančice,38,340,170,170
14583,6408,Ivančice,39,361,191,170
14584,6408,Ivančice,40,334,186,148
14585,6408,Ivančice,41,428,220,208
14586,6408,Ivančice,42,426,203,223
14587,6408,Ivančice,43,416,217,199
14588,6408,Ivančice,44,450,239,211
14589,6408,Ivančice,45,431,227,204
14590,6408,Ivančice,46,460,262,198
14591,6408,Ivančice,47,444,227,217
14592,6408,Ivančice,48,375,198,177
14593,6408,Ivančice,49,351,201,150
14594,6408,Ivančice,50,350,187,163
14595,6408,Ivančice,51,338,182,156
14596,6408,Ivančice,52,333,171,162
14597,6408,Ivančice,53,305,149,156
14598,6408,Ivančice,54,312,159,153
14599,6408,Ivančice,55,319,176,143
14600,6408,Ivančice,56,322,163,159
14601,6408,Ivančice,57,338,172,166
14602,6408,Ivančice,58,253,147,106
14603,6408,Ivančice,59,256,138,118
14604,6408,Ivančice,60,277,130,147
14605,6408,Ivančice,61,255,119,136
14606,6408,Ivančice,62,291,129,162
14607,6408,Ivančice,63,334,167,167
14608,6408,Ivančice,64,313,156,157
14609,6408,Ivančice,65,333,150,183
14610,6408,Ivančice,66,306,152,154
14611,6408,Ivančice,67,279,130,149
14612,6408,Ivančice,68,295,145,150
14613,6408,Ivančice,69,334,154,180
14614,6408,Ivančice,70,273,131,142
14615,6408,Ivančice,71,302,142,160
14616,6408,Ivančice,72,280,119,161
14617,6408,Ivančice,73,287,117,170
14618,6408,Ivančice,74,262,126,136
14619,6408,Ivančice,75,213,91,122
14620,6408,Ivančice,76,220,83,137
14621,6408,Ivančice,77,228,86,142
14622,6408,Ivančice,78,180,78,102
14623,6408,Ivančice,79,175,67,108
14624,6408,Ivančice,80,121,51,70
14625,6408,Ivančice,81,122,41,81
14626,6408,Ivančice,82,107,36,71
14627,6408,Ivančice,83,90,33,57
14628,6408,Ivančice,84,66,20,46
14629,6408,Ivančice,85,83,24,59
14630,6408,Ivančice,86,69,25,44
14631,6408,Ivančice,87,54,17,37
14632,6408,Ivančice,88,45,18,27
14633,6408,Ivančice,89,42,10,32
14634,6408,Ivančice,90,33,8,25
14635,6408,Ivančice,91,25,11,14
14636,6408,Ivančice,92,29,11,18
14637,6408,Ivančice,93,10,3,7
14638,6408,Ivančice,94,14,5,9
14639,6408,Ivančice,95,8,4,4
14640,6408,Ivančice,96,7,1,6
14641,6408,Ivančice,97,2,0,2
14642,6408,Ivančice,98,2,2,0
14643,6408,Ivančice,99,1,1,0
14644,6408,Ivančice,100,1,0,1
14645,6409,Kuřim,0,241,127,114
14646,6409,Kuřim,1,242,120,122
14647,6409,Kuřim,2,269,130,139
14648,6409,Kuřim,3,279,154,125
14649,6409,Kuřim,4,276,149,127
14650,6409,Kuřim,5,278,142,136
14651,6409,Kuřim,6,274,137,137
14652,6409,Kuřim,7,283,150,133
14653,6409,Kuřim,8,295,156,139
14654,6409,Kuřim,9,280,148,132
14655,6409,Kuřim,10,309,146,163
14656,6409,Kuřim,11,358,175,183
14657,6409,Kuřim,12,304,158,146
14658,6409,Kuřim,13,311,170,141
14659,6409,Kuřim,14,291,157,134
14660,6409,Kuřim,15,247,128,119
14661,6409,Kuřim,16,243,124,119
14662,6409,Kuřim,17,262,128,134
14663,6409,Kuřim,18,247,119,128
14664,6409,Kuřim,19,229,124,105
14665,6409,Kuřim,20,210,115,95
14666,6409,Kuřim,21,240,130,110
14667,6409,Kuřim,22,189,97,92
14668,6409,Kuřim,23,191,98,93
14669,6409,Kuřim,24,222,97,125
14670,6409,Kuřim,25,220,121,99
14671,6409,Kuřim,26,236,122,114
14672,6409,Kuřim,27,263,133,130
14673,6409,Kuřim,28,263,134,129
14674,6409,Kuřim,29,250,116,134
14675,6409,Kuřim,30,272,130,142
14676,6409,Kuřim,31,267,130,137
14677,6409,Kuřim,32,301,154,147
14678,6409,Kuřim,33,277,133,144
14679,6409,Kuřim,34,332,171,161
14680,6409,Kuřim,35,285,144,141
14681,6409,Kuřim,36,344,177,167
14682,6409,Kuřim,37,358,176,182
14683,6409,Kuřim,38,324,172,152
14684,6409,Kuřim,39,387,185,202
14685,6409,Kuřim,40,371,178,193
14686,6409,Kuřim,41,401,204,197
14687,6409,Kuřim,42,404,212,192
14688,6409,Kuřim,43,468,221,247
14689,6409,Kuřim,44,432,206,226
14690,6409,Kuřim,45,483,229,254
14691,6409,Kuřim,46,458,215,243
14692,6409,Kuřim,47,449,240,209
14693,6409,Kuřim,48,354,174,180
14694,6409,Kuřim,49,354,170,184
14695,6409,Kuřim,50,351,184,167
14696,6409,Kuřim,51,334,163,171
14697,6409,Kuřim,52,306,164,142
14698,6409,Kuřim,53,285,139,146
14699,6409,Kuřim,54,329,157,172
14700,6409,Kuřim,55,323,165,158
14701,6409,Kuřim,56,287,149,138
14702,6409,Kuřim,57,299,145,154
14703,6409,Kuřim,58,236,110,126
14704,6409,Kuřim,59,249,129,120
14705,6409,Kuřim,60,224,105,119
14706,6409,Kuřim,61,217,106,111
14707,6409,Kuřim,62,260,139,121
14708,6409,Kuřim,63,259,121,138
14709,6409,Kuřim,64,259,136,123
14710,6409,Kuřim,65,235,105,130
14711,6409,Kuřim,66,239,114,125
14712,6409,Kuřim,67,252,117,135
14713,6409,Kuřim,68,255,120,135
14714,6409,Kuřim,69,239,105,134
14715,6409,Kuřim,70,244,111,133
14716,6409,Kuřim,71,250,110,140
14717,6409,Kuřim,72,239,116,123
14718,6409,Kuřim,73,228,98,130
14719,6409,Kuřim,74,230,100,130
14720,6409,Kuřim,75,186,84,102
14721,6409,Kuřim,76,174,84,90
14722,6409,Kuřim,77,209,91,118
14723,6409,Kuřim,78,187,82,105
14724,6409,Kuřim,79,152,64,88
14725,6409,Kuřim,80,138,58,80
14726,6409,Kuřim,81,99,41,58
14727,6409,Kuřim,82,99,38,61
14728,6409,Kuřim,83,81,21,60
14729,6409,Kuřim,84,77,28,49
14730,6409,Kuřim,85,69,25,44
14731,6409,Kuřim,86,51,17,34
14732,6409,Kuřim,87,56,22,34
14733,6409,Kuřim,88,52,16,36
14734,6409,Kuřim,89,33,7,26
14735,6409,Kuřim,90,33,10,23
14736,6409,Kuřim,91,34,16,18
14737,6409,Kuřim,92,16,5,11
14738,6409,Kuřim,93,17,7,10
14739,6409,Kuřim,94,6,2,4
14740,6409,Kuřim,95,12,2,10
14741,6409,Kuřim,96,8,2,6
14742,6409,Kuřim,97,6,2,4
14743,6409,Kuřim,98,5,1,4
14744,6409,Kuřim,99,0,0,0
14745,6409,Kuřim,100,2,0,2
14746,6410,Kyjov,0,563,284,279
14747,6410,Kyjov,1,539,274,265
14748,6410,Kyjov,2,544,287,257
14749,6410,Kyjov,3,562,294,268
14750,6410,Kyjov,4,514,258,256
14751,6410,Kyjov,5,504,264,240
14752,6410,Kyjov,6,550,277,273
14753,6410,Kyjov,7,502,249,253
14754,6410,Kyjov,8,536,287,249
14755,6410,Kyjov,9,521,271,250
14756,6410,Kyjov,10,553,266,287
14757,6410,Kyjov,11,552,289,263
14758,6410,Kyjov,12,590,295,295
14759,6410,Kyjov,13,573,276,297
14760,6410,Kyjov,14,541,282,259
14761,6410,Kyjov,15,531,276,255
14762,6410,Kyjov,16,547,302,245
14763,6410,Kyjov,17,493,251,242
14764,6410,Kyjov,18,551,276,275
14765,6410,Kyjov,19,466,254,212
14766,6410,Kyjov,20,497,247,250
14767,6410,Kyjov,21,510,264,246
14768,6410,Kyjov,22,518,276,242
14769,6410,Kyjov,23,521,256,265
14770,6410,Kyjov,24,530,278,252
14771,6410,Kyjov,25,532,276,256
14772,6410,Kyjov,26,667,340,327
14773,6410,Kyjov,27,707,360,347
14774,6410,Kyjov,28,673,358,315
14775,6410,Kyjov,29,707,367,340
14776,6410,Kyjov,30,714,360,354
14777,6410,Kyjov,31,650,356,294
14778,6410,Kyjov,32,668,371,297
14779,6410,Kyjov,33,652,326,326
14780,6410,Kyjov,34,691,353,338
14781,6410,Kyjov,35,727,390,337
14782,6410,Kyjov,36,747,398,349
14783,6410,Kyjov,37,746,421,325
14784,6410,Kyjov,38,736,385,351
14785,6410,Kyjov,39,783,414,369
14786,6410,Kyjov,40,798,421,377
14787,6410,Kyjov,41,876,462,414
14788,6410,Kyjov,42,916,479,437
14789,6410,Kyjov,43,928,490,438
14790,6410,Kyjov,44,932,501,431
14791,6410,Kyjov,45,958,480,478
14792,6410,Kyjov,46,988,494,494
14793,6410,Kyjov,47,941,477,464
14794,6410,Kyjov,48,887,469,418
14795,6410,Kyjov,49,800,438,362
14796,6410,Kyjov,50,776,390,386
14797,6410,Kyjov,51,781,412,369
14798,6410,Kyjov,52,716,371,345
14799,6410,Kyjov,53,716,369,347
14800,6410,Kyjov,54,729,389,340
14801,6410,Kyjov,55,840,435,405
14802,6410,Kyjov,56,788,407,381
14803,6410,Kyjov,57,823,421,402
14804,6410,Kyjov,58,707,380,327
14805,6410,Kyjov,59,683,365,318
14806,6410,Kyjov,60,663,325,338
14807,6410,Kyjov,61,682,352,330
14808,6410,Kyjov,62,680,349,331
14809,6410,Kyjov,63,759,370,389
14810,6410,Kyjov,64,748,352,396
14811,6410,Kyjov,65,736,367,369
14812,6410,Kyjov,66,764,375,389
14813,6410,Kyjov,67,737,324,413
14814,6410,Kyjov,68,714,315,399
14815,6410,Kyjov,69,717,358,359
14816,6410,Kyjov,70,698,327,371
14817,6410,Kyjov,71,652,289,363
14818,6410,Kyjov,72,618,276,342
14819,6410,Kyjov,73,681,294,387
14820,6410,Kyjov,74,602,258,344
14821,6410,Kyjov,75,455,191,264
14822,6410,Kyjov,76,497,209,288
14823,6410,Kyjov,77,437,159,278
14824,6410,Kyjov,78,411,145,266
14825,6410,Kyjov,79,389,126,263
14826,6410,Kyjov,80,366,133,233
14827,6410,Kyjov,81,321,102,219
14828,6410,Kyjov,82,262,76,186
14829,6410,Kyjov,83,231,74,157
14830,6410,Kyjov,84,224,65,159
14831,6410,Kyjov,85,204,67,137
14832,6410,Kyjov,86,178,54,124
14833,6410,Kyjov,87,174,52,122
14834,6410,Kyjov,88,145,43,102
14835,6410,Kyjov,89,115,34,81
14836,6410,Kyjov,90,102,28,74
14837,6410,Kyjov,91,66,14,52
14838,6410,Kyjov,92,65,16,49
14839,6410,Kyjov,93,47,10,37
14840,6410,Kyjov,94,40,10,30
14841,6410,Kyjov,95,26,3,23
14842,6410,Kyjov,96,17,4,13
14843,6410,Kyjov,97,6,0,6
14844,6410,Kyjov,98,5,1,4
14845,6410,Kyjov,99,1,1,0
14846,6410,Kyjov,100,4,1,3
14847,6411,Mikulov,0,214,105,109
14848,6411,Mikulov,1,226,104,122
14849,6411,Mikulov,2,217,116,101
14850,6411,Mikulov,3,226,108,118
14851,6411,Mikulov,4,219,106,113
14852,6411,Mikulov,5,223,113,110
14853,6411,Mikulov,6,188,96,92
14854,6411,Mikulov,7,197,99,98
14855,6411,Mikulov,8,205,91,114
14856,6411,Mikulov,9,224,114,110
14857,6411,Mikulov,10,225,124,101
14858,6411,Mikulov,11,219,108,111
14859,6411,Mikulov,12,224,103,121
14860,6411,Mikulov,13,206,107,99
14861,6411,Mikulov,14,172,93,79
14862,6411,Mikulov,15,224,110,114
14863,6411,Mikulov,16,186,88,98
14864,6411,Mikulov,17,181,103,78
14865,6411,Mikulov,18,184,100,84
14866,6411,Mikulov,19,169,90,79
14867,6411,Mikulov,20,176,94,82
14868,6411,Mikulov,21,185,102,83
14869,6411,Mikulov,22,188,94,94
14870,6411,Mikulov,23,160,85,75
14871,6411,Mikulov,24,172,83,89
14872,6411,Mikulov,25,176,94,82
14873,6411,Mikulov,26,232,133,99
14874,6411,Mikulov,27,257,149,108
14875,6411,Mikulov,28,264,130,134
14876,6411,Mikulov,29,254,129,125
14877,6411,Mikulov,30,271,146,125
14878,6411,Mikulov,31,288,141,147
14879,6411,Mikulov,32,293,145,148
14880,6411,Mikulov,33,263,133,130
14881,6411,Mikulov,34,258,135,123
14882,6411,Mikulov,35,306,159,147
14883,6411,Mikulov,36,303,155,148
14884,6411,Mikulov,37,289,140,149
14885,6411,Mikulov,38,273,142,131
14886,6411,Mikulov,39,306,163,143
14887,6411,Mikulov,40,301,159,142
14888,6411,Mikulov,41,361,190,171
14889,6411,Mikulov,42,345,187,158
14890,6411,Mikulov,43,351,180,171
14891,6411,Mikulov,44,349,178,171
14892,6411,Mikulov,45,363,173,190
14893,6411,Mikulov,46,342,181,161
14894,6411,Mikulov,47,357,186,171
14895,6411,Mikulov,48,309,157,152
14896,6411,Mikulov,49,295,167,128
14897,6411,Mikulov,50,256,119,137
14898,6411,Mikulov,51,273,149,124
14899,6411,Mikulov,52,292,155,137
14900,6411,Mikulov,53,244,127,117
14901,6411,Mikulov,54,251,129,122
14902,6411,Mikulov,55,261,137,124
14903,6411,Mikulov,56,282,147,135
14904,6411,Mikulov,57,260,118,142
14905,6411,Mikulov,58,233,124,109
14906,6411,Mikulov,59,259,122,137
14907,6411,Mikulov,60,217,108,109
14908,6411,Mikulov,61,245,115,130
14909,6411,Mikulov,62,236,113,123
14910,6411,Mikulov,63,301,138,163
14911,6411,Mikulov,64,305,153,152
14912,6411,Mikulov,65,309,134,175
14913,6411,Mikulov,66,289,137,152
14914,6411,Mikulov,67,254,115,139
14915,6411,Mikulov,68,284,135,149
14916,6411,Mikulov,69,275,135,140
14917,6411,Mikulov,70,258,112,146
14918,6411,Mikulov,71,226,103,123
14919,6411,Mikulov,72,288,138,150
14920,6411,Mikulov,73,267,125,142
14921,6411,Mikulov,74,233,100,133
14922,6411,Mikulov,75,164,66,98
14923,6411,Mikulov,76,160,63,97
14924,6411,Mikulov,77,138,58,80
14925,6411,Mikulov,78,138,46,92
14926,6411,Mikulov,79,116,52,64
14927,6411,Mikulov,80,100,42,58
14928,6411,Mikulov,81,100,39,61
14929,6411,Mikulov,82,69,22,47
14930,6411,Mikulov,83,51,16,35
14931,6411,Mikulov,84,74,19,55
14932,6411,Mikulov,85,62,18,44
14933,6411,Mikulov,86,51,14,37
14934,6411,Mikulov,87,38,8,30
14935,6411,Mikulov,88,36,10,26
14936,6411,Mikulov,89,18,4,14
14937,6411,Mikulov,90,20,6,14
14938,6411,Mikulov,91,16,5,11
14939,6411,Mikulov,92,14,1,13
14940,6411,Mikulov,93,7,0,7
14941,6411,Mikulov,94,8,2,6
14942,6411,Mikulov,95,5,1,4
14943,6411,Mikulov,96,5,0,5
14944,6411,Mikulov,97,2,0,2
14945,6411,Mikulov,98,1,0,1
14946,6411,Mikulov,99,0,0,0
14947,6411,Mikulov,100,2,0,2
14948,6412,Moravský Krumlov,0,268,116,152
14949,6412,Moravský Krumlov,1,252,120,132
14950,6412,Moravský Krumlov,2,228,111,117
14951,6412,Moravský Krumlov,3,251,125,126
14952,6412,Moravský Krumlov,4,260,129,131
14953,6412,Moravský Krumlov,5,206,99,107
14954,6412,Moravský Krumlov,6,198,108,90
14955,6412,Moravský Krumlov,7,204,96,108
14956,6412,Moravský Krumlov,8,193,97,96
14957,6412,Moravský Krumlov,9,197,113,84
14958,6412,Moravský Krumlov,10,229,118,111
14959,6412,Moravský Krumlov,11,238,117,121
14960,6412,Moravský Krumlov,12,213,109,104
14961,6412,Moravský Krumlov,13,273,146,127
14962,6412,Moravský Krumlov,14,177,92,85
14963,6412,Moravský Krumlov,15,205,98,107
14964,6412,Moravský Krumlov,16,188,92,96
14965,6412,Moravský Krumlov,17,222,113,109
14966,6412,Moravský Krumlov,18,188,104,84
14967,6412,Moravský Krumlov,19,194,101,93
14968,6412,Moravský Krumlov,20,192,94,98
14969,6412,Moravský Krumlov,21,216,125,91
14970,6412,Moravský Krumlov,22,220,112,108
14971,6412,Moravský Krumlov,23,244,127,117
14972,6412,Moravský Krumlov,24,225,134,91
14973,6412,Moravský Krumlov,25,228,119,109
14974,6412,Moravský Krumlov,26,279,141,138
14975,6412,Moravský Krumlov,27,310,148,162
14976,6412,Moravský Krumlov,28,330,161,169
14977,6412,Moravský Krumlov,29,324,170,154
14978,6412,Moravský Krumlov,30,314,165,149
14979,6412,Moravský Krumlov,31,301,148,153
14980,6412,Moravský Krumlov,32,313,170,143
14981,6412,Moravský Krumlov,33,267,149,118
14982,6412,Moravský Krumlov,34,304,157,147
14983,6412,Moravský Krumlov,35,319,164,155
14984,6412,Moravský Krumlov,36,290,165,125
14985,6412,Moravský Krumlov,37,310,161,149
14986,6412,Moravský Krumlov,38,316,171,145
14987,6412,Moravský Krumlov,39,285,150,135
14988,6412,Moravský Krumlov,40,317,157,160
14989,6412,Moravský Krumlov,41,297,157,140
14990,6412,Moravský Krumlov,42,327,176,151
14991,6412,Moravský Krumlov,43,356,201,155
14992,6412,Moravský Krumlov,44,339,163,176
14993,6412,Moravský Krumlov,45,384,180,204
14994,6412,Moravský Krumlov,46,385,179,206
14995,6412,Moravský Krumlov,47,350,178,172
14996,6412,Moravský Krumlov,48,366,208,158
14997,6412,Moravský Krumlov,49,318,165,153
14998,6412,Moravský Krumlov,50,345,175,170
14999,6412,Moravský Krumlov,51,303,143,160
15000,6412,Moravský Krumlov,52,302,155,147
15001,6412,Moravský Krumlov,53,310,163,147
15002,6412,Moravský Krumlov,54,333,168,165
15003,6412,Moravský Krumlov,55,304,157,147
15004,6412,Moravský Krumlov,56,308,155,153
15005,6412,Moravský Krumlov,57,285,143,142
15006,6412,Moravský Krumlov,58,273,138,135
15007,6412,Moravský Krumlov,59,277,145,132
15008,6412,Moravský Krumlov,60,254,131,123
15009,6412,Moravský Krumlov,61,262,126,136
15010,6412,Moravský Krumlov,62,264,143,121
15011,6412,Moravský Krumlov,63,315,167,148
15012,6412,Moravský Krumlov,64,323,152,171
15013,6412,Moravský Krumlov,65,285,139,146
15014,6412,Moravský Krumlov,66,274,128,146
15015,6412,Moravský Krumlov,67,313,150,163
15016,6412,Moravský Krumlov,68,322,147,175
15017,6412,Moravský Krumlov,69,273,147,126
15018,6412,Moravský Krumlov,70,275,131,144
15019,6412,Moravský Krumlov,71,265,115,150
15020,6412,Moravský Krumlov,72,287,125,162
15021,6412,Moravský Krumlov,73,280,135,145
15022,6412,Moravský Krumlov,74,284,139,145
15023,6412,Moravský Krumlov,75,201,76,125
15024,6412,Moravský Krumlov,76,210,90,120
15025,6412,Moravský Krumlov,77,146,64,82
15026,6412,Moravský Krumlov,78,150,61,89
15027,6412,Moravský Krumlov,79,151,52,99
15028,6412,Moravský Krumlov,80,148,52,96
15029,6412,Moravský Krumlov,81,99,37,62
15030,6412,Moravský Krumlov,82,118,50,68
15031,6412,Moravský Krumlov,83,91,38,53
15032,6412,Moravský Krumlov,84,83,25,58
15033,6412,Moravský Krumlov,85,66,20,46
15034,6412,Moravský Krumlov,86,66,26,40
15035,6412,Moravský Krumlov,87,45,8,37
15036,6412,Moravský Krumlov,88,42,15,27
15037,6412,Moravský Krumlov,89,37,13,24
15038,6412,Moravský Krumlov,90,40,13,27
15039,6412,Moravský Krumlov,91,23,8,15
15040,6412,Moravský Krumlov,92,22,6,16
15041,6412,Moravský Krumlov,93,13,3,10
15042,6412,Moravský Krumlov,94,10,2,8
15043,6412,Moravský Krumlov,95,6,0,6
15044,6412,Moravský Krumlov,96,4,2,2
15045,6412,Moravský Krumlov,97,3,2,1
15046,6412,Moravský Krumlov,98,3,0,3
15047,6412,Moravský Krumlov,99,1,0,1
15048,6412,Moravský Krumlov,100,2,0,2
15049,6413,Pohořelice,0,186,89,97
15050,6413,Pohořelice,1,185,99,86
15051,6413,Pohořelice,2,204,101,103
15052,6413,Pohořelice,3,192,91,101
15053,6413,Pohořelice,4,217,113,104
15054,6413,Pohořelice,5,191,95,96
15055,6413,Pohořelice,6,192,105,87
15056,6413,Pohořelice,7,178,92,86
15057,6413,Pohořelice,8,149,70,79
15058,6413,Pohořelice,9,132,64,68
15059,6413,Pohořelice,10,161,79,82
15060,6413,Pohořelice,11,159,75,84
15061,6413,Pohořelice,12,201,108,93
15062,6413,Pohořelice,13,125,62,63
15063,6413,Pohořelice,14,137,72,65
15064,6413,Pohořelice,15,143,73,70
15065,6413,Pohořelice,16,142,68,74
15066,6413,Pohořelice,17,114,59,55
15067,6413,Pohořelice,18,147,76,71
15068,6413,Pohořelice,19,115,54,61
15069,6413,Pohořelice,20,115,56,59
15070,6413,Pohořelice,21,113,67,46
15071,6413,Pohořelice,22,137,74,63
15072,6413,Pohořelice,23,125,67,58
15073,6413,Pohořelice,24,124,67,57
15074,6413,Pohořelice,25,143,87,56
15075,6413,Pohořelice,26,151,79,72
15076,6413,Pohořelice,27,187,96,91
15077,6413,Pohořelice,28,219,113,106
15078,6413,Pohořelice,29,218,109,109
15079,6413,Pohořelice,30,227,110,117
15080,6413,Pohořelice,31,231,118,113
15081,6413,Pohořelice,32,247,130,117
15082,6413,Pohořelice,33,257,127,130
15083,6413,Pohořelice,34,183,93,90
15084,6413,Pohořelice,35,249,131,118
15085,6413,Pohořelice,36,245,133,112
15086,6413,Pohořelice,37,229,124,105
15087,6413,Pohořelice,38,222,113,109
15088,6413,Pohořelice,39,216,98,118
15089,6413,Pohořelice,40,220,128,92
15090,6413,Pohořelice,41,266,133,133
15091,6413,Pohořelice,42,261,137,124
15092,6413,Pohořelice,43,301,153,148
15093,6413,Pohořelice,44,248,121,127
15094,6413,Pohořelice,45,254,136,118
15095,6413,Pohořelice,46,280,161,119
15096,6413,Pohořelice,47,234,123,111
15097,6413,Pohořelice,48,218,114,104
15098,6413,Pohořelice,49,183,104,79
15099,6413,Pohořelice,50,183,81,102
15100,6413,Pohořelice,51,201,117,84
15101,6413,Pohořelice,52,174,91,83
15102,6413,Pohořelice,53,190,90,100
15103,6413,Pohořelice,54,164,83,81
15104,6413,Pohořelice,55,173,86,87
15105,6413,Pohořelice,56,198,103,95
15106,6413,Pohořelice,57,192,97,95
15107,6413,Pohořelice,58,177,94,83
15108,6413,Pohořelice,59,177,88,89
15109,6413,Pohořelice,60,192,103,89
15110,6413,Pohořelice,61,156,90,66
15111,6413,Pohořelice,62,164,86,78
15112,6413,Pohořelice,63,181,91,90
15113,6413,Pohořelice,64,153,69,84
15114,6413,Pohořelice,65,180,94,86
15115,6413,Pohořelice,66,182,81,101
15116,6413,Pohořelice,67,185,93,92
15117,6413,Pohořelice,68,166,90,76
15118,6413,Pohořelice,69,174,80,94
15119,6413,Pohořelice,70,177,70,107
15120,6413,Pohořelice,71,153,81,72
15121,6413,Pohořelice,72,154,73,81
15122,6413,Pohořelice,73,140,59,81
15123,6413,Pohořelice,74,122,50,72
15124,6413,Pohořelice,75,90,37,53
15125,6413,Pohořelice,76,95,36,59
15126,6413,Pohořelice,77,121,53,68
15127,6413,Pohořelice,78,91,36,55
15128,6413,Pohořelice,79,99,31,68
15129,6413,Pohořelice,80,92,32,60
15130,6413,Pohořelice,81,61,20,41
15131,6413,Pohořelice,82,48,12,36
15132,6413,Pohořelice,83,43,13,30
15133,6413,Pohořelice,84,48,12,36
15134,6413,Pohořelice,85,34,13,21
15135,6413,Pohořelice,86,41,12,29
15136,6413,Pohořelice,87,39,13,26
15137,6413,Pohořelice,88,27,5,22
15138,6413,Pohořelice,89,13,2,11
15139,6413,Pohořelice,90,21,3,18
15140,6413,Pohořelice,91,12,3,9
15141,6413,Pohořelice,92,11,2,9
15142,6413,Pohořelice,93,6,4,2
15143,6413,Pohořelice,94,3,1,2
15144,6413,Pohořelice,95,6,2,4
15145,6413,Pohořelice,96,3,1,2
15146,6413,Pohořelice,97,5,1,4
15147,6413,Pohořelice,98,4,2,2
15148,6413,Pohořelice,99,1,0,1
15149,6413,Pohořelice,100,0,0,0
15150,6414,Rosice,0,317,169,148
15151,6414,Rosice,1,328,163,165
15152,6414,Rosice,2,353,186,167
15153,6414,Rosice,3,316,157,159
15154,6414,Rosice,4,322,168,154
15155,6414,Rosice,5,328,153,175
15156,6414,Rosice,6,331,185,146
15157,6414,Rosice,7,287,136,151
15158,6414,Rosice,8,316,163,153
15159,6414,Rosice,9,294,146,148
15160,6414,Rosice,10,308,180,128
15161,6414,Rosice,11,325,165,160
15162,6414,Rosice,12,348,178,170
15163,6414,Rosice,13,280,154,126
15164,6414,Rosice,14,278,149,129
15165,6414,Rosice,15,266,128,138
15166,6414,Rosice,16,239,127,112
15167,6414,Rosice,17,217,112,105
15168,6414,Rosice,18,223,117,106
15169,6414,Rosice,19,213,93,120
15170,6414,Rosice,20,208,109,99
15171,6414,Rosice,21,222,111,111
15172,6414,Rosice,22,225,125,100
15173,6414,Rosice,23,214,113,101
15174,6414,Rosice,24,228,113,115
15175,6414,Rosice,25,222,113,109
15176,6414,Rosice,26,297,160,137
15177,6414,Rosice,27,316,168,148
15178,6414,Rosice,28,313,166,147
15179,6414,Rosice,29,396,203,193
15180,6414,Rosice,30,344,166,178
15181,6414,Rosice,31,340,168,172
15182,6414,Rosice,32,347,170,177
15183,6414,Rosice,33,380,200,180
15184,6414,Rosice,34,388,198,190
15185,6414,Rosice,35,418,216,202
15186,6414,Rosice,36,366,202,164
15187,6414,Rosice,37,377,200,177
15188,6414,Rosice,38,389,186,203
15189,6414,Rosice,39,387,200,187
15190,6414,Rosice,40,389,199,190
15191,6414,Rosice,41,434,238,196
15192,6414,Rosice,42,436,220,216
15193,6414,Rosice,43,480,229,251
15194,6414,Rosice,44,454,222,232
15195,6414,Rosice,45,450,222,228
15196,6414,Rosice,46,479,258,221
15197,6414,Rosice,47,420,207,213
15198,6414,Rosice,48,372,189,183
15199,6414,Rosice,49,371,187,184
15200,6414,Rosice,50,371,187,184
15201,6414,Rosice,51,332,174,158
15202,6414,Rosice,52,320,172,148
15203,6414,Rosice,53,320,173,147
15204,6414,Rosice,54,344,170,174
15205,6414,Rosice,55,330,165,165
15206,6414,Rosice,56,356,188,168
15207,6414,Rosice,57,328,149,179
15208,6414,Rosice,58,288,148,140
15209,6414,Rosice,59,291,137,154
15210,6414,Rosice,60,310,154,156
15211,6414,Rosice,61,303,157,146
15212,6414,Rosice,62,298,150,148
15213,6414,Rosice,63,303,144,159
15214,6414,Rosice,64,306,159,147
15215,6414,Rosice,65,280,138,142
15216,6414,Rosice,66,288,138,150
15217,6414,Rosice,67,316,156,160
15218,6414,Rosice,68,297,134,163
15219,6414,Rosice,69,287,144,143
15220,6414,Rosice,70,267,114,153
15221,6414,Rosice,71,271,124,147
15222,6414,Rosice,72,286,123,163
15223,6414,Rosice,73,304,140,164
15224,6414,Rosice,74,300,135,165
15225,6414,Rosice,75,229,99,130
15226,6414,Rosice,76,210,82,128
15227,6414,Rosice,77,220,91,129
15228,6414,Rosice,78,206,86,120
15229,6414,Rosice,79,199,75,124
15230,6414,Rosice,80,179,64,115
15231,6414,Rosice,81,128,44,84
15232,6414,Rosice,82,104,40,64
15233,6414,Rosice,83,107,38,69
15234,6414,Rosice,84,90,37,53
15235,6414,Rosice,85,92,33,59
15236,6414,Rosice,86,71,21,50
15237,6414,Rosice,87,60,22,38
15238,6414,Rosice,88,69,22,47
15239,6414,Rosice,89,50,17,33
15240,6414,Rosice,90,55,8,47
15241,6414,Rosice,91,37,7,30
15242,6414,Rosice,92,31,5,26
15243,6414,Rosice,93,19,3,16
15244,6414,Rosice,94,11,3,8
15245,6414,Rosice,95,12,3,9
15246,6414,Rosice,96,3,0,3
15247,6414,Rosice,97,7,2,5
15248,6414,Rosice,98,3,1,2
15249,6414,Rosice,99,0,0,0
15250,6414,Rosice,100,1,0,1
15251,6415,Slavkov u Brna,0,275,148,127
15252,6415,Slavkov u Brna,1,324,181,143
15253,6415,Slavkov u Brna,2,319,158,161
15254,6415,Slavkov u Brna,3,349,172,177
15255,6415,Slavkov u Brna,4,321,179,142
15256,6415,Slavkov u Brna,5,340,179,161
15257,6415,Slavkov u Brna,6,341,166,175
15258,6415,Slavkov u Brna,7,305,148,157
15259,6415,Slavkov u Brna,8,287,161,126
15260,6415,Slavkov u Brna,9,316,157,159
15261,6415,Slavkov u Brna,10,287,152,135
15262,6415,Slavkov u Brna,11,301,130,171
15263,6415,Slavkov u Brna,12,302,141,161
15264,6415,Slavkov u Brna,13,272,147,125
15265,6415,Slavkov u Brna,14,256,130,126
15266,6415,Slavkov u Brna,15,211,110,101
15267,6415,Slavkov u Brna,16,259,125,134
15268,6415,Slavkov u Brna,17,211,102,109
15269,6415,Slavkov u Brna,18,231,133,98
15270,6415,Slavkov u Brna,19,185,92,93
15271,6415,Slavkov u Brna,20,204,101,103
15272,6415,Slavkov u Brna,21,190,87,103
15273,6415,Slavkov u Brna,22,170,87,83
15274,6415,Slavkov u Brna,23,198,97,101
15275,6415,Slavkov u Brna,24,188,95,93
15276,6415,Slavkov u Brna,25,218,108,110
15277,6415,Slavkov u Brna,26,230,125,105
15278,6415,Slavkov u Brna,27,268,139,129
15279,6415,Slavkov u Brna,28,317,148,169
15280,6415,Slavkov u Brna,29,327,165,162
15281,6415,Slavkov u Brna,30,344,168,176
15282,6415,Slavkov u Brna,31,346,174,172
15283,6415,Slavkov u Brna,32,359,188,171
15284,6415,Slavkov u Brna,33,370,191,179
15285,6415,Slavkov u Brna,34,394,186,208
15286,6415,Slavkov u Brna,35,405,212,193
15287,6415,Slavkov u Brna,36,408,214,194
15288,6415,Slavkov u Brna,37,340,155,185
15289,6415,Slavkov u Brna,38,422,229,193
15290,6415,Slavkov u Brna,39,367,179,188
15291,6415,Slavkov u Brna,40,430,218,212
15292,6415,Slavkov u Brna,41,455,220,235
15293,6415,Slavkov u Brna,42,449,214,235
15294,6415,Slavkov u Brna,43,455,260,195
15295,6415,Slavkov u Brna,44,455,265,190
15296,6415,Slavkov u Brna,45,413,222,191
15297,6415,Slavkov u Brna,46,443,233,210
15298,6415,Slavkov u Brna,47,399,189,210
15299,6415,Slavkov u Brna,48,311,146,165
15300,6415,Slavkov u Brna,49,339,173,166
15301,6415,Slavkov u Brna,50,307,163,144
15302,6415,Slavkov u Brna,51,296,154,142
15303,6415,Slavkov u Brna,52,254,147,107
15304,6415,Slavkov u Brna,53,286,148,138
15305,6415,Slavkov u Brna,54,263,135,128
15306,6415,Slavkov u Brna,55,297,157,140
15307,6415,Slavkov u Brna,56,298,152,146
15308,6415,Slavkov u Brna,57,288,145,143
15309,6415,Slavkov u Brna,58,252,120,132
15310,6415,Slavkov u Brna,59,240,114,126
15311,6415,Slavkov u Brna,60,244,120,124
15312,6415,Slavkov u Brna,61,247,126,121
15313,6415,Slavkov u Brna,62,241,124,117
15314,6415,Slavkov u Brna,63,304,141,163
15315,6415,Slavkov u Brna,64,305,145,160
15316,6415,Slavkov u Brna,65,251,123,128
15317,6415,Slavkov u Brna,66,271,133,138
15318,6415,Slavkov u Brna,67,269,133,136
15319,6415,Slavkov u Brna,68,289,150,139
15320,6415,Slavkov u Brna,69,255,120,135
15321,6415,Slavkov u Brna,70,282,124,158
15322,6415,Slavkov u Brna,71,228,116,112
15323,6415,Slavkov u Brna,72,217,95,122
15324,6415,Slavkov u Brna,73,211,94,117
15325,6415,Slavkov u Brna,74,223,104,119
15326,6415,Slavkov u Brna,75,177,75,102
15327,6415,Slavkov u Brna,76,202,79,123
15328,6415,Slavkov u Brna,77,150,74,76
15329,6415,Slavkov u Brna,78,134,55,79
15330,6415,Slavkov u Brna,79,150,52,98
15331,6415,Slavkov u Brna,80,135,60,75
15332,6415,Slavkov u Brna,81,86,33,53
15333,6415,Slavkov u Brna,82,101,33,68
15334,6415,Slavkov u Brna,83,98,31,67
15335,6415,Slavkov u Brna,84,59,13,46
15336,6415,Slavkov u Brna,85,77,25,52
15337,6415,Slavkov u Brna,86,70,23,47
15338,6415,Slavkov u Brna,87,60,21,39
15339,6415,Slavkov u Brna,88,64,19,45
15340,6415,Slavkov u Brna,89,47,11,36
15341,6415,Slavkov u Brna,90,37,9,28
15342,6415,Slavkov u Brna,91,30,8,22
15343,6415,Slavkov u Brna,92,23,4,19
15344,6415,Slavkov u Brna,93,20,5,15
15345,6415,Slavkov u Brna,94,9,2,7
15346,6415,Slavkov u Brna,95,8,2,6
15347,6415,Slavkov u Brna,96,6,1,5
15348,6415,Slavkov u Brna,97,0,0,0
15349,6415,Slavkov u Brna,98,5,2,3
15350,6415,Slavkov u Brna,99,0,0,0
15351,6415,Slavkov u Brna,100,2,1,1
15352,6416,Šlapanice,0,791,429,362
15353,6416,Šlapanice,1,908,475,433
15354,6416,Šlapanice,2,952,461,491
15355,6416,Šlapanice,3,934,480,454
15356,6416,Šlapanice,4,934,470,464
15357,6416,Šlapanice,5,970,489,481
15358,6416,Šlapanice,6,923,490,433
15359,6416,Šlapanice,7,936,467,469
15360,6416,Šlapanice,8,895,428,467
15361,6416,Šlapanice,9,890,453,437
15362,6416,Šlapanice,10,969,522,447
15363,6416,Šlapanice,11,902,459,443
15364,6416,Šlapanice,12,995,540,455
15365,6416,Šlapanice,13,876,456,420
15366,6416,Šlapanice,14,790,422,368
15367,6416,Šlapanice,15,798,424,374
15368,6416,Šlapanice,16,750,380,370
15369,6416,Šlapanice,17,664,342,322
15370,6416,Šlapanice,18,620,306,314
15371,6416,Šlapanice,19,654,342,312
15372,6416,Šlapanice,20,574,298,276
15373,6416,Šlapanice,21,614,345,269
15374,6416,Šlapanice,22,608,310,298
15375,6416,Šlapanice,23,634,320,314
15376,6416,Šlapanice,24,600,305,295
15377,6416,Šlapanice,25,643,311,332
15378,6416,Šlapanice,26,684,350,334
15379,6416,Šlapanice,27,754,409,345
15380,6416,Šlapanice,28,782,379,403
15381,6416,Šlapanice,29,841,414,427
15382,6416,Šlapanice,30,909,447,462
15383,6416,Šlapanice,31,857,431,426
15384,6416,Šlapanice,32,899,429,470
15385,6416,Šlapanice,33,892,442,450
15386,6416,Šlapanice,34,956,469,487
15387,6416,Šlapanice,35,1032,516,516
15388,6416,Šlapanice,36,1073,531,542
15389,6416,Šlapanice,37,1018,493,525
15390,6416,Šlapanice,38,1052,533,519
15391,6416,Šlapanice,39,1144,576,568
15392,6416,Šlapanice,40,1150,573,577
15393,6416,Šlapanice,41,1251,623,628
15394,6416,Šlapanice,42,1251,624,627
15395,6416,Šlapanice,43,1343,663,680
15396,6416,Šlapanice,44,1303,654,649
15397,6416,Šlapanice,45,1430,718,712
15398,6416,Šlapanice,46,1365,679,686
15399,6416,Šlapanice,47,1230,633,597
15400,6416,Šlapanice,48,1087,575,512
15401,6416,Šlapanice,49,1044,537,507
15402,6416,Šlapanice,50,978,506,472
15403,6416,Šlapanice,51,904,493,411
15404,6416,Šlapanice,52,923,480,443
15405,6416,Šlapanice,53,854,470,384
15406,6416,Šlapanice,54,858,436,422
15407,6416,Šlapanice,55,830,430,400
15408,6416,Šlapanice,56,919,455,464
15409,6416,Šlapanice,57,863,438,425
15410,6416,Šlapanice,58,710,365,345
15411,6416,Šlapanice,59,751,372,379
15412,6416,Šlapanice,60,690,366,324
15413,6416,Šlapanice,61,670,361,309
15414,6416,Šlapanice,62,694,349,345
15415,6416,Šlapanice,63,738,346,392
15416,6416,Šlapanice,64,699,352,347
15417,6416,Šlapanice,65,776,382,394
15418,6416,Šlapanice,66,739,352,387
15419,6416,Šlapanice,67,720,361,359
15420,6416,Šlapanice,68,771,371,400
15421,6416,Šlapanice,69,792,355,437
15422,6416,Šlapanice,70,734,337,397
15423,6416,Šlapanice,71,702,323,379
15424,6416,Šlapanice,72,766,341,425
15425,6416,Šlapanice,73,752,333,419
15426,6416,Šlapanice,74,721,298,423
15427,6416,Šlapanice,75,579,263,316
15428,6416,Šlapanice,76,565,248,317
15429,6416,Šlapanice,77,564,240,324
15430,6416,Šlapanice,78,474,212,262
15431,6416,Šlapanice,79,420,175,245
15432,6416,Šlapanice,80,358,148,210
15433,6416,Šlapanice,81,295,114,181
15434,6416,Šlapanice,82,315,136,179
15435,6416,Šlapanice,83,265,98,167
15436,6416,Šlapanice,84,223,73,150
15437,6416,Šlapanice,85,238,82,156
15438,6416,Šlapanice,86,195,75,120
15439,6416,Šlapanice,87,178,60,118
15440,6416,Šlapanice,88,139,40,99
15441,6416,Šlapanice,89,126,29,97
15442,6416,Šlapanice,90,121,34,87
15443,6416,Šlapanice,91,82,16,66
15444,6416,Šlapanice,92,79,31,48
15445,6416,Šlapanice,93,48,12,36
15446,6416,Šlapanice,94,32,8,24
15447,6416,Šlapanice,95,24,6,18
15448,6416,Šlapanice,96,22,5,17
15449,6416,Šlapanice,97,10,1,9
15450,6416,Šlapanice,98,9,0,9
15451,6416,Šlapanice,99,11,2,9
15452,6416,Šlapanice,100,5,0,5
15453,6417,Tišnov,0,352,179,173
15454,6417,Tišnov,1,354,173,181
15455,6417,Tišnov,2,431,208,223
15456,6417,Tišnov,3,434,215,219
15457,6417,Tišnov,4,422,215,207
15458,6417,Tišnov,5,421,219,202
15459,6417,Tišnov,6,385,193,192
15460,6417,Tišnov,7,406,196,210
15461,6417,Tišnov,8,373,179,194
15462,6417,Tišnov,9,391,201,190
15463,6417,Tišnov,10,373,186,187
15464,6417,Tišnov,11,366,185,181
15465,6417,Tišnov,12,416,202,214
15466,6417,Tišnov,13,372,197,175
15467,6417,Tišnov,14,348,174,174
15468,6417,Tišnov,15,313,171,142
15469,6417,Tišnov,16,286,147,139
15470,6417,Tišnov,17,285,150,135
15471,6417,Tišnov,18,311,156,155
15472,6417,Tišnov,19,256,143,113
15473,6417,Tišnov,20,256,120,136
15474,6417,Tišnov,21,256,140,116
15475,6417,Tišnov,22,261,136,125
15476,6417,Tišnov,23,251,119,132
15477,6417,Tišnov,24,291,151,140
15478,6417,Tišnov,25,329,163,166
15479,6417,Tišnov,26,339,182,157
15480,6417,Tišnov,27,392,193,199
15481,6417,Tišnov,28,384,197,187
15482,6417,Tišnov,29,380,183,197
15483,6417,Tišnov,30,340,155,185
15484,6417,Tišnov,31,408,200,208
15485,6417,Tišnov,32,419,204,215
15486,6417,Tišnov,33,388,190,198
15487,6417,Tišnov,34,434,214,220
15488,6417,Tišnov,35,422,213,209
15489,6417,Tišnov,36,468,241,227
15490,6417,Tišnov,37,463,238,225
15491,6417,Tišnov,38,491,263,228
15492,6417,Tišnov,39,463,227,236
15493,6417,Tišnov,40,500,242,258
15494,6417,Tišnov,41,541,278,263
15495,6417,Tišnov,42,529,278,251
15496,6417,Tišnov,43,608,301,307
15497,6417,Tišnov,44,615,311,304
15498,6417,Tišnov,45,573,286,287
15499,6417,Tišnov,46,558,278,280
15500,6417,Tišnov,47,553,298,255
15501,6417,Tišnov,48,495,257,238
15502,6417,Tišnov,49,432,226,206
15503,6417,Tišnov,50,441,239,202
15504,6417,Tišnov,51,418,231,187
15505,6417,Tišnov,52,381,206,175
15506,6417,Tišnov,53,394,220,174
15507,6417,Tišnov,54,382,184,198
15508,6417,Tišnov,55,369,201,168
15509,6417,Tišnov,56,380,210,170
15510,6417,Tišnov,57,376,181,195
15511,6417,Tišnov,58,334,176,158
15512,6417,Tišnov,59,338,168,170
15513,6417,Tišnov,60,307,169,138
15514,6417,Tišnov,61,312,167,145
15515,6417,Tišnov,62,342,169,173
15516,6417,Tišnov,63,380,185,195
15517,6417,Tišnov,64,334,179,155
15518,6417,Tišnov,65,371,171,200
15519,6417,Tišnov,66,342,171,171
15520,6417,Tišnov,67,384,170,214
15521,6417,Tišnov,68,358,170,188
15522,6417,Tišnov,69,375,164,211
15523,6417,Tišnov,70,348,149,199
15524,6417,Tišnov,71,321,142,179
15525,6417,Tišnov,72,327,152,175
15526,6417,Tišnov,73,383,170,213
15527,6417,Tišnov,74,350,154,196
15528,6417,Tišnov,75,291,126,165
15529,6417,Tišnov,76,287,123,164
15530,6417,Tišnov,77,293,125,168
15531,6417,Tišnov,78,217,93,124
15532,6417,Tišnov,79,223,92,131
15533,6417,Tišnov,80,211,83,128
15534,6417,Tišnov,81,158,60,98
15535,6417,Tišnov,82,145,58,87
15536,6417,Tišnov,83,131,40,91
15537,6417,Tišnov,84,136,46,90
15538,6417,Tišnov,85,108,34,74
15539,6417,Tišnov,86,99,31,68
15540,6417,Tišnov,87,70,27,43
15541,6417,Tišnov,88,63,20,43
15542,6417,Tišnov,89,75,18,57
15543,6417,Tišnov,90,55,14,41
15544,6417,Tišnov,91,35,8,27
15545,6417,Tišnov,92,28,12,16
15546,6417,Tišnov,93,23,5,18
15547,6417,Tišnov,94,18,7,11
15548,6417,Tišnov,95,10,3,7
15549,6417,Tišnov,96,15,3,12
15550,6417,Tišnov,97,6,2,4
15551,6417,Tišnov,98,6,0,6
15552,6417,Tišnov,99,3,0,3
15553,6417,Tišnov,100,8,3,5
15554,6418,Veselí nad Moravou,0,321,171,150
15555,6418,Veselí nad Moravou,1,343,190,153
15556,6418,Veselí nad Moravou,2,339,155,184
15557,6418,Veselí nad Moravou,3,328,174,154
15558,6418,Veselí nad Moravou,4,330,169,161
15559,6418,Veselí nad Moravou,5,353,180,173
15560,6418,Veselí nad Moravou,6,328,175,153
15561,6418,Veselí nad Moravou,7,321,171,150
15562,6418,Veselí nad Moravou,8,308,176,132
15563,6418,Veselí nad Moravou,9,307,153,154
15564,6418,Veselí nad Moravou,10,345,183,162
15565,6418,Veselí nad Moravou,11,343,165,178
15566,6418,Veselí nad Moravou,12,381,201,180
15567,6418,Veselí nad Moravou,13,399,211,188
15568,6418,Veselí nad Moravou,14,365,177,188
15569,6418,Veselí nad Moravou,15,349,155,194
15570,6418,Veselí nad Moravou,16,342,168,174
15571,6418,Veselí nad Moravou,17,334,167,167
15572,6418,Veselí nad Moravou,18,346,185,161
15573,6418,Veselí nad Moravou,19,339,175,164
15574,6418,Veselí nad Moravou,20,351,176,175
15575,6418,Veselí nad Moravou,21,324,160,164
15576,6418,Veselí nad Moravou,22,353,187,166
15577,6418,Veselí nad Moravou,23,352,180,172
15578,6418,Veselí nad Moravou,24,347,197,150
15579,6418,Veselí nad Moravou,25,422,210,212
15580,6418,Veselí nad Moravou,26,459,232,227
15581,6418,Veselí nad Moravou,27,495,261,234
15582,6418,Veselí nad Moravou,28,495,258,237
15583,6418,Veselí nad Moravou,29,527,284,243
15584,6418,Veselí nad Moravou,30,454,225,229
15585,6418,Veselí nad Moravou,31,473,264,209
15586,6418,Veselí nad Moravou,32,449,243,206
15587,6418,Veselí nad Moravou,33,465,249,216
15588,6418,Veselí nad Moravou,34,439,233,206
15589,6418,Veselí nad Moravou,35,499,277,222
15590,6418,Veselí nad Moravou,36,459,234,225
15591,6418,Veselí nad Moravou,37,469,251,218
15592,6418,Veselí nad Moravou,38,496,256,240
15593,6418,Veselí nad Moravou,39,500,260,240
15594,6418,Veselí nad Moravou,40,485,264,221
15595,6418,Veselí nad Moravou,41,517,262,255
15596,6418,Veselí nad Moravou,42,612,323,289
15597,6418,Veselí nad Moravou,43,571,303,268
15598,6418,Veselí nad Moravou,44,614,313,301
15599,6418,Veselí nad Moravou,45,625,337,288
15600,6418,Veselí nad Moravou,46,673,354,319
15601,6418,Veselí nad Moravou,47,604,311,293
15602,6418,Veselí nad Moravou,48,575,296,279
15603,6418,Veselí nad Moravou,49,573,298,275
15604,6418,Veselí nad Moravou,50,535,263,272
15605,6418,Veselí nad Moravou,51,564,264,300
15606,6418,Veselí nad Moravou,52,541,271,270
15607,6418,Veselí nad Moravou,53,500,268,232
15608,6418,Veselí nad Moravou,54,488,249,239
15609,6418,Veselí nad Moravou,55,513,274,239
15610,6418,Veselí nad Moravou,56,521,270,251
15611,6418,Veselí nad Moravou,57,501,244,257
15612,6418,Veselí nad Moravou,58,478,230,248
15613,6418,Veselí nad Moravou,59,469,257,212
15614,6418,Veselí nad Moravou,60,489,236,253
15615,6418,Veselí nad Moravou,61,466,234,232
15616,6418,Veselí nad Moravou,62,532,274,258
15617,6418,Veselí nad Moravou,63,577,283,294
15618,6418,Veselí nad Moravou,64,531,244,287
15619,6418,Veselí nad Moravou,65,567,260,307
15620,6418,Veselí nad Moravou,66,488,234,254
15621,6418,Veselí nad Moravou,67,552,251,301
15622,6418,Veselí nad Moravou,68,489,240,249
15623,6418,Veselí nad Moravou,69,520,226,294
15624,6418,Veselí nad Moravou,70,502,240,262
15625,6418,Veselí nad Moravou,71,445,192,253
15626,6418,Veselí nad Moravou,72,414,178,236
15627,6418,Veselí nad Moravou,73,445,203,242
15628,6418,Veselí nad Moravou,74,435,177,258
15629,6418,Veselí nad Moravou,75,356,129,227
15630,6418,Veselí nad Moravou,76,354,131,223
15631,6418,Veselí nad Moravou,77,337,129,208
15632,6418,Veselí nad Moravou,78,326,131,195
15633,6418,Veselí nad Moravou,79,289,110,179
15634,6418,Veselí nad Moravou,80,243,95,148
15635,6418,Veselí nad Moravou,81,206,81,125
15636,6418,Veselí nad Moravou,82,209,80,129
15637,6418,Veselí nad Moravou,83,186,61,125
15638,6418,Veselí nad Moravou,84,152,50,102
15639,6418,Veselí nad Moravou,85,145,45,100
15640,6418,Veselí nad Moravou,86,134,50,84
15641,6418,Veselí nad Moravou,87,98,26,72
15642,6418,Veselí nad Moravou,88,86,23,63
15643,6418,Veselí nad Moravou,89,84,27,57
15644,6418,Veselí nad Moravou,90,62,16,46
15645,6418,Veselí nad Moravou,91,50,15,35
15646,6418,Veselí nad Moravou,92,36,7,29
15647,6418,Veselí nad Moravou,93,24,2,22
15648,6418,Veselí nad Moravou,94,18,7,11
15649,6418,Veselí nad Moravou,95,16,1,15
15650,6418,Veselí nad Moravou,96,9,5,4
15651,6418,Veselí nad Moravou,97,10,0,10
15652,6418,Veselí nad Moravou,98,2,1,1
15653,6418,Veselí nad Moravou,99,2,0,2
15654,6418,Veselí nad Moravou,100,4,0,4
15655,6419,Vyškov,0,526,263,263
15656,6419,Vyškov,1,582,298,284
15657,6419,Vyškov,2,623,318,305
15658,6419,Vyškov,3,613,314,299
15659,6419,Vyškov,4,584,299,285
15660,6419,Vyškov,5,542,283,259
15661,6419,Vyškov,6,574,328,246
15662,6419,Vyškov,7,564,277,287
15663,6419,Vyškov,8,539,270,269
15664,6419,Vyškov,9,555,290,265
15665,6419,Vyškov,10,570,276,294
15666,6419,Vyškov,11,627,310,317
15667,6419,Vyškov,12,611,318,293
15668,6419,Vyškov,13,576,304,272
15669,6419,Vyškov,14,503,266,237
15670,6419,Vyškov,15,511,257,254
15671,6419,Vyškov,16,499,251,248
15672,6419,Vyškov,17,451,236,215
15673,6419,Vyškov,18,438,213,225
15674,6419,Vyškov,19,437,240,197
15675,6419,Vyškov,20,448,225,223
15676,6419,Vyškov,21,449,217,232
15677,6419,Vyškov,22,465,236,229
15678,6419,Vyškov,23,454,230,224
15679,6419,Vyškov,24,463,218,245
15680,6419,Vyškov,25,475,249,226
15681,6419,Vyškov,26,534,246,288
15682,6419,Vyškov,27,665,331,334
15683,6419,Vyškov,28,611,301,310
15684,6419,Vyškov,29,680,344,336
15685,6419,Vyškov,30,676,354,322
15686,6419,Vyškov,31,649,329,320
15687,6419,Vyškov,32,681,342,339
15688,6419,Vyškov,33,686,370,316
15689,6419,Vyškov,34,732,364,368
15690,6419,Vyškov,35,763,400,363
15691,6419,Vyškov,36,753,405,348
15692,6419,Vyškov,37,738,381,357
15693,6419,Vyškov,38,735,393,342
15694,6419,Vyškov,39,753,388,365
15695,6419,Vyškov,40,825,414,411
15696,6419,Vyškov,41,902,486,416
15697,6419,Vyškov,42,911,510,401
15698,6419,Vyškov,43,899,447,452
15699,6419,Vyškov,44,968,506,462
15700,6419,Vyškov,45,879,441,438
15701,6419,Vyškov,46,934,473,461
15702,6419,Vyškov,47,887,473,414
15703,6419,Vyškov,48,737,395,342
15704,6419,Vyškov,49,735,362,373
15705,6419,Vyškov,50,684,355,329
15706,6419,Vyškov,51,652,331,321
15707,6419,Vyškov,52,647,330,317
15708,6419,Vyškov,53,659,331,328
15709,6419,Vyškov,54,711,357,354
15710,6419,Vyškov,55,631,333,298
15711,6419,Vyškov,56,648,333,315
15712,6419,Vyškov,57,713,356,357
15713,6419,Vyškov,58,622,339,283
15714,6419,Vyškov,59,628,324,304
15715,6419,Vyškov,60,587,294,293
15716,6419,Vyškov,61,613,312,301
15717,6419,Vyškov,62,601,283,318
15718,6419,Vyškov,63,656,308,348
15719,6419,Vyškov,64,731,343,388
15720,6419,Vyškov,65,665,318,347
15721,6419,Vyškov,66,715,341,374
15722,6419,Vyškov,67,630,299,331
15723,6419,Vyškov,68,675,328,347
15724,6419,Vyškov,69,676,289,387
15725,6419,Vyškov,70,652,313,339
15726,6419,Vyškov,71,623,279,344
15727,6419,Vyškov,72,575,256,319
15728,6419,Vyškov,73,569,246,323
15729,6419,Vyškov,74,526,249,277
15730,6419,Vyškov,75,465,205,260
15731,6419,Vyškov,76,417,179,238
15732,6419,Vyškov,77,369,147,222
15733,6419,Vyškov,78,348,149,199
15734,6419,Vyškov,79,339,121,218
15735,6419,Vyškov,80,300,114,186
15736,6419,Vyškov,81,268,94,174
15737,6419,Vyškov,82,240,84,156
15738,6419,Vyškov,83,222,67,155
15739,6419,Vyškov,84,178,52,126
15740,6419,Vyškov,85,176,63,113
15741,6419,Vyškov,86,159,45,114
15742,6419,Vyškov,87,148,51,97
15743,6419,Vyškov,88,104,18,86
15744,6419,Vyškov,89,112,30,82
15745,6419,Vyškov,90,80,27,53
15746,6419,Vyškov,91,71,19,52
15747,6419,Vyškov,92,58,19,39
15748,6419,Vyškov,93,40,13,27
15749,6419,Vyškov,94,21,8,13
15750,6419,Vyškov,95,19,5,14
15751,6419,Vyškov,96,9,3,6
15752,6419,Vyškov,97,10,1,9
15753,6419,Vyškov,98,6,1,5
15754,6419,Vyškov,99,7,1,6
15755,6419,Vyškov,100,4,1,3
15756,6420,Znojmo,0,994,520,474
15757,6420,Znojmo,1,958,488,470
15758,6420,Znojmo,2,1016,520,496
15759,6420,Znojmo,3,1023,519,504
15760,6420,Znojmo,4,955,516,439
15761,6420,Znojmo,5,990,477,513
15762,6420,Znojmo,6,972,499,473
15763,6420,Znojmo,7,912,454,458
15764,6420,Znojmo,8,910,475,435
15765,6420,Znojmo,9,932,464,468
15766,6420,Znojmo,10,982,515,467
15767,6420,Znojmo,11,1079,532,547
15768,6420,Znojmo,12,1067,538,529
15769,6420,Znojmo,13,1095,564,531
15770,6420,Znojmo,14,948,525,423
15771,6420,Znojmo,15,928,476,452
15772,6420,Znojmo,16,851,467,384
15773,6420,Znojmo,17,904,455,449
15774,6420,Znojmo,18,871,449,422
15775,6420,Znojmo,19,867,431,436
15776,6420,Znojmo,20,873,472,401
15777,6420,Znojmo,21,809,416,393
15778,6420,Znojmo,22,865,439,426
15779,6420,Znojmo,23,854,432,422
15780,6420,Znojmo,24,919,499,420
15781,6420,Znojmo,25,955,468,487
15782,6420,Znojmo,26,1022,525,497
15783,6420,Znojmo,27,1181,587,594
15784,6420,Znojmo,28,1161,598,563
15785,6420,Znojmo,29,1200,614,586
15786,6420,Znojmo,30,1228,647,581
15787,6420,Znojmo,31,1092,577,515
15788,6420,Znojmo,32,1174,602,572
15789,6420,Znojmo,33,1194,607,587
15790,6420,Znojmo,34,1115,563,552
15791,6420,Znojmo,35,1205,595,610
15792,6420,Znojmo,36,1205,613,592
15793,6420,Znojmo,37,1266,658,608
15794,6420,Znojmo,38,1230,611,619
15795,6420,Znojmo,39,1243,641,602
15796,6420,Znojmo,40,1356,671,685
15797,6420,Znojmo,41,1450,748,702
15798,6420,Znojmo,42,1477,761,716
15799,6420,Znojmo,43,1618,856,762
15800,6420,Znojmo,44,1593,876,717
15801,6420,Znojmo,45,1634,824,810
15802,6420,Znojmo,46,1608,797,811
15803,6420,Znojmo,47,1563,747,816
15804,6420,Znojmo,48,1395,730,665
15805,6420,Znojmo,49,1363,676,687
15806,6420,Znojmo,50,1311,647,664
15807,6420,Znojmo,51,1248,635,613
15808,6420,Znojmo,52,1134,580,554
15809,6420,Znojmo,53,1138,588,550
15810,6420,Znojmo,54,1164,548,616
15811,6420,Znojmo,55,1209,634,575
15812,6420,Znojmo,56,1246,642,604
15813,6420,Znojmo,57,1139,589,550
15814,6420,Znojmo,58,1068,569,499
15815,6420,Znojmo,59,1073,546,527
15816,6420,Znojmo,60,990,475,515
15817,6420,Znojmo,61,1039,512,527
15818,6420,Znojmo,62,1156,566,590
15819,6420,Znojmo,63,1235,616,619
15820,6420,Znojmo,64,1313,620,693
15821,6420,Znojmo,65,1265,607,658
15822,6420,Znojmo,66,1231,577,654
15823,6420,Znojmo,67,1160,542,618
15824,6420,Znojmo,68,1224,558,666
15825,6420,Znojmo,69,1247,595,652
15826,6420,Znojmo,70,1140,522,618
15827,6420,Znojmo,71,1106,512,594
15828,6420,Znojmo,72,1148,518,630
15829,6420,Znojmo,73,1126,493,633
15830,6420,Znojmo,74,1028,491,537
15831,6420,Znojmo,75,702,291,411
15832,6420,Znojmo,76,700,308,392
15833,6420,Znojmo,77,674,294,380
15834,6420,Znojmo,78,570,240,330
15835,6420,Znojmo,79,556,226,330
15836,6420,Znojmo,80,510,179,331
15837,6420,Znojmo,81,448,181,267
15838,6420,Znojmo,82,346,112,234
15839,6420,Znojmo,83,333,128,205
15840,6420,Znojmo,84,286,86,200
15841,6420,Znojmo,85,262,86,176
15842,6420,Znojmo,86,243,83,160
15843,6420,Znojmo,87,253,78,175
15844,6420,Znojmo,88,229,57,172
15845,6420,Znojmo,89,167,42,125
15846,6420,Znojmo,90,149,39,110
15847,6420,Znojmo,91,92,23,69
15848,6420,Znojmo,92,82,12,70
15849,6420,Znojmo,93,50,7,43
15850,6420,Znojmo,94,40,6,34
15851,6420,Znojmo,95,43,11,32
15852,6420,Znojmo,96,29,1,28
15853,6420,Znojmo,97,17,3,14
15854,6420,Znojmo,98,9,2,7
15855,6420,Znojmo,99,10,3,7
15856,6420,Znojmo,100,6,2,4
15857,6421,Židlochovice,0,390,213,177
15858,6421,Židlochovice,1,398,186,212
15859,6421,Židlochovice,2,448,233,215
15860,6421,Židlochovice,3,443,230,213
15861,6421,Židlochovice,4,456,262,194
15862,6421,Židlochovice,5,435,230,205
15863,6421,Židlochovice,6,477,245,232
15864,6421,Židlochovice,7,444,217,227
15865,6421,Židlochovice,8,412,227,185
15866,6421,Židlochovice,9,440,223,217
15867,6421,Židlochovice,10,474,249,225
15868,6421,Židlochovice,11,433,211,222
15869,6421,Židlochovice,12,416,210,206
15870,6421,Židlochovice,13,379,204,175
15871,6421,Židlochovice,14,358,183,175
15872,6421,Židlochovice,15,360,201,159
15873,6421,Židlochovice,16,323,165,158
15874,6421,Židlochovice,17,324,169,155
15875,6421,Židlochovice,18,291,149,142
15876,6421,Židlochovice,19,314,154,160
15877,6421,Židlochovice,20,270,142,128
15878,6421,Židlochovice,21,309,152,157
15879,6421,Židlochovice,22,307,164,143
15880,6421,Židlochovice,23,254,141,113
15881,6421,Židlochovice,24,268,153,115
15882,6421,Židlochovice,25,282,133,149
15883,6421,Židlochovice,26,320,164,156
15884,6421,Židlochovice,27,384,218,166
15885,6421,Židlochovice,28,353,177,176
15886,6421,Židlochovice,29,417,204,213
15887,6421,Židlochovice,30,452,232,220
15888,6421,Židlochovice,31,396,188,208
15889,6421,Židlochovice,32,480,230,250
15890,6421,Židlochovice,33,478,246,232
15891,6421,Židlochovice,34,452,217,235
15892,6421,Židlochovice,35,561,292,269
15893,6421,Židlochovice,36,509,255,254
15894,6421,Židlochovice,37,543,283,260
15895,6421,Židlochovice,38,560,277,283
15896,6421,Židlochovice,39,576,262,314
15897,6421,Židlochovice,40,534,273,261
15898,6421,Židlochovice,41,629,316,313
15899,6421,Židlochovice,42,622,333,289
15900,6421,Židlochovice,43,674,354,320
15901,6421,Židlochovice,44,629,339,290
15902,6421,Židlochovice,45,636,353,283
15903,6421,Židlochovice,46,606,304,302
15904,6421,Židlochovice,47,573,287,286
15905,6421,Židlochovice,48,527,262,265
15906,6421,Židlochovice,49,493,266,227
15907,6421,Židlochovice,50,456,225,231
15908,6421,Židlochovice,51,438,227,211
15909,6421,Židlochovice,52,399,216,183
15910,6421,Židlochovice,53,407,215,192
15911,6421,Židlochovice,54,418,221,197
15912,6421,Židlochovice,55,376,206,170
15913,6421,Židlochovice,56,460,244,216
15914,6421,Židlochovice,57,393,209,184
15915,6421,Židlochovice,58,362,182,180
15916,6421,Židlochovice,59,320,160,160
15917,6421,Židlochovice,60,368,195,173
15918,6421,Židlochovice,61,299,152,147
15919,6421,Židlochovice,62,374,195,179
15920,6421,Židlochovice,63,374,176,198
15921,6421,Židlochovice,64,364,179,185
15922,6421,Židlochovice,65,403,181,222
15923,6421,Židlochovice,66,379,166,213
15924,6421,Židlochovice,67,336,160,176
15925,6421,Židlochovice,68,365,178,187
15926,6421,Židlochovice,69,350,146,204
15927,6421,Židlochovice,70,389,173,216
15928,6421,Židlochovice,71,335,137,198
15929,6421,Židlochovice,72,360,165,195
15930,6421,Židlochovice,73,345,146,199
15931,6421,Židlochovice,74,342,143,199
15932,6421,Židlochovice,75,269,110,159
15933,6421,Židlochovice,76,271,118,153
15934,6421,Židlochovice,77,212,80,132
15935,6421,Židlochovice,78,214,82,132
15936,6421,Židlochovice,79,207,84,123
15937,6421,Židlochovice,80,198,82,116
15938,6421,Židlochovice,81,137,49,88
15939,6421,Židlochovice,82,124,41,83
15940,6421,Židlochovice,83,110,34,76
15941,6421,Židlochovice,84,89,30,59
15942,6421,Židlochovice,85,94,20,74
15943,6421,Židlochovice,86,75,20,55
15944,6421,Židlochovice,87,85,22,63
15945,6421,Židlochovice,88,62,22,40
15946,6421,Židlochovice,89,37,11,26
15947,6421,Židlochovice,90,51,13,38
15948,6421,Židlochovice,91,43,6,37
15949,6421,Židlochovice,92,26,4,22
15950,6421,Židlochovice,93,26,6,20
15951,6421,Židlochovice,94,20,5,15
15952,6421,Židlochovice,95,6,3,3
15953,6421,Židlochovice,96,12,5,7
15954,6421,Židlochovice,97,8,2,6
15955,6421,Židlochovice,98,3,0,3
15956,6421,Židlochovice,99,3,1,2
15957,6421,Židlochovice,100,0,0,0
15958,7101,Hranice,0,383,193,190
15959,7101,Hranice,1,313,171,142
15960,7101,Hranice,2,352,173,179
15961,7101,Hranice,3,330,168,162
15962,7101,Hranice,4,384,189,195
15963,7101,Hranice,5,316,172,144
15964,7101,Hranice,6,348,191,157
15965,7101,Hranice,7,309,145,164
15966,7101,Hranice,8,352,176,176
15967,7101,Hranice,9,303,149,154
15968,7101,Hranice,10,362,194,168
15969,7101,Hranice,11,360,177,183
15970,7101,Hranice,12,359,187,172
15971,7101,Hranice,13,388,192,196
15972,7101,Hranice,14,378,194,184
15973,7101,Hranice,15,343,171,172
15974,7101,Hranice,16,320,165,155
15975,7101,Hranice,17,327,183,144
15976,7101,Hranice,18,297,156,141
15977,7101,Hranice,19,345,176,169
15978,7101,Hranice,20,327,182,145
15979,7101,Hranice,21,329,154,175
15980,7101,Hranice,22,317,169,148
15981,7101,Hranice,23,301,161,140
15982,7101,Hranice,24,336,154,182
15983,7101,Hranice,25,353,177,176
15984,7101,Hranice,26,425,232,193
15985,7101,Hranice,27,467,232,235
15986,7101,Hranice,28,426,220,206
15987,7101,Hranice,29,469,262,207
15988,7101,Hranice,30,484,248,236
15989,7101,Hranice,31,438,216,222
15990,7101,Hranice,32,438,235,203
15991,7101,Hranice,33,444,227,217
15992,7101,Hranice,34,428,222,206
15993,7101,Hranice,35,446,222,224
15994,7101,Hranice,36,423,223,200
15995,7101,Hranice,37,420,232,188
15996,7101,Hranice,38,434,218,216
15997,7101,Hranice,39,458,222,236
15998,7101,Hranice,40,516,263,253
15999,7101,Hranice,41,509,258,251
16000,7101,Hranice,42,517,273,244
16001,7101,Hranice,43,503,250,253
16002,7101,Hranice,44,577,326,251
16003,7101,Hranice,45,611,310,301
16004,7101,Hranice,46,634,301,333
16005,7101,Hranice,47,595,340,255
16006,7101,Hranice,48,507,250,257
16007,7101,Hranice,49,505,233,272
16008,7101,Hranice,50,477,261,216
16009,7101,Hranice,51,451,227,224
16010,7101,Hranice,52,455,234,221
16011,7101,Hranice,53,442,223,219
16012,7101,Hranice,54,457,212,245
16013,7101,Hranice,55,510,277,233
16014,7101,Hranice,56,472,246,226
16015,7101,Hranice,57,454,223,231
16016,7101,Hranice,58,410,229,181
16017,7101,Hranice,59,391,184,207
16018,7101,Hranice,60,378,174,204
16019,7101,Hranice,61,382,173,209
16020,7101,Hranice,62,438,211,227
16021,7101,Hranice,63,453,210,243
16022,7101,Hranice,64,440,216,224
16023,7101,Hranice,65,464,228,236
16024,7101,Hranice,66,458,209,249
16025,7101,Hranice,67,457,225,232
16026,7101,Hranice,68,474,215,259
16027,7101,Hranice,69,403,176,227
16028,7101,Hranice,70,404,206,198
16029,7101,Hranice,71,379,180,199
16030,7101,Hranice,72,368,158,210
16031,7101,Hranice,73,370,134,236
16032,7101,Hranice,74,365,155,210
16033,7101,Hranice,75,289,131,158
16034,7101,Hranice,76,305,131,174
16035,7101,Hranice,77,299,121,178
16036,7101,Hranice,78,251,96,155
16037,7101,Hranice,79,204,69,135
16038,7101,Hranice,80,199,79,120
16039,7101,Hranice,81,180,70,110
16040,7101,Hranice,82,177,71,106
16041,7101,Hranice,83,137,46,91
16042,7101,Hranice,84,115,33,82
16043,7101,Hranice,85,86,22,64
16044,7101,Hranice,86,91,35,56
16045,7101,Hranice,87,91,28,63
16046,7101,Hranice,88,79,22,57
16047,7101,Hranice,89,67,25,42
16048,7101,Hranice,90,55,11,44
16049,7101,Hranice,91,42,11,31
16050,7101,Hranice,92,41,12,29
16051,7101,Hranice,93,33,7,26
16052,7101,Hranice,94,19,1,18
16053,7101,Hranice,95,15,4,11
16054,7101,Hranice,96,7,0,7
16055,7101,Hranice,97,7,3,4
16056,7101,Hranice,98,3,1,2
16057,7101,Hranice,99,3,0,3
16058,7101,Hranice,100,2,1,1
16059,7102,Jeseník,0,365,187,178
16060,7102,Jeseník,1,350,173,177
16061,7102,Jeseník,2,331,168,163
16062,7102,Jeseník,3,346,180,166
16063,7102,Jeseník,4,331,164,167
16064,7102,Jeseník,5,332,160,172
16065,7102,Jeseník,6,312,170,142
16066,7102,Jeseník,7,330,164,166
16067,7102,Jeseník,8,338,152,186
16068,7102,Jeseník,9,320,170,150
16069,7102,Jeseník,10,365,182,183
16070,7102,Jeseník,11,410,221,189
16071,7102,Jeseník,12,415,198,217
16072,7102,Jeseník,13,411,220,191
16073,7102,Jeseník,14,371,175,196
16074,7102,Jeseník,15,377,179,198
16075,7102,Jeseník,16,361,155,206
16076,7102,Jeseník,17,351,177,174
16077,7102,Jeseník,18,344,181,163
16078,7102,Jeseník,19,363,201,162
16079,7102,Jeseník,20,359,181,178
16080,7102,Jeseník,21,356,188,168
16081,7102,Jeseník,22,382,192,190
16082,7102,Jeseník,23,363,187,176
16083,7102,Jeseník,24,378,205,173
16084,7102,Jeseník,25,377,192,185
16085,7102,Jeseník,26,434,226,208
16086,7102,Jeseník,27,447,236,211
16087,7102,Jeseník,28,474,222,252
16088,7102,Jeseník,29,455,234,221
16089,7102,Jeseník,30,441,260,181
16090,7102,Jeseník,31,513,283,230
16091,7102,Jeseník,32,467,255,212
16092,7102,Jeseník,33,461,238,223
16093,7102,Jeseník,34,469,274,195
16094,7102,Jeseník,35,433,232,201
16095,7102,Jeseník,36,433,243,190
16096,7102,Jeseník,37,464,253,211
16097,7102,Jeseník,38,450,238,212
16098,7102,Jeseník,39,471,260,211
16099,7102,Jeseník,40,464,249,215
16100,7102,Jeseník,41,576,285,291
16101,7102,Jeseník,42,577,319,258
16102,7102,Jeseník,43,595,321,274
16103,7102,Jeseník,44,664,367,297
16104,7102,Jeseník,45,667,356,311
16105,7102,Jeseník,46,667,333,334
16106,7102,Jeseník,47,646,362,284
16107,7102,Jeseník,48,573,276,297
16108,7102,Jeseník,49,519,266,253
16109,7102,Jeseník,50,456,246,210
16110,7102,Jeseník,51,481,248,233
16111,7102,Jeseník,52,467,256,211
16112,7102,Jeseník,53,533,284,249
16113,7102,Jeseník,54,486,248,238
16114,7102,Jeseník,55,527,276,251
16115,7102,Jeseník,56,531,275,256
16116,7102,Jeseník,57,505,229,276
16117,7102,Jeseník,58,480,258,222
16118,7102,Jeseník,59,472,246,226
16119,7102,Jeseník,60,501,234,267
16120,7102,Jeseník,61,453,232,221
16121,7102,Jeseník,62,487,240,247
16122,7102,Jeseník,63,531,262,269
16123,7102,Jeseník,64,585,274,311
16124,7102,Jeseník,65,583,250,333
16125,7102,Jeseník,66,581,276,305
16126,7102,Jeseník,67,575,268,307
16127,7102,Jeseník,68,576,274,302
16128,7102,Jeseník,69,581,265,316
16129,7102,Jeseník,70,584,261,323
16130,7102,Jeseník,71,538,243,295
16131,7102,Jeseník,72,510,222,288
16132,7102,Jeseník,73,547,242,305
16133,7102,Jeseník,74,425,189,236
16134,7102,Jeseník,75,315,115,200
16135,7102,Jeseník,76,336,144,192
16136,7102,Jeseník,77,306,126,180
16137,7102,Jeseník,78,260,96,164
16138,7102,Jeseník,79,271,107,164
16139,7102,Jeseník,80,251,98,153
16140,7102,Jeseník,81,189,69,120
16141,7102,Jeseník,82,165,61,104
16142,7102,Jeseník,83,148,39,109
16143,7102,Jeseník,84,110,41,69
16144,7102,Jeseník,85,122,41,81
16145,7102,Jeseník,86,96,35,61
16146,7102,Jeseník,87,100,33,67
16147,7102,Jeseník,88,91,21,70
16148,7102,Jeseník,89,56,17,39
16149,7102,Jeseník,90,48,15,33
16150,7102,Jeseník,91,47,17,30
16151,7102,Jeseník,92,32,8,24
16152,7102,Jeseník,93,18,5,13
16153,7102,Jeseník,94,18,3,15
16154,7102,Jeseník,95,15,2,13
16155,7102,Jeseník,96,4,0,4
16156,7102,Jeseník,97,7,0,7
16157,7102,Jeseník,98,2,1,1
16158,7102,Jeseník,99,5,1,4
16159,7102,Jeseník,100,4,2,2
16160,7103,Konice,0,107,54,53
16161,7103,Konice,1,93,50,43
16162,7103,Konice,2,83,49,34
16163,7103,Konice,3,110,64,46
16164,7103,Konice,4,84,46,38
16165,7103,Konice,5,85,41,44
16166,7103,Konice,6,102,58,44
16167,7103,Konice,7,101,48,53
16168,7103,Konice,8,87,43,44
16169,7103,Konice,9,115,51,64
16170,7103,Konice,10,122,62,60
16171,7103,Konice,11,107,56,51
16172,7103,Konice,12,121,70,51
16173,7103,Konice,13,106,49,57
16174,7103,Konice,14,97,41,56
16175,7103,Konice,15,87,41,46
16176,7103,Konice,16,81,50,31
16177,7103,Konice,17,95,48,47
16178,7103,Konice,18,98,44,54
16179,7103,Konice,19,94,50,44
16180,7103,Konice,20,101,48,53
16181,7103,Konice,21,108,64,44
16182,7103,Konice,22,101,51,50
16183,7103,Konice,23,90,42,48
16184,7103,Konice,24,102,51,51
16185,7103,Konice,25,106,60,46
16186,7103,Konice,26,120,61,59
16187,7103,Konice,27,134,74,60
16188,7103,Konice,28,138,72,66
16189,7103,Konice,29,123,68,55
16190,7103,Konice,30,132,67,65
16191,7103,Konice,31,127,66,61
16192,7103,Konice,32,128,69,59
16193,7103,Konice,33,127,79,48
16194,7103,Konice,34,125,73,52
16195,7103,Konice,35,118,68,50
16196,7103,Konice,36,125,59,66
16197,7103,Konice,37,138,69,69
16198,7103,Konice,38,121,77,44
16199,7103,Konice,39,141,78,63
16200,7103,Konice,40,165,90,75
16201,7103,Konice,41,160,75,85
16202,7103,Konice,42,160,81,79
16203,7103,Konice,43,195,100,95
16204,7103,Konice,44,166,91,75
16205,7103,Konice,45,171,103,68
16206,7103,Konice,46,211,119,92
16207,7103,Konice,47,170,81,89
16208,7103,Konice,48,160,91,69
16209,7103,Konice,49,149,89,60
16210,7103,Konice,50,156,78,78
16211,7103,Konice,51,137,74,63
16212,7103,Konice,52,126,75,51
16213,7103,Konice,53,133,63,70
16214,7103,Konice,54,125,59,66
16215,7103,Konice,55,138,72,66
16216,7103,Konice,56,153,81,72
16217,7103,Konice,57,144,76,68
16218,7103,Konice,58,109,54,55
16219,7103,Konice,59,140,78,62
16220,7103,Konice,60,136,58,78
16221,7103,Konice,61,137,70,67
16222,7103,Konice,62,140,67,73
16223,7103,Konice,63,166,88,78
16224,7103,Konice,64,189,94,95
16225,7103,Konice,65,164,72,92
16226,7103,Konice,66,151,72,79
16227,7103,Konice,67,148,78,70
16228,7103,Konice,68,164,86,78
16229,7103,Konice,69,162,64,98
16230,7103,Konice,70,163,76,87
16231,7103,Konice,71,154,70,84
16232,7103,Konice,72,159,79,80
16233,7103,Konice,73,127,63,64
16234,7103,Konice,74,116,57,59
16235,7103,Konice,75,104,43,61
16236,7103,Konice,76,91,35,56
16237,7103,Konice,77,88,40,48
16238,7103,Konice,78,72,30,42
16239,7103,Konice,79,74,26,48
16240,7103,Konice,80,57,22,35
16241,7103,Konice,81,57,20,37
16242,7103,Konice,82,60,21,39
16243,7103,Konice,83,49,12,37
16244,7103,Konice,84,47,16,31
16245,7103,Konice,85,37,12,25
16246,7103,Konice,86,33,9,24
16247,7103,Konice,87,23,6,17
16248,7103,Konice,88,27,5,22
16249,7103,Konice,89,24,8,16
16250,7103,Konice,90,11,3,8
16251,7103,Konice,91,22,4,18
16252,7103,Konice,92,14,4,10
16253,7103,Konice,93,10,1,9
16254,7103,Konice,94,8,0,8
16255,7103,Konice,95,8,2,6
16256,7103,Konice,96,4,1,3
16257,7103,Konice,97,1,0,1
16258,7103,Konice,98,0,0,0
16259,7103,Konice,99,1,0,1
16260,7103,Konice,100,0,0,0
16261,7104,Lipník nad Bečvou,0,168,77,91
16262,7104,Lipník nad Bečvou,1,148,85,63
16263,7104,Lipník nad Bečvou,2,124,61,63
16264,7104,Lipník nad Bečvou,3,159,88,71
16265,7104,Lipník nad Bečvou,4,143,75,68
16266,7104,Lipník nad Bečvou,5,147,77,70
16267,7104,Lipník nad Bečvou,6,169,80,89
16268,7104,Lipník nad Bečvou,7,136,73,63
16269,7104,Lipník nad Bečvou,8,145,76,69
16270,7104,Lipník nad Bečvou,9,140,69,71
16271,7104,Lipník nad Bečvou,10,160,77,83
16272,7104,Lipník nad Bečvou,11,172,91,81
16273,7104,Lipník nad Bečvou,12,167,86,81
16274,7104,Lipník nad Bečvou,13,161,76,85
16275,7104,Lipník nad Bečvou,14,180,94,86
16276,7104,Lipník nad Bečvou,15,170,92,78
16277,7104,Lipník nad Bečvou,16,148,73,75
16278,7104,Lipník nad Bečvou,17,140,71,69
16279,7104,Lipník nad Bečvou,18,138,77,61
16280,7104,Lipník nad Bečvou,19,146,73,73
16281,7104,Lipník nad Bečvou,20,124,65,59
16282,7104,Lipník nad Bečvou,21,141,78,63
16283,7104,Lipník nad Bečvou,22,139,56,83
16284,7104,Lipník nad Bečvou,23,139,72,67
16285,7104,Lipník nad Bečvou,24,134,72,62
16286,7104,Lipník nad Bečvou,25,155,81,74
16287,7104,Lipník nad Bečvou,26,180,94,86
16288,7104,Lipník nad Bečvou,27,192,101,91
16289,7104,Lipník nad Bečvou,28,197,103,94
16290,7104,Lipník nad Bečvou,29,199,99,100
16291,7104,Lipník nad Bečvou,30,221,116,105
16292,7104,Lipník nad Bečvou,31,202,110,92
16293,7104,Lipník nad Bečvou,32,200,113,87
16294,7104,Lipník nad Bečvou,33,215,120,95
16295,7104,Lipník nad Bečvou,34,177,79,98
16296,7104,Lipník nad Bečvou,35,187,101,86
16297,7104,Lipník nad Bečvou,36,201,105,96
16298,7104,Lipník nad Bečvou,37,197,94,103
16299,7104,Lipník nad Bečvou,38,188,108,80
16300,7104,Lipník nad Bečvou,39,199,111,88
16301,7104,Lipník nad Bečvou,40,214,122,92
16302,7104,Lipník nad Bečvou,41,228,119,109
16303,7104,Lipník nad Bečvou,42,255,132,123
16304,7104,Lipník nad Bečvou,43,242,142,100
16305,7104,Lipník nad Bečvou,44,238,121,117
16306,7104,Lipník nad Bečvou,45,269,128,141
16307,7104,Lipník nad Bečvou,46,270,135,135
16308,7104,Lipník nad Bečvou,47,225,115,110
16309,7104,Lipník nad Bečvou,48,275,152,123
16310,7104,Lipník nad Bečvou,49,209,98,111
16311,7104,Lipník nad Bečvou,50,222,111,111
16312,7104,Lipník nad Bečvou,51,228,114,114
16313,7104,Lipník nad Bečvou,52,193,93,100
16314,7104,Lipník nad Bečvou,53,205,111,94
16315,7104,Lipník nad Bečvou,54,189,94,95
16316,7104,Lipník nad Bečvou,55,195,100,95
16317,7104,Lipník nad Bečvou,56,221,101,120
16318,7104,Lipník nad Bečvou,57,235,116,119
16319,7104,Lipník nad Bečvou,58,193,96,97
16320,7104,Lipník nad Bečvou,59,192,105,87
16321,7104,Lipník nad Bečvou,60,195,99,96
16322,7104,Lipník nad Bečvou,61,193,104,89
16323,7104,Lipník nad Bečvou,62,203,93,110
16324,7104,Lipník nad Bečvou,63,200,104,96
16325,7104,Lipník nad Bečvou,64,207,97,110
16326,7104,Lipník nad Bečvou,65,208,115,93
16327,7104,Lipník nad Bečvou,66,214,99,115
16328,7104,Lipník nad Bečvou,67,170,85,85
16329,7104,Lipník nad Bečvou,68,202,99,103
16330,7104,Lipník nad Bečvou,69,165,71,94
16331,7104,Lipník nad Bečvou,70,155,66,89
16332,7104,Lipník nad Bečvou,71,171,84,87
16333,7104,Lipník nad Bečvou,72,144,62,82
16334,7104,Lipník nad Bečvou,73,165,67,98
16335,7104,Lipník nad Bečvou,74,154,67,87
16336,7104,Lipník nad Bečvou,75,148,55,93
16337,7104,Lipník nad Bečvou,76,128,54,74
16338,7104,Lipník nad Bečvou,77,129,56,73
16339,7104,Lipník nad Bečvou,78,102,43,59
16340,7104,Lipník nad Bečvou,79,95,36,59
16341,7104,Lipník nad Bečvou,80,89,36,53
16342,7104,Lipník nad Bečvou,81,69,32,37
16343,7104,Lipník nad Bečvou,82,55,10,45
16344,7104,Lipník nad Bečvou,83,76,24,52
16345,7104,Lipník nad Bečvou,84,46,13,33
16346,7104,Lipník nad Bečvou,85,69,18,51
16347,7104,Lipník nad Bečvou,86,40,11,29
16348,7104,Lipník nad Bečvou,87,28,12,16
16349,7104,Lipník nad Bečvou,88,30,8,22
16350,7104,Lipník nad Bečvou,89,25,12,13
16351,7104,Lipník nad Bečvou,90,24,4,20
16352,7104,Lipník nad Bečvou,91,16,7,9
16353,7104,Lipník nad Bečvou,92,10,1,9
16354,7104,Lipník nad Bečvou,93,12,4,8
16355,7104,Lipník nad Bečvou,94,5,1,4
16356,7104,Lipník nad Bečvou,95,3,0,3
16357,7104,Lipník nad Bečvou,96,1,0,1
16358,7104,Lipník nad Bečvou,97,3,1,2
16359,7104,Lipník nad Bečvou,98,1,0,1
16360,7104,Lipník nad Bečvou,99,1,0,1
16361,7104,Lipník nad Bečvou,100,2,0,2
16362,7105,Litovel,0,252,125,127
16363,7105,Litovel,1,236,112,124
16364,7105,Litovel,2,275,124,151
16365,7105,Litovel,3,267,135,132
16366,7105,Litovel,4,265,148,117
16367,7105,Litovel,5,237,138,99
16368,7105,Litovel,6,256,133,123
16369,7105,Litovel,7,255,138,117
16370,7105,Litovel,8,241,114,127
16371,7105,Litovel,9,232,122,110
16372,7105,Litovel,10,241,121,120
16373,7105,Litovel,11,270,134,136
16374,7105,Litovel,12,249,124,125
16375,7105,Litovel,13,264,133,131
16376,7105,Litovel,14,215,123,92
16377,7105,Litovel,15,238,127,111
16378,7105,Litovel,16,210,110,100
16379,7105,Litovel,17,220,118,102
16380,7105,Litovel,18,215,105,110
16381,7105,Litovel,19,229,118,111
16382,7105,Litovel,20,200,102,98
16383,7105,Litovel,21,212,101,111
16384,7105,Litovel,22,219,111,108
16385,7105,Litovel,23,237,120,117
16386,7105,Litovel,24,183,84,99
16387,7105,Litovel,25,227,105,122
16388,7105,Litovel,26,244,123,121
16389,7105,Litovel,27,308,156,152
16390,7105,Litovel,28,283,142,141
16391,7105,Litovel,29,305,164,141
16392,7105,Litovel,30,287,151,136
16393,7105,Litovel,31,316,158,158
16394,7105,Litovel,32,292,148,144
16395,7105,Litovel,33,297,158,139
16396,7105,Litovel,34,300,167,133
16397,7105,Litovel,35,304,173,131
16398,7105,Litovel,36,299,148,151
16399,7105,Litovel,37,282,151,131
16400,7105,Litovel,38,312,152,160
16401,7105,Litovel,39,357,196,161
16402,7105,Litovel,40,373,180,193
16403,7105,Litovel,41,368,192,176
16404,7105,Litovel,42,367,195,172
16405,7105,Litovel,43,395,221,174
16406,7105,Litovel,44,381,203,178
16407,7105,Litovel,45,449,233,216
16408,7105,Litovel,46,417,216,201
16409,7105,Litovel,47,386,199,187
16410,7105,Litovel,48,368,188,180
16411,7105,Litovel,49,333,173,160
16412,7105,Litovel,50,328,169,159
16413,7105,Litovel,51,304,180,124
16414,7105,Litovel,52,312,170,142
16415,7105,Litovel,53,278,136,142
16416,7105,Litovel,54,306,158,148
16417,7105,Litovel,55,319,165,154
16418,7105,Litovel,56,328,163,165
16419,7105,Litovel,57,337,173,164
16420,7105,Litovel,58,297,148,149
16421,7105,Litovel,59,274,132,142
16422,7105,Litovel,60,290,146,144
16423,7105,Litovel,61,246,121,125
16424,7105,Litovel,62,291,148,143
16425,7105,Litovel,63,294,138,156
16426,7105,Litovel,64,297,147,150
16427,7105,Litovel,65,293,153,140
16428,7105,Litovel,66,292,150,142
16429,7105,Litovel,67,319,155,164
16430,7105,Litovel,68,312,146,166
16431,7105,Litovel,69,326,152,174
16432,7105,Litovel,70,289,147,142
16433,7105,Litovel,71,292,129,163
16434,7105,Litovel,72,287,133,154
16435,7105,Litovel,73,267,126,141
16436,7105,Litovel,74,262,123,139
16437,7105,Litovel,75,217,85,132
16438,7105,Litovel,76,177,78,99
16439,7105,Litovel,77,194,75,119
16440,7105,Litovel,78,171,71,100
16441,7105,Litovel,79,164,68,96
16442,7105,Litovel,80,149,54,95
16443,7105,Litovel,81,137,50,87
16444,7105,Litovel,82,108,37,71
16445,7105,Litovel,83,99,44,55
16446,7105,Litovel,84,99,26,73
16447,7105,Litovel,85,77,24,53
16448,7105,Litovel,86,86,28,58
16449,7105,Litovel,87,64,19,45
16450,7105,Litovel,88,58,15,43
16451,7105,Litovel,89,40,10,30
16452,7105,Litovel,90,34,10,24
16453,7105,Litovel,91,34,8,26
16454,7105,Litovel,92,25,7,18
16455,7105,Litovel,93,21,3,18
16456,7105,Litovel,94,12,0,12
16457,7105,Litovel,95,9,4,5
16458,7105,Litovel,96,4,0,4
16459,7105,Litovel,97,0,0,0
16460,7105,Litovel,98,5,1,4
16461,7105,Litovel,99,1,1,0
16462,7105,Litovel,100,1,0,1
16463,7106,Mohelnice,0,209,108,101
16464,7106,Mohelnice,1,201,100,101
16465,7106,Mohelnice,2,210,113,97
16466,7106,Mohelnice,3,182,83,99
16467,7106,Mohelnice,4,206,108,98
16468,7106,Mohelnice,5,170,97,73
16469,7106,Mohelnice,6,165,98,67
16470,7106,Mohelnice,7,182,97,85
16471,7106,Mohelnice,8,176,86,90
16472,7106,Mohelnice,9,165,82,83
16473,7106,Mohelnice,10,199,102,97
16474,7106,Mohelnice,11,196,101,95
16475,7106,Mohelnice,12,211,112,99
16476,7106,Mohelnice,13,187,93,94
16477,7106,Mohelnice,14,178,83,95
16478,7106,Mohelnice,15,170,89,81
16479,7106,Mohelnice,16,152,88,64
16480,7106,Mohelnice,17,143,67,76
16481,7106,Mohelnice,18,162,97,65
16482,7106,Mohelnice,19,153,66,87
16483,7106,Mohelnice,20,200,105,95
16484,7106,Mohelnice,21,161,83,78
16485,7106,Mohelnice,22,173,98,75
16486,7106,Mohelnice,23,169,84,85
16487,7106,Mohelnice,24,169,80,89
16488,7106,Mohelnice,25,186,84,102
16489,7106,Mohelnice,26,214,124,90
16490,7106,Mohelnice,27,269,141,128
16491,7106,Mohelnice,28,232,128,104
16492,7106,Mohelnice,29,266,131,135
16493,7106,Mohelnice,30,281,134,147
16494,7106,Mohelnice,31,253,160,93
16495,7106,Mohelnice,32,244,137,107
16496,7106,Mohelnice,33,233,126,107
16497,7106,Mohelnice,34,244,135,109
16498,7106,Mohelnice,35,209,110,99
16499,7106,Mohelnice,36,241,140,101
16500,7106,Mohelnice,37,224,107,117
16501,7106,Mohelnice,38,247,123,124
16502,7106,Mohelnice,39,247,121,126
16503,7106,Mohelnice,40,250,133,117
16504,7106,Mohelnice,41,303,162,141
16505,7106,Mohelnice,42,308,163,145
16506,7106,Mohelnice,43,311,156,155
16507,7106,Mohelnice,44,346,190,156
16508,7106,Mohelnice,45,353,192,161
16509,7106,Mohelnice,46,328,175,153
16510,7106,Mohelnice,47,300,146,154
16511,7106,Mohelnice,48,252,123,129
16512,7106,Mohelnice,49,277,147,130
16513,7106,Mohelnice,50,261,126,135
16514,7106,Mohelnice,51,277,135,142
16515,7106,Mohelnice,52,238,134,104
16516,7106,Mohelnice,53,248,125,123
16517,7106,Mohelnice,54,254,125,129
16518,7106,Mohelnice,55,260,146,114
16519,7106,Mohelnice,56,226,130,96
16520,7106,Mohelnice,57,244,125,119
16521,7106,Mohelnice,58,231,121,110
16522,7106,Mohelnice,59,208,101,107
16523,7106,Mohelnice,60,204,88,116
16524,7106,Mohelnice,61,206,90,116
16525,7106,Mohelnice,62,206,94,112
16526,7106,Mohelnice,63,233,116,117
16527,7106,Mohelnice,64,234,114,120
16528,7106,Mohelnice,65,237,124,113
16529,7106,Mohelnice,66,236,120,116
16530,7106,Mohelnice,67,239,101,138
16531,7106,Mohelnice,68,238,104,134
16532,7106,Mohelnice,69,246,119,127
16533,7106,Mohelnice,70,225,95,130
16534,7106,Mohelnice,71,230,105,125
16535,7106,Mohelnice,72,249,104,145
16536,7106,Mohelnice,73,212,87,125
16537,7106,Mohelnice,74,195,89,106
16538,7106,Mohelnice,75,134,59,75
16539,7106,Mohelnice,76,158,64,94
16540,7106,Mohelnice,77,138,52,86
16541,7106,Mohelnice,78,138,56,82
16542,7106,Mohelnice,79,128,45,83
16543,7106,Mohelnice,80,110,38,72
16544,7106,Mohelnice,81,89,27,62
16545,7106,Mohelnice,82,73,28,45
16546,7106,Mohelnice,83,78,26,52
16547,7106,Mohelnice,84,63,17,46
16548,7106,Mohelnice,85,66,28,38
16549,7106,Mohelnice,86,54,19,35
16550,7106,Mohelnice,87,38,17,21
16551,7106,Mohelnice,88,46,10,36
16552,7106,Mohelnice,89,42,12,30
16553,7106,Mohelnice,90,19,6,13
16554,7106,Mohelnice,91,26,6,20
16555,7106,Mohelnice,92,22,9,13
16556,7106,Mohelnice,93,13,1,12
16557,7106,Mohelnice,94,9,1,8
16558,7106,Mohelnice,95,7,1,6
16559,7106,Mohelnice,96,2,0,2
16560,7106,Mohelnice,97,2,0,2
16561,7106,Mohelnice,98,1,1,0
16562,7106,Mohelnice,99,1,0,1
16563,7106,Mohelnice,100,2,1,1
16564,7107,Olomouc,0,1705,840,865
16565,7107,Olomouc,1,1816,910,906
16566,7107,Olomouc,2,1938,971,967
16567,7107,Olomouc,3,1917,998,919
16568,7107,Olomouc,4,1933,989,944
16569,7107,Olomouc,5,1862,973,889
16570,7107,Olomouc,6,1871,963,908
16571,7107,Olomouc,7,1836,938,898
16572,7107,Olomouc,8,1813,959,854
16573,7107,Olomouc,9,1880,956,924
16574,7107,Olomouc,10,1918,986,932
16575,7107,Olomouc,11,1946,948,998
16576,7107,Olomouc,12,1928,976,952
16577,7107,Olomouc,13,1827,916,911
16578,7107,Olomouc,14,1677,878,799
16579,7107,Olomouc,15,1611,830,781
16580,7107,Olomouc,16,1523,773,750
16581,7107,Olomouc,17,1443,744,699
16582,7107,Olomouc,18,1398,718,680
16583,7107,Olomouc,19,1471,738,733
16584,7107,Olomouc,20,1337,678,659
16585,7107,Olomouc,21,1442,721,721
16586,7107,Olomouc,22,1400,708,692
16587,7107,Olomouc,23,1420,727,693
16588,7107,Olomouc,24,1393,683,710
16589,7107,Olomouc,25,1472,751,721
16590,7107,Olomouc,26,1715,893,822
16591,7107,Olomouc,27,1908,949,959
16592,7107,Olomouc,28,2046,977,1069
16593,7107,Olomouc,29,2111,1067,1044
16594,7107,Olomouc,30,2180,1139,1041
16595,7107,Olomouc,31,2111,1015,1096
16596,7107,Olomouc,32,2283,1130,1153
16597,7107,Olomouc,33,2250,1111,1139
16598,7107,Olomouc,34,2259,1112,1147
16599,7107,Olomouc,35,2373,1183,1190
16600,7107,Olomouc,36,2325,1186,1139
16601,7107,Olomouc,37,2289,1140,1149
16602,7107,Olomouc,38,2441,1193,1248
16603,7107,Olomouc,39,2441,1220,1221
16604,7107,Olomouc,40,2573,1346,1227
16605,7107,Olomouc,41,2823,1441,1382
16606,7107,Olomouc,42,2927,1482,1445
16607,7107,Olomouc,43,2920,1501,1419
16608,7107,Olomouc,44,3074,1521,1553
16609,7107,Olomouc,45,2907,1462,1445
16610,7107,Olomouc,46,3016,1510,1506
16611,7107,Olomouc,47,2694,1390,1304
16612,7107,Olomouc,48,2449,1264,1185
16613,7107,Olomouc,49,2358,1195,1163
16614,7107,Olomouc,50,2115,1031,1084
16615,7107,Olomouc,51,2066,1015,1051
16616,7107,Olomouc,52,1914,949,965
16617,7107,Olomouc,53,1932,983,949
16618,7107,Olomouc,54,2019,1020,999
16619,7107,Olomouc,55,2158,1059,1099
16620,7107,Olomouc,56,2104,1067,1037
16621,7107,Olomouc,57,2201,1075,1126
16622,7107,Olomouc,58,1835,892,943
16623,7107,Olomouc,59,1825,888,937
16624,7107,Olomouc,60,1811,859,952
16625,7107,Olomouc,61,1844,922,922
16626,7107,Olomouc,62,1919,875,1044
16627,7107,Olomouc,63,2017,938,1079
16628,7107,Olomouc,64,2107,957,1150
16629,7107,Olomouc,65,2105,992,1113
16630,7107,Olomouc,66,2086,994,1092
16631,7107,Olomouc,67,2053,965,1088
16632,7107,Olomouc,68,1993,946,1047
16633,7107,Olomouc,69,2041,959,1082
16634,7107,Olomouc,70,1885,806,1079
16635,7107,Olomouc,71,1816,790,1026
16636,7107,Olomouc,72,1834,785,1049
16637,7107,Olomouc,73,1957,842,1115
16638,7107,Olomouc,74,1751,726,1025
16639,7107,Olomouc,75,1305,511,794
16640,7107,Olomouc,76,1430,574,856
16641,7107,Olomouc,77,1395,550,845
16642,7107,Olomouc,78,1214,472,742
16643,7107,Olomouc,79,1093,426,667
16644,7107,Olomouc,80,974,359,615
16645,7107,Olomouc,81,851,339,512
16646,7107,Olomouc,82,792,291,501
16647,7107,Olomouc,83,649,210,439
16648,7107,Olomouc,84,624,211,413
16649,7107,Olomouc,85,557,191,366
16650,7107,Olomouc,86,498,150,348
16651,7107,Olomouc,87,462,128,334
16652,7107,Olomouc,88,415,130,285
16653,7107,Olomouc,89,391,106,285
16654,7107,Olomouc,90,297,81,216
16655,7107,Olomouc,91,220,50,170
16656,7107,Olomouc,92,159,41,118
16657,7107,Olomouc,93,119,25,94
16658,7107,Olomouc,94,112,17,95
16659,7107,Olomouc,95,70,16,54
16660,7107,Olomouc,96,55,18,37
16661,7107,Olomouc,97,48,9,39
16662,7107,Olomouc,98,17,2,15
16663,7107,Olomouc,99,10,2,8
16664,7107,Olomouc,100,9,1,8
16665,7108,Prostějov,0,1030,547,483
16666,7108,Prostějov,1,1002,523,479
16667,7108,Prostějov,2,1012,515,497
16668,7108,Prostějov,3,1003,490,513
16669,7108,Prostějov,4,1023,521,502
16670,7108,Prostějov,5,1041,520,521
16671,7108,Prostějov,6,991,509,482
16672,7108,Prostějov,7,963,479,484
16673,7108,Prostějov,8,965,484,481
16674,7108,Prostějov,9,990,510,480
16675,7108,Prostějov,10,1074,528,546
16676,7108,Prostějov,11,1167,568,599
16677,7108,Prostějov,12,1180,635,545
16678,7108,Prostějov,13,1135,591,544
16679,7108,Prostějov,14,1035,536,499
16680,7108,Prostějov,15,970,478,492
16681,7108,Prostějov,16,983,494,489
16682,7108,Prostějov,17,948,476,472
16683,7108,Prostějov,18,890,441,449
16684,7108,Prostějov,19,895,463,432
16685,7108,Prostějov,20,873,455,418
16686,7108,Prostějov,21,871,425,446
16687,7108,Prostějov,22,873,476,397
16688,7108,Prostějov,23,898,436,462
16689,7108,Prostějov,24,843,424,419
16690,7108,Prostějov,25,929,457,472
16691,7108,Prostějov,26,1028,553,475
16692,7108,Prostějov,27,1148,595,553
16693,7108,Prostějov,28,1195,621,574
16694,7108,Prostějov,29,1206,625,581
16695,7108,Prostějov,30,1246,652,594
16696,7108,Prostějov,31,1222,645,577
16697,7108,Prostějov,32,1220,602,618
16698,7108,Prostějov,33,1220,617,603
16699,7108,Prostějov,34,1226,644,582
16700,7108,Prostějov,35,1242,645,597
16701,7108,Prostějov,36,1299,665,634
16702,7108,Prostějov,37,1294,653,641
16703,7108,Prostějov,38,1395,722,673
16704,7108,Prostějov,39,1443,695,748
16705,7108,Prostějov,40,1494,787,707
16706,7108,Prostějov,41,1569,823,746
16707,7108,Prostějov,42,1730,865,865
16708,7108,Prostějov,43,1703,829,874
16709,7108,Prostějov,44,1691,875,816
16710,7108,Prostějov,45,1774,898,876
16711,7108,Prostějov,46,1747,914,833
16712,7108,Prostějov,47,1707,864,843
16713,7108,Prostějov,48,1485,739,746
16714,7108,Prostějov,49,1332,695,637
16715,7108,Prostějov,50,1274,618,656
16716,7108,Prostějov,51,1308,653,655
16717,7108,Prostějov,52,1191,614,577
16718,7108,Prostějov,53,1192,566,626
16719,7108,Prostějov,54,1188,605,583
16720,7108,Prostějov,55,1335,695,640
16721,7108,Prostějov,56,1301,664,637
16722,7108,Prostějov,57,1239,623,616
16723,7108,Prostějov,58,1155,560,595
16724,7108,Prostějov,59,1199,588,611
16725,7108,Prostějov,60,1103,588,515
16726,7108,Prostějov,61,1132,545,587
16727,7108,Prostějov,62,1142,547,595
16728,7108,Prostějov,63,1235,579,656
16729,7108,Prostějov,64,1253,607,646
16730,7108,Prostějov,65,1310,623,687
16731,7108,Prostějov,66,1294,641,653
16732,7108,Prostějov,67,1274,591,683
16733,7108,Prostějov,68,1183,518,665
16734,7108,Prostějov,69,1209,537,672
16735,7108,Prostějov,70,1144,510,634
16736,7108,Prostějov,71,1164,494,670
16737,7108,Prostějov,72,1205,524,681
16738,7108,Prostějov,73,1058,458,600
16739,7108,Prostějov,74,1125,434,691
16740,7108,Prostějov,75,900,347,553
16741,7108,Prostějov,76,893,357,536
16742,7108,Prostějov,77,892,375,517
16743,7108,Prostějov,78,727,318,409
16744,7108,Prostějov,79,654,262,392
16745,7108,Prostějov,80,580,227,353
16746,7108,Prostějov,81,506,189,317
16747,7108,Prostějov,82,485,153,332
16748,7108,Prostějov,83,421,131,290
16749,7108,Prostějov,84,376,126,250
16750,7108,Prostějov,85,351,125,226
16751,7108,Prostějov,86,287,94,193
16752,7108,Prostějov,87,272,72,200
16753,7108,Prostějov,88,238,59,179
16754,7108,Prostějov,89,198,62,136
16755,7108,Prostějov,90,191,62,129
16756,7108,Prostějov,91,136,33,103
16757,7108,Prostějov,92,102,18,84
16758,7108,Prostějov,93,65,20,45
16759,7108,Prostějov,94,52,16,36
16760,7108,Prostějov,95,40,10,30
16761,7108,Prostějov,96,24,6,18
16762,7108,Prostějov,97,21,3,18
16763,7108,Prostějov,98,13,3,10
16764,7108,Prostějov,99,11,1,10
16765,7108,Prostějov,100,10,1,9
16766,7109,Přerov,0,775,403,372
16767,7109,Přerov,1,757,399,358
16768,7109,Přerov,2,758,392,366
16769,7109,Přerov,3,791,425,366
16770,7109,Přerov,4,792,428,364
16771,7109,Přerov,5,714,378,336
16772,7109,Přerov,6,692,346,346
16773,7109,Přerov,7,744,404,340
16774,7109,Přerov,8,721,371,350
16775,7109,Přerov,9,695,368,327
16776,7109,Přerov,10,876,457,419
16777,7109,Přerov,11,870,456,414
16778,7109,Přerov,12,886,452,434
16779,7109,Přerov,13,858,434,424
16780,7109,Přerov,14,796,377,419
16781,7109,Přerov,15,768,396,372
16782,7109,Přerov,16,695,349,346
16783,7109,Přerov,17,727,370,357
16784,7109,Přerov,18,738,393,345
16785,7109,Přerov,19,686,351,335
16786,7109,Přerov,20,681,350,331
16787,7109,Přerov,21,680,341,339
16788,7109,Přerov,22,712,384,328
16789,7109,Přerov,23,741,381,360
16790,7109,Přerov,24,750,390,360
16791,7109,Přerov,25,752,371,381
16792,7109,Přerov,26,861,439,422
16793,7109,Přerov,27,922,480,442
16794,7109,Přerov,28,939,521,418
16795,7109,Přerov,29,1017,500,517
16796,7109,Přerov,30,1009,526,483
16797,7109,Přerov,31,1014,552,462
16798,7109,Přerov,32,981,491,490
16799,7109,Přerov,33,979,493,486
16800,7109,Přerov,34,965,519,446
16801,7109,Přerov,35,986,516,470
16802,7109,Přerov,36,972,512,460
16803,7109,Přerov,37,1010,517,493
16804,7109,Přerov,38,1044,545,499
16805,7109,Přerov,39,1045,532,513
16806,7109,Přerov,40,1030,541,489
16807,7109,Přerov,41,1166,623,543
16808,7109,Přerov,42,1248,656,592
16809,7109,Přerov,43,1288,683,605
16810,7109,Přerov,44,1354,682,672
16811,7109,Přerov,45,1396,700,696
16812,7109,Přerov,46,1383,715,668
16813,7109,Přerov,47,1312,684,628
16814,7109,Přerov,48,1258,680,578
16815,7109,Přerov,49,1211,598,613
16816,7109,Přerov,50,1135,555,580
16817,7109,Přerov,51,1151,586,565
16818,7109,Přerov,52,1102,592,510
16819,7109,Přerov,53,1122,568,554
16820,7109,Přerov,54,1114,559,555
16821,7109,Přerov,55,1094,552,542
16822,7109,Přerov,56,1128,575,553
16823,7109,Přerov,57,1087,542,545
16824,7109,Přerov,58,989,485,504
16825,7109,Přerov,59,1003,502,501
16826,7109,Přerov,60,1030,532,498
16827,7109,Přerov,61,935,464,471
16828,7109,Přerov,62,1058,494,564
16829,7109,Přerov,63,1035,503,532
16830,7109,Přerov,64,1050,516,534
16831,7109,Přerov,65,1075,534,541
16832,7109,Přerov,66,1054,489,565
16833,7109,Přerov,67,1033,472,561
16834,7109,Přerov,68,996,454,542
16835,7109,Přerov,69,1028,471,557
16836,7109,Přerov,70,959,431,528
16837,7109,Přerov,71,913,405,508
16838,7109,Přerov,72,966,405,561
16839,7109,Přerov,73,1022,410,612
16840,7109,Přerov,74,1000,402,598
16841,7109,Přerov,75,808,304,504
16842,7109,Přerov,76,812,333,479
16843,7109,Přerov,77,724,299,425
16844,7109,Přerov,78,662,265,397
16845,7109,Přerov,79,592,236,356
16846,7109,Přerov,80,541,189,352
16847,7109,Přerov,81,478,176,302
16848,7109,Přerov,82,494,179,315
16849,7109,Přerov,83,402,153,249
16850,7109,Přerov,84,349,122,227
16851,7109,Přerov,85,311,110,201
16852,7109,Přerov,86,289,102,187
16853,7109,Přerov,87,265,85,180
16854,7109,Přerov,88,195,69,126
16855,7109,Přerov,89,179,52,127
16856,7109,Přerov,90,135,31,104
16857,7109,Přerov,91,105,29,76
16858,7109,Přerov,92,77,23,54
16859,7109,Přerov,93,78,20,58
16860,7109,Přerov,94,51,9,42
16861,7109,Přerov,95,32,2,30
16862,7109,Přerov,96,17,5,12
16863,7109,Přerov,97,9,1,8
16864,7109,Přerov,98,7,1,6
16865,7109,Přerov,99,5,0,5
16866,7109,Přerov,100,6,2,4
16867,7110,Šternberk,0,265,132,133
16868,7110,Šternberk,1,253,133,120
16869,7110,Šternberk,2,258,127,131
16870,7110,Šternberk,3,266,126,140
16871,7110,Šternberk,4,259,121,138
16872,7110,Šternberk,5,261,116,145
16873,7110,Šternberk,6,254,128,126
16874,7110,Šternberk,7,249,133,116
16875,7110,Šternberk,8,240,126,114
16876,7110,Šternberk,9,235,122,113
16877,7110,Šternberk,10,255,124,131
16878,7110,Šternberk,11,291,152,139
16879,7110,Šternberk,12,267,148,119
16880,7110,Šternberk,13,289,151,138
16881,7110,Šternberk,14,275,143,132
16882,7110,Šternberk,15,232,126,106
16883,7110,Šternberk,16,201,101,100
16884,7110,Šternberk,17,252,128,124
16885,7110,Šternberk,18,239,124,115
16886,7110,Šternberk,19,229,121,108
16887,7110,Šternberk,20,211,119,92
16888,7110,Šternberk,21,224,112,112
16889,7110,Šternberk,22,211,103,108
16890,7110,Šternberk,23,209,111,98
16891,7110,Šternberk,24,209,109,100
16892,7110,Šternberk,25,232,115,117
16893,7110,Šternberk,26,285,132,153
16894,7110,Šternberk,27,310,156,154
16895,7110,Šternberk,28,288,130,158
16896,7110,Šternberk,29,332,170,162
16897,7110,Šternberk,30,320,173,147
16898,7110,Šternberk,31,325,171,154
16899,7110,Šternberk,32,321,156,165
16900,7110,Šternberk,33,317,174,143
16901,7110,Šternberk,34,302,152,150
16902,7110,Šternberk,35,317,180,137
16903,7110,Šternberk,36,306,162,144
16904,7110,Šternberk,37,290,158,132
16905,7110,Šternberk,38,311,174,137
16906,7110,Šternberk,39,333,158,175
16907,7110,Šternberk,40,373,181,192
16908,7110,Šternberk,41,395,214,181
16909,7110,Šternberk,42,366,213,153
16910,7110,Šternberk,43,392,212,180
16911,7110,Šternberk,44,439,224,215
16912,7110,Šternberk,45,483,239,244
16913,7110,Šternberk,46,444,236,208
16914,7110,Šternberk,47,414,209,205
16915,7110,Šternberk,48,375,195,180
16916,7110,Šternberk,49,335,164,171
16917,7110,Šternberk,50,325,169,156
16918,7110,Šternberk,51,290,166,124
16919,7110,Šternberk,52,322,161,161
16920,7110,Šternberk,53,298,161,137
16921,7110,Šternberk,54,308,165,143
16922,7110,Šternberk,55,283,138,145
16923,7110,Šternberk,56,309,146,163
16924,7110,Šternberk,57,314,155,159
16925,7110,Šternberk,58,266,128,138
16926,7110,Šternberk,59,276,125,151
16927,7110,Šternberk,60,282,157,125
16928,7110,Šternberk,61,286,141,145
16929,7110,Šternberk,62,274,122,152
16930,7110,Šternberk,63,309,166,143
16931,7110,Šternberk,64,310,142,168
16932,7110,Šternberk,65,319,154,165
16933,7110,Šternberk,66,341,159,182
16934,7110,Šternberk,67,304,139,165
16935,7110,Šternberk,68,313,134,179
16936,7110,Šternberk,69,308,136,172
16937,7110,Šternberk,70,304,151,153
16938,7110,Šternberk,71,298,141,157
16939,7110,Šternberk,72,296,130,166
16940,7110,Šternberk,73,306,122,184
16941,7110,Šternberk,74,247,119,128
16942,7110,Šternberk,75,194,78,116
16943,7110,Šternberk,76,210,78,132
16944,7110,Šternberk,77,164,56,108
16945,7110,Šternberk,78,174,69,105
16946,7110,Šternberk,79,142,50,92
16947,7110,Šternberk,80,144,67,77
16948,7110,Šternberk,81,106,42,64
16949,7110,Šternberk,82,99,39,60
16950,7110,Šternberk,83,106,41,65
16951,7110,Šternberk,84,68,19,49
16952,7110,Šternberk,85,83,23,60
16953,7110,Šternberk,86,80,26,54
16954,7110,Šternberk,87,63,18,45
16955,7110,Šternberk,88,56,14,42
16956,7110,Šternberk,89,39,12,27
16957,7110,Šternberk,90,39,11,28
16958,7110,Šternberk,91,31,9,22
16959,7110,Šternberk,92,20,5,15
16960,7110,Šternberk,93,15,3,12
16961,7110,Šternberk,94,10,1,9
16962,7110,Šternberk,95,6,1,5
16963,7110,Šternberk,96,3,0,3
16964,7110,Šternberk,97,4,0,4
16965,7110,Šternberk,98,2,0,2
16966,7110,Šternberk,99,1,0,1
16967,7110,Šternberk,100,1,0,1
16968,7111,Šumperk,0,652,335,317
16969,7111,Šumperk,1,639,345,294
16970,7111,Šumperk,2,664,338,326
16971,7111,Šumperk,3,687,337,350
16972,7111,Šumperk,4,655,333,322
16973,7111,Šumperk,5,721,366,355
16974,7111,Šumperk,6,624,328,296
16975,7111,Šumperk,7,702,342,360
16976,7111,Šumperk,8,643,329,314
16977,7111,Šumperk,9,631,318,313
16978,7111,Šumperk,10,757,383,374
16979,7111,Šumperk,11,822,424,398
16980,7111,Šumperk,12,780,376,404
16981,7111,Šumperk,13,788,398,390
16982,7111,Šumperk,14,728,392,336
16983,7111,Šumperk,15,677,359,318
16984,7111,Šumperk,16,689,348,341
16985,7111,Šumperk,17,659,344,315
16986,7111,Šumperk,18,620,313,307
16987,7111,Šumperk,19,650,333,317
16988,7111,Šumperk,20,613,348,265
16989,7111,Šumperk,21,596,322,274
16990,7111,Šumperk,22,685,369,316
16991,7111,Šumperk,23,650,353,297
16992,7111,Šumperk,24,652,340,312
16993,7111,Šumperk,25,632,315,317
16994,7111,Šumperk,26,772,377,395
16995,7111,Šumperk,27,796,400,396
16996,7111,Šumperk,28,799,407,392
16997,7111,Šumperk,29,835,467,368
16998,7111,Šumperk,30,879,453,426
16999,7111,Šumperk,31,796,429,367
17000,7111,Šumperk,32,843,420,423
17001,7111,Šumperk,33,749,407,342
17002,7111,Šumperk,34,843,430,413
17003,7111,Šumperk,35,785,415,370
17004,7111,Šumperk,36,779,405,374
17005,7111,Šumperk,37,793,395,398
17006,7111,Šumperk,38,841,468,373
17007,7111,Šumperk,39,873,449,424
17008,7111,Šumperk,40,901,472,429
17009,7111,Šumperk,41,1039,553,486
17010,7111,Šumperk,42,1056,554,502
17011,7111,Šumperk,43,1153,559,594
17012,7111,Šumperk,44,1261,636,625
17013,7111,Šumperk,45,1261,671,590
17014,7111,Šumperk,46,1269,649,620
17015,7111,Šumperk,47,1181,594,587
17016,7111,Šumperk,48,1098,575,523
17017,7111,Šumperk,49,948,469,479
17018,7111,Šumperk,50,936,455,481
17019,7111,Šumperk,51,914,461,453
17020,7111,Šumperk,52,848,450,398
17021,7111,Šumperk,53,872,440,432
17022,7111,Šumperk,54,872,429,443
17023,7111,Šumperk,55,842,433,409
17024,7111,Šumperk,56,888,443,445
17025,7111,Šumperk,57,851,424,427
17026,7111,Šumperk,58,790,389,401
17027,7111,Šumperk,59,799,394,405
17028,7111,Šumperk,60,855,460,395
17029,7111,Šumperk,61,781,374,407
17030,7111,Šumperk,62,907,447,460
17031,7111,Šumperk,63,900,437,463
17032,7111,Šumperk,64,966,447,519
17033,7111,Šumperk,65,955,415,540
17034,7111,Šumperk,66,955,470,485
17035,7111,Šumperk,67,955,421,534
17036,7111,Šumperk,68,956,443,513
17037,7111,Šumperk,69,1007,461,546
17038,7111,Šumperk,70,985,441,544
17039,7111,Šumperk,71,983,438,545
17040,7111,Šumperk,72,948,426,522
17041,7111,Šumperk,73,936,399,537
17042,7111,Šumperk,74,767,327,440
17043,7111,Šumperk,75,587,246,341
17044,7111,Šumperk,76,589,271,318
17045,7111,Šumperk,77,577,201,376
17046,7111,Šumperk,78,506,197,309
17047,7111,Šumperk,79,476,168,308
17048,7111,Šumperk,80,460,187,273
17049,7111,Šumperk,81,395,164,231
17050,7111,Šumperk,82,363,132,231
17051,7111,Šumperk,83,297,104,193
17052,7111,Šumperk,84,259,93,166
17053,7111,Šumperk,85,231,77,154
17054,7111,Šumperk,86,209,71,138
17055,7111,Šumperk,87,172,51,121
17056,7111,Šumperk,88,187,56,131
17057,7111,Šumperk,89,142,38,104
17058,7111,Šumperk,90,131,29,102
17059,7111,Šumperk,91,79,25,54
17060,7111,Šumperk,92,63,15,48
17061,7111,Šumperk,93,46,12,34
17062,7111,Šumperk,94,43,8,35
17063,7111,Šumperk,95,15,4,11
17064,7111,Šumperk,96,22,3,19
17065,7111,Šumperk,97,12,1,11
17066,7111,Šumperk,98,9,3,6
17067,7111,Šumperk,99,3,1,2
17068,7111,Šumperk,100,6,0,6
17069,7112,Uničov,0,246,125,121
17070,7112,Uničov,1,220,97,123
17071,7112,Uničov,2,237,123,114
17072,7112,Uničov,3,205,101,104
17073,7112,Uničov,4,217,111,106
17074,7112,Uničov,5,206,117,89
17075,7112,Uničov,6,214,104,110
17076,7112,Uničov,7,214,114,100
17077,7112,Uničov,8,190,93,97
17078,7112,Uničov,9,217,122,95
17079,7112,Uničov,10,233,119,114
17080,7112,Uničov,11,221,117,104
17081,7112,Uničov,12,289,151,138
17082,7112,Uničov,13,235,131,104
17083,7112,Uničov,14,233,122,111
17084,7112,Uničov,15,203,114,89
17085,7112,Uničov,16,210,106,104
17086,7112,Uničov,17,220,107,113
17087,7112,Uničov,18,214,112,102
17088,7112,Uničov,19,204,96,108
17089,7112,Uničov,20,202,92,110
17090,7112,Uničov,21,192,106,86
17091,7112,Uničov,22,197,95,102
17092,7112,Uničov,23,212,110,102
17093,7112,Uničov,24,225,105,120
17094,7112,Uničov,25,243,144,99
17095,7112,Uničov,26,246,133,113
17096,7112,Uničov,27,266,157,109
17097,7112,Uničov,28,306,148,158
17098,7112,Uničov,29,328,157,171
17099,7112,Uničov,30,313,170,143
17100,7112,Uničov,31,297,147,150
17101,7112,Uničov,32,296,159,137
17102,7112,Uničov,33,272,144,128
17103,7112,Uničov,34,269,136,133
17104,7112,Uničov,35,295,155,140
17105,7112,Uničov,36,283,148,135
17106,7112,Uničov,37,302,165,137
17107,7112,Uničov,38,299,158,141
17108,7112,Uničov,39,327,176,151
17109,7112,Uničov,40,329,162,167
17110,7112,Uničov,41,322,172,150
17111,7112,Uničov,42,358,191,167
17112,7112,Uničov,43,368,184,184
17113,7112,Uničov,44,378,203,175
17114,7112,Uničov,45,396,214,182
17115,7112,Uničov,46,394,202,192
17116,7112,Uničov,47,342,176,166
17117,7112,Uničov,48,332,185,147
17118,7112,Uničov,49,350,172,178
17119,7112,Uničov,50,291,147,144
17120,7112,Uničov,51,303,139,164
17121,7112,Uničov,52,286,148,138
17122,7112,Uničov,53,289,153,136
17123,7112,Uničov,54,297,138,159
17124,7112,Uničov,55,286,155,131
17125,7112,Uničov,56,323,171,152
17126,7112,Uničov,57,274,141,133
17127,7112,Uničov,58,280,139,141
17128,7112,Uničov,59,277,132,145
17129,7112,Uničov,60,276,139,137
17130,7112,Uničov,61,292,139,153
17131,7112,Uničov,62,302,149,153
17132,7112,Uničov,63,294,159,135
17133,7112,Uničov,64,316,145,171
17134,7112,Uničov,65,302,139,163
17135,7112,Uničov,66,288,125,163
17136,7112,Uničov,67,295,131,164
17137,7112,Uničov,68,275,120,155
17138,7112,Uničov,69,286,143,143
17139,7112,Uničov,70,278,123,155
17140,7112,Uničov,71,261,126,135
17141,7112,Uničov,72,267,111,156
17142,7112,Uničov,73,255,119,136
17143,7112,Uničov,74,248,101,147
17144,7112,Uničov,75,170,59,111
17145,7112,Uničov,76,181,78,103
17146,7112,Uničov,77,177,68,109
17147,7112,Uničov,78,151,55,96
17148,7112,Uničov,79,157,54,103
17149,7112,Uničov,80,154,56,98
17150,7112,Uničov,81,131,55,76
17151,7112,Uničov,82,103,34,69
17152,7112,Uničov,83,87,32,55
17153,7112,Uničov,84,91,30,61
17154,7112,Uničov,85,75,27,48
17155,7112,Uničov,86,88,31,57
17156,7112,Uničov,87,62,11,51
17157,7112,Uničov,88,52,16,36
17158,7112,Uničov,89,54,20,34
17159,7112,Uničov,90,37,16,21
17160,7112,Uničov,91,17,5,12
17161,7112,Uničov,92,23,6,17
17162,7112,Uničov,93,11,3,8
17163,7112,Uničov,94,4,3,1
17164,7112,Uničov,95,6,1,5
17165,7112,Uničov,96,4,1,3
17166,7112,Uničov,97,7,2,5
17167,7112,Uničov,98,3,0,3
17168,7112,Uničov,99,2,1,1
17169,7112,Uničov,100,1,1,0
17170,7113,Zábřeh,0,394,193,201
17171,7113,Zábřeh,1,334,172,162
17172,7113,Zábřeh,2,363,174,189
17173,7113,Zábřeh,3,358,184,174
17174,7113,Zábřeh,4,336,197,139
17175,7113,Zábřeh,5,370,195,175
17176,7113,Zábřeh,6,327,164,163
17177,7113,Zábřeh,7,304,144,160
17178,7113,Zábřeh,8,344,179,165
17179,7113,Zábřeh,9,287,145,142
17180,7113,Zábřeh,10,374,197,177
17181,7113,Zábřeh,11,378,197,181
17182,7113,Zábřeh,12,400,191,209
17183,7113,Zábřeh,13,378,185,193
17184,7113,Zábřeh,14,327,157,170
17185,7113,Zábřeh,15,313,164,149
17186,7113,Zábřeh,16,295,132,163
17187,7113,Zábřeh,17,333,169,164
17188,7113,Zábřeh,18,301,149,152
17189,7113,Zábřeh,19,290,151,139
17190,7113,Zábřeh,20,283,149,134
17191,7113,Zábřeh,21,277,148,129
17192,7113,Zábřeh,22,322,165,157
17193,7113,Zábřeh,23,300,151,149
17194,7113,Zábřeh,24,338,168,170
17195,7113,Zábřeh,25,357,173,184
17196,7113,Zábřeh,26,395,206,189
17197,7113,Zábřeh,27,417,211,206
17198,7113,Zábřeh,28,387,192,195
17199,7113,Zábřeh,29,470,235,235
17200,7113,Zábřeh,30,460,228,232
17201,7113,Zábřeh,31,435,222,213
17202,7113,Zábřeh,32,419,214,205
17203,7113,Zábřeh,33,464,221,243
17204,7113,Zábřeh,34,399,210,189
17205,7113,Zábřeh,35,437,237,200
17206,7113,Zábřeh,36,407,208,199
17207,7113,Zábřeh,37,400,217,183
17208,7113,Zábřeh,38,375,197,178
17209,7113,Zábřeh,39,422,217,205
17210,7113,Zábřeh,40,462,250,212
17211,7113,Zábřeh,41,472,245,227
17212,7113,Zábřeh,42,541,299,242
17213,7113,Zábřeh,43,547,305,242
17214,7113,Zábřeh,44,543,269,274
17215,7113,Zábřeh,45,598,299,299
17216,7113,Zábřeh,46,556,293,263
17217,7113,Zábřeh,47,525,265,260
17218,7113,Zábřeh,48,489,257,232
17219,7113,Zábřeh,49,422,214,208
17220,7113,Zábřeh,50,444,215,229
17221,7113,Zábřeh,51,406,191,215
17222,7113,Zábřeh,52,425,185,240
17223,7113,Zábřeh,53,383,180,203
17224,7113,Zábřeh,54,403,210,193
17225,7113,Zábřeh,55,425,214,211
17226,7113,Zábřeh,56,473,243,230
17227,7113,Zábřeh,57,482,234,248
17228,7113,Zábřeh,58,402,211,191
17229,7113,Zábřeh,59,421,202,219
17230,7113,Zábřeh,60,419,218,201
17231,7113,Zábřeh,61,403,212,191
17232,7113,Zábřeh,62,372,180,192
17233,7113,Zábřeh,63,422,194,228
17234,7113,Zábřeh,64,454,227,227
17235,7113,Zábřeh,65,449,216,233
17236,7113,Zábřeh,66,440,202,238
17237,7113,Zábřeh,67,447,209,238
17238,7113,Zábřeh,68,445,197,248
17239,7113,Zábřeh,69,432,214,218
17240,7113,Zábřeh,70,463,226,237
17241,7113,Zábřeh,71,399,193,206
17242,7113,Zábřeh,72,415,190,225
17243,7113,Zábřeh,73,424,190,234
17244,7113,Zábřeh,74,406,186,220
17245,7113,Zábřeh,75,237,110,127
17246,7113,Zábřeh,76,264,112,152
17247,7113,Zábřeh,77,264,91,173
17248,7113,Zábřeh,78,245,96,149
17249,7113,Zábřeh,79,241,89,152
17250,7113,Zábřeh,80,238,80,158
17251,7113,Zábřeh,81,184,69,115
17252,7113,Zábřeh,82,150,54,96
17253,7113,Zábřeh,83,124,48,76
17254,7113,Zábřeh,84,120,51,69
17255,7113,Zábřeh,85,107,30,77
17256,7113,Zábřeh,86,90,29,61
17257,7113,Zábřeh,87,79,21,58
17258,7113,Zábřeh,88,69,15,54
17259,7113,Zábřeh,89,76,24,52
17260,7113,Zábřeh,90,55,15,40
17261,7113,Zábřeh,91,27,10,17
17262,7113,Zábřeh,92,27,5,22
17263,7113,Zábřeh,93,28,7,21
17264,7113,Zábřeh,94,14,2,12
17265,7113,Zábřeh,95,8,3,5
17266,7113,Zábřeh,96,15,3,12
17267,7113,Zábřeh,97,5,1,4
17268,7113,Zábřeh,98,2,1,1
17269,7113,Zábřeh,99,1,0,1
17270,7113,Zábřeh,100,2,0,2
17271,7201,Bystřice pod Hostýnem,0,167,82,85
17272,7201,Bystřice pod Hostýnem,1,147,76,71
17273,7201,Bystřice pod Hostýnem,2,154,71,83
17274,7201,Bystřice pod Hostýnem,3,149,78,71
17275,7201,Bystřice pod Hostýnem,4,144,69,75
17276,7201,Bystřice pod Hostýnem,5,130,61,69
17277,7201,Bystřice pod Hostýnem,6,149,77,72
17278,7201,Bystřice pod Hostýnem,7,144,75,69
17279,7201,Bystřice pod Hostýnem,8,137,72,65
17280,7201,Bystřice pod Hostýnem,9,151,78,73
17281,7201,Bystřice pod Hostýnem,10,142,73,69
17282,7201,Bystřice pod Hostýnem,11,147,68,79
17283,7201,Bystřice pod Hostýnem,12,182,101,81
17284,7201,Bystřice pod Hostýnem,13,145,77,68
17285,7201,Bystřice pod Hostýnem,14,135,77,58
17286,7201,Bystřice pod Hostýnem,15,142,69,73
17287,7201,Bystřice pod Hostýnem,16,157,74,83
17288,7201,Bystřice pod Hostýnem,17,111,70,41
17289,7201,Bystřice pod Hostýnem,18,117,56,61
17290,7201,Bystřice pod Hostýnem,19,152,78,74
17291,7201,Bystřice pod Hostýnem,20,117,66,51
17292,7201,Bystřice pod Hostýnem,21,173,84,89
17293,7201,Bystřice pod Hostýnem,22,129,58,71
17294,7201,Bystřice pod Hostýnem,23,127,73,54
17295,7201,Bystřice pod Hostýnem,24,136,68,68
17296,7201,Bystřice pod Hostýnem,25,163,77,86
17297,7201,Bystřice pod Hostýnem,26,154,91,63
17298,7201,Bystřice pod Hostýnem,27,188,98,90
17299,7201,Bystřice pod Hostýnem,28,203,109,94
17300,7201,Bystřice pod Hostýnem,29,205,121,84
17301,7201,Bystřice pod Hostýnem,30,201,113,88
17302,7201,Bystřice pod Hostýnem,31,181,90,91
17303,7201,Bystřice pod Hostýnem,32,199,96,103
17304,7201,Bystřice pod Hostýnem,33,178,103,75
17305,7201,Bystřice pod Hostýnem,34,182,99,83
17306,7201,Bystřice pod Hostýnem,35,198,98,100
17307,7201,Bystřice pod Hostýnem,36,185,103,82
17308,7201,Bystřice pod Hostýnem,37,189,98,91
17309,7201,Bystřice pod Hostýnem,38,190,104,86
17310,7201,Bystřice pod Hostýnem,39,198,101,97
17311,7201,Bystřice pod Hostýnem,40,205,99,106
17312,7201,Bystřice pod Hostýnem,41,225,114,111
17313,7201,Bystřice pod Hostýnem,42,212,112,100
17314,7201,Bystřice pod Hostýnem,43,245,132,113
17315,7201,Bystřice pod Hostýnem,44,242,124,118
17316,7201,Bystřice pod Hostýnem,45,274,143,131
17317,7201,Bystřice pod Hostýnem,46,268,145,123
17318,7201,Bystřice pod Hostýnem,47,287,150,137
17319,7201,Bystřice pod Hostýnem,48,251,123,128
17320,7201,Bystřice pod Hostýnem,49,235,117,118
17321,7201,Bystřice pod Hostýnem,50,220,117,103
17322,7201,Bystřice pod Hostýnem,51,209,114,95
17323,7201,Bystřice pod Hostýnem,52,198,99,99
17324,7201,Bystřice pod Hostýnem,53,223,118,105
17325,7201,Bystřice pod Hostýnem,54,199,96,103
17326,7201,Bystřice pod Hostýnem,55,185,101,84
17327,7201,Bystřice pod Hostýnem,56,212,101,111
17328,7201,Bystřice pod Hostýnem,57,203,93,110
17329,7201,Bystřice pod Hostýnem,58,211,108,103
17330,7201,Bystřice pod Hostýnem,59,208,101,107
17331,7201,Bystřice pod Hostýnem,60,178,85,93
17332,7201,Bystřice pod Hostýnem,61,204,108,96
17333,7201,Bystřice pod Hostýnem,62,191,98,93
17334,7201,Bystřice pod Hostýnem,63,189,97,92
17335,7201,Bystřice pod Hostýnem,64,202,105,97
17336,7201,Bystřice pod Hostýnem,65,219,99,120
17337,7201,Bystřice pod Hostýnem,66,224,100,124
17338,7201,Bystřice pod Hostýnem,67,214,108,106
17339,7201,Bystřice pod Hostýnem,68,204,99,105
17340,7201,Bystřice pod Hostýnem,69,189,80,109
17341,7201,Bystřice pod Hostýnem,70,202,86,116
17342,7201,Bystřice pod Hostýnem,71,188,92,96
17343,7201,Bystřice pod Hostýnem,72,184,80,104
17344,7201,Bystřice pod Hostýnem,73,201,83,118
17345,7201,Bystřice pod Hostýnem,74,172,74,98
17346,7201,Bystřice pod Hostýnem,75,140,60,80
17347,7201,Bystřice pod Hostýnem,76,135,49,86
17348,7201,Bystřice pod Hostýnem,77,122,41,81
17349,7201,Bystřice pod Hostýnem,78,124,53,71
17350,7201,Bystřice pod Hostýnem,79,101,54,47
17351,7201,Bystřice pod Hostýnem,80,116,43,73
17352,7201,Bystřice pod Hostýnem,81,100,29,71
17353,7201,Bystřice pod Hostýnem,82,84,25,59
17354,7201,Bystřice pod Hostýnem,83,70,23,47
17355,7201,Bystřice pod Hostýnem,84,52,17,35
17356,7201,Bystřice pod Hostýnem,85,46,15,31
17357,7201,Bystřice pod Hostýnem,86,47,12,35
17358,7201,Bystřice pod Hostýnem,87,46,9,37
17359,7201,Bystřice pod Hostýnem,88,34,9,25
17360,7201,Bystřice pod Hostýnem,89,35,9,26
17361,7201,Bystřice pod Hostýnem,90,32,5,27
17362,7201,Bystřice pod Hostýnem,91,18,4,14
17363,7201,Bystřice pod Hostýnem,92,16,3,13
17364,7201,Bystřice pod Hostýnem,93,13,2,11
17365,7201,Bystřice pod Hostýnem,94,5,0,5
17366,7201,Bystřice pod Hostýnem,95,7,0,7
17367,7201,Bystřice pod Hostýnem,96,2,0,2
17368,7201,Bystřice pod Hostýnem,97,4,1,3
17369,7201,Bystřice pod Hostýnem,98,3,0,3
17370,7201,Bystřice pod Hostýnem,99,2,0,2
17371,7201,Bystřice pod Hostýnem,100,0,0,0
17372,7202,Holešov,0,215,104,111
17373,7202,Holešov,1,198,100,98
17374,7202,Holešov,2,246,127,119
17375,7202,Holešov,3,229,125,104
17376,7202,Holešov,4,228,118,110
17377,7202,Holešov,5,199,93,106
17378,7202,Holešov,6,212,112,100
17379,7202,Holešov,7,220,109,111
17380,7202,Holešov,8,207,97,110
17381,7202,Holešov,9,201,91,110
17382,7202,Holešov,10,228,112,116
17383,7202,Holešov,11,231,117,114
17384,7202,Holešov,12,262,139,123
17385,7202,Holešov,13,249,122,127
17386,7202,Holešov,14,213,104,109
17387,7202,Holešov,15,230,120,110
17388,7202,Holešov,16,196,105,91
17389,7202,Holešov,17,196,99,97
17390,7202,Holešov,18,213,106,107
17391,7202,Holešov,19,204,98,106
17392,7202,Holešov,20,192,94,98
17393,7202,Holešov,21,213,103,110
17394,7202,Holešov,22,199,97,102
17395,7202,Holešov,23,209,124,85
17396,7202,Holešov,24,193,95,98
17397,7202,Holešov,25,209,109,100
17398,7202,Holešov,26,233,111,122
17399,7202,Holešov,27,246,133,113
17400,7202,Holešov,28,240,120,120
17401,7202,Holešov,29,287,147,140
17402,7202,Holešov,30,272,146,126
17403,7202,Holešov,31,265,110,155
17404,7202,Holešov,32,274,147,127
17405,7202,Holešov,33,284,142,142
17406,7202,Holešov,34,270,137,133
17407,7202,Holešov,35,285,151,134
17408,7202,Holešov,36,286,155,131
17409,7202,Holešov,37,294,165,129
17410,7202,Holešov,38,293,156,137
17411,7202,Holešov,39,331,184,147
17412,7202,Holešov,40,294,149,145
17413,7202,Holešov,41,354,181,173
17414,7202,Holešov,42,353,173,180
17415,7202,Holešov,43,358,185,173
17416,7202,Holešov,44,338,159,179
17417,7202,Holešov,45,381,189,192
17418,7202,Holešov,46,401,203,198
17419,7202,Holešov,47,349,195,154
17420,7202,Holešov,48,322,173,149
17421,7202,Holešov,49,285,143,142
17422,7202,Holešov,50,308,165,143
17423,7202,Holešov,51,284,150,134
17424,7202,Holešov,52,257,135,122
17425,7202,Holešov,53,234,117,117
17426,7202,Holešov,54,278,146,132
17427,7202,Holešov,55,270,130,140
17428,7202,Holešov,56,277,142,135
17429,7202,Holešov,57,269,130,139
17430,7202,Holešov,58,282,132,150
17431,7202,Holešov,59,307,154,153
17432,7202,Holešov,60,270,120,150
17433,7202,Holešov,61,278,142,136
17434,7202,Holešov,62,279,133,146
17435,7202,Holešov,63,303,138,165
17436,7202,Holešov,64,294,164,130
17437,7202,Holešov,65,302,156,146
17438,7202,Holešov,66,304,154,150
17439,7202,Holešov,67,264,115,149
17440,7202,Holešov,68,242,111,131
17441,7202,Holešov,69,271,128,143
17442,7202,Holešov,70,262,118,144
17443,7202,Holešov,71,250,112,138
17444,7202,Holešov,72,242,111,131
17445,7202,Holešov,73,243,105,138
17446,7202,Holešov,74,242,111,131
17447,7202,Holešov,75,186,80,106
17448,7202,Holešov,76,177,84,93
17449,7202,Holešov,77,179,72,107
17450,7202,Holešov,78,132,48,84
17451,7202,Holešov,79,142,43,99
17452,7202,Holešov,80,137,57,80
17453,7202,Holešov,81,121,44,77
17454,7202,Holešov,82,109,40,69
17455,7202,Holešov,83,98,34,64
17456,7202,Holešov,84,81,23,58
17457,7202,Holešov,85,70,17,53
17458,7202,Holešov,86,80,16,64
17459,7202,Holešov,87,58,28,30
17460,7202,Holešov,88,78,25,53
17461,7202,Holešov,89,41,6,35
17462,7202,Holešov,90,30,7,23
17463,7202,Holešov,91,41,10,31
17464,7202,Holešov,92,18,7,11
17465,7202,Holešov,93,17,5,12
17466,7202,Holešov,94,7,2,5
17467,7202,Holešov,95,7,1,6
17468,7202,Holešov,96,8,1,7
17469,7202,Holešov,97,2,1,1
17470,7202,Holešov,98,0,0,0
17471,7202,Holešov,99,0,0,0
17472,7202,Holešov,100,1,0,1
17473,7203,Kroměříž,0,694,356,338
17474,7203,Kroměříž,1,652,338,314
17475,7203,Kroměříž,2,718,361,357
17476,7203,Kroměříž,3,691,349,342
17477,7203,Kroměříž,4,721,363,358
17478,7203,Kroměříž,5,693,372,321
17479,7203,Kroměříž,6,656,331,325
17480,7203,Kroměříž,7,643,333,310
17481,7203,Kroměříž,8,657,366,291
17482,7203,Kroměříž,9,633,305,328
17483,7203,Kroměříž,10,749,387,362
17484,7203,Kroměříž,11,728,366,362
17485,7203,Kroměříž,12,726,371,355
17486,7203,Kroměříž,13,774,402,372
17487,7203,Kroměříž,14,689,361,328
17488,7203,Kroměříž,15,638,327,311
17489,7203,Kroměříž,16,641,320,321
17490,7203,Kroměříž,17,597,311,286
17491,7203,Kroměříž,18,603,305,298
17492,7203,Kroměříž,19,636,311,325
17493,7203,Kroměříž,20,583,313,270
17494,7203,Kroměříž,21,570,290,280
17495,7203,Kroměříž,22,607,320,287
17496,7203,Kroměříž,23,590,296,294
17497,7203,Kroměříž,24,626,312,314
17498,7203,Kroměříž,25,675,330,345
17499,7203,Kroměříž,26,741,390,351
17500,7203,Kroměříž,27,789,400,389
17501,7203,Kroměříž,28,863,446,417
17502,7203,Kroměříž,29,866,449,417
17503,7203,Kroměříž,30,833,458,375
17504,7203,Kroměříž,31,786,406,380
17505,7203,Kroměříž,32,851,450,401
17506,7203,Kroměříž,33,827,454,373
17507,7203,Kroměříž,34,882,445,437
17508,7203,Kroměříž,35,931,498,433
17509,7203,Kroměříž,36,883,457,426
17510,7203,Kroměříž,37,855,477,378
17511,7203,Kroměříž,38,885,464,421
17512,7203,Kroměříž,39,946,485,461
17513,7203,Kroměříž,40,960,500,460
17514,7203,Kroměříž,41,1066,566,500
17515,7203,Kroměříž,42,1082,525,557
17516,7203,Kroměříž,43,1181,592,589
17517,7203,Kroměříž,44,1134,600,534
17518,7203,Kroměříž,45,1174,582,592
17519,7203,Kroměříž,46,1204,626,578
17520,7203,Kroměříž,47,1143,561,582
17521,7203,Kroměříž,48,1031,551,480
17522,7203,Kroměříž,49,976,497,479
17523,7203,Kroměříž,50,944,460,484
17524,7203,Kroměříž,51,895,456,439
17525,7203,Kroměříž,52,868,418,450
17526,7203,Kroměříž,53,880,451,429
17527,7203,Kroměříž,54,856,435,421
17528,7203,Kroměříž,55,906,445,461
17529,7203,Kroměříž,56,983,500,483
17530,7203,Kroměříž,57,900,430,470
17531,7203,Kroměříž,58,825,397,428
17532,7203,Kroměříž,59,839,389,450
17533,7203,Kroměříž,60,851,435,416
17534,7203,Kroměříž,61,794,382,412
17535,7203,Kroměříž,62,872,429,443
17536,7203,Kroměříž,63,929,458,471
17537,7203,Kroměříž,64,924,478,446
17538,7203,Kroměříž,65,1004,484,520
17539,7203,Kroměříž,66,976,453,523
17540,7203,Kroměříž,67,971,441,530
17541,7203,Kroměříž,68,948,422,526
17542,7203,Kroměříž,69,944,383,561
17543,7203,Kroměříž,70,907,404,503
17544,7203,Kroměříž,71,876,382,494
17545,7203,Kroměříž,72,822,375,447
17546,7203,Kroměříž,73,795,365,430
17547,7203,Kroměříž,74,737,323,414
17548,7203,Kroměříž,75,614,246,368
17549,7203,Kroměříž,76,596,245,351
17550,7203,Kroměříž,77,535,202,333
17551,7203,Kroměříž,78,500,190,310
17552,7203,Kroměříž,79,439,159,280
17553,7203,Kroměříž,80,422,150,272
17554,7203,Kroměříž,81,338,110,228
17555,7203,Kroměříž,82,319,118,201
17556,7203,Kroměříž,83,299,96,203
17557,7203,Kroměříž,84,263,81,182
17558,7203,Kroměříž,85,220,60,160
17559,7203,Kroměříž,86,211,62,149
17560,7203,Kroměříž,87,203,55,148
17561,7203,Kroměříž,88,162,52,110
17562,7203,Kroměříž,89,145,28,117
17563,7203,Kroměříž,90,124,27,97
17564,7203,Kroměříž,91,83,17,66
17565,7203,Kroměříž,92,82,21,61
17566,7203,Kroměříž,93,54,12,42
17567,7203,Kroměříž,94,49,11,38
17568,7203,Kroměříž,95,27,9,18
17569,7203,Kroměříž,96,31,7,24
17570,7203,Kroměříž,97,19,5,14
17571,7203,Kroměříž,98,10,2,8
17572,7203,Kroměříž,99,5,1,4
17573,7203,Kroměříž,100,7,2,5
17574,7204,Luhačovice,0,203,104,99
17575,7204,Luhačovice,1,182,95,87
17576,7204,Luhačovice,2,199,97,102
17577,7204,Luhačovice,3,185,86,99
17578,7204,Luhačovice,4,179,97,82
17579,7204,Luhačovice,5,197,86,111
17580,7204,Luhačovice,6,150,77,73
17581,7204,Luhačovice,7,166,95,71
17582,7204,Luhačovice,8,160,68,92
17583,7204,Luhačovice,9,176,91,85
17584,7204,Luhačovice,10,214,111,103
17585,7204,Luhačovice,11,179,101,78
17586,7204,Luhačovice,12,191,103,88
17587,7204,Luhačovice,13,172,86,86
17588,7204,Luhačovice,14,174,77,97
17589,7204,Luhačovice,15,175,94,81
17590,7204,Luhačovice,16,159,87,72
17591,7204,Luhačovice,17,156,88,68
17592,7204,Luhačovice,18,161,85,76
17593,7204,Luhačovice,19,159,78,81
17594,7204,Luhačovice,20,191,95,96
17595,7204,Luhačovice,21,170,95,75
17596,7204,Luhačovice,22,142,76,66
17597,7204,Luhačovice,23,159,83,76
17598,7204,Luhačovice,24,146,76,70
17599,7204,Luhačovice,25,175,91,84
17600,7204,Luhačovice,26,177,99,78
17601,7204,Luhačovice,27,228,118,110
17602,7204,Luhačovice,28,249,129,120
17603,7204,Luhačovice,29,244,108,136
17604,7204,Luhačovice,30,260,135,125
17605,7204,Luhačovice,31,224,125,99
17606,7204,Luhačovice,32,249,139,110
17607,7204,Luhačovice,33,228,123,105
17608,7204,Luhačovice,34,264,134,130
17609,7204,Luhačovice,35,249,118,131
17610,7204,Luhačovice,36,240,140,100
17611,7204,Luhačovice,37,239,119,120
17612,7204,Luhačovice,38,244,131,113
17613,7204,Luhačovice,39,253,123,130
17614,7204,Luhačovice,40,272,131,141
17615,7204,Luhačovice,41,286,142,144
17616,7204,Luhačovice,42,325,167,158
17617,7204,Luhačovice,43,298,165,133
17618,7204,Luhačovice,44,299,160,139
17619,7204,Luhačovice,45,312,169,143
17620,7204,Luhačovice,46,300,152,148
17621,7204,Luhačovice,47,239,131,108
17622,7204,Luhačovice,48,282,146,136
17623,7204,Luhačovice,49,265,131,134
17624,7204,Luhačovice,50,228,106,122
17625,7204,Luhačovice,51,222,109,113
17626,7204,Luhačovice,52,218,119,99
17627,7204,Luhačovice,53,263,132,131
17628,7204,Luhačovice,54,242,132,110
17629,7204,Luhačovice,55,245,125,120
17630,7204,Luhačovice,56,247,110,137
17631,7204,Luhačovice,57,271,132,139
17632,7204,Luhačovice,58,273,134,139
17633,7204,Luhačovice,59,264,145,119
17634,7204,Luhačovice,60,262,132,130
17635,7204,Luhačovice,61,263,127,136
17636,7204,Luhačovice,62,253,125,128
17637,7204,Luhačovice,63,279,131,148
17638,7204,Luhačovice,64,291,153,138
17639,7204,Luhačovice,65,250,119,131
17640,7204,Luhačovice,66,258,118,140
17641,7204,Luhačovice,67,257,116,141
17642,7204,Luhačovice,68,270,115,155
17643,7204,Luhačovice,69,256,105,151
17644,7204,Luhačovice,70,225,112,113
17645,7204,Luhačovice,71,205,93,112
17646,7204,Luhačovice,72,215,101,114
17647,7204,Luhačovice,73,198,93,105
17648,7204,Luhačovice,74,176,63,113
17649,7204,Luhačovice,75,170,67,103
17650,7204,Luhačovice,76,176,86,90
17651,7204,Luhačovice,77,140,45,95
17652,7204,Luhačovice,78,130,44,86
17653,7204,Luhačovice,79,119,49,70
17654,7204,Luhačovice,80,129,51,78
17655,7204,Luhačovice,81,113,37,76
17656,7204,Luhačovice,82,105,35,70
17657,7204,Luhačovice,83,100,26,74
17658,7204,Luhačovice,84,84,32,52
17659,7204,Luhačovice,85,82,33,49
17660,7204,Luhačovice,86,73,24,49
17661,7204,Luhačovice,87,58,13,45
17662,7204,Luhačovice,88,55,16,39
17663,7204,Luhačovice,89,38,11,27
17664,7204,Luhačovice,90,33,10,23
17665,7204,Luhačovice,91,29,6,23
17666,7204,Luhačovice,92,15,2,13
17667,7204,Luhačovice,93,13,3,10
17668,7204,Luhačovice,94,10,1,9
17669,7204,Luhačovice,95,7,0,7
17670,7204,Luhačovice,96,4,1,3
17671,7204,Luhačovice,97,3,0,3
17672,7204,Luhačovice,98,0,0,0
17673,7204,Luhačovice,99,2,0,2
17674,7204,Luhačovice,100,2,1,1
17675,7205,Otrokovice,0,300,150,150
17676,7205,Otrokovice,1,283,152,131
17677,7205,Otrokovice,2,334,178,156
17678,7205,Otrokovice,3,320,174,146
17679,7205,Otrokovice,4,298,131,167
17680,7205,Otrokovice,5,298,162,136
17681,7205,Otrokovice,6,311,151,160
17682,7205,Otrokovice,7,315,163,152
17683,7205,Otrokovice,8,310,170,140
17684,7205,Otrokovice,9,310,154,156
17685,7205,Otrokovice,10,349,192,157
17686,7205,Otrokovice,11,348,177,171
17687,7205,Otrokovice,12,352,167,185
17688,7205,Otrokovice,13,379,204,175
17689,7205,Otrokovice,14,336,189,147
17690,7205,Otrokovice,15,352,191,161
17691,7205,Otrokovice,16,323,156,167
17692,7205,Otrokovice,17,317,160,157
17693,7205,Otrokovice,18,318,169,149
17694,7205,Otrokovice,19,334,169,165
17695,7205,Otrokovice,20,314,168,146
17696,7205,Otrokovice,21,286,146,140
17697,7205,Otrokovice,22,310,155,155
17698,7205,Otrokovice,23,293,152,141
17699,7205,Otrokovice,24,297,159,138
17700,7205,Otrokovice,25,324,159,165
17701,7205,Otrokovice,26,346,174,172
17702,7205,Otrokovice,27,401,223,178
17703,7205,Otrokovice,28,407,204,203
17704,7205,Otrokovice,29,397,220,177
17705,7205,Otrokovice,30,414,220,194
17706,7205,Otrokovice,31,429,253,176
17707,7205,Otrokovice,32,403,227,176
17708,7205,Otrokovice,33,427,220,207
17709,7205,Otrokovice,34,408,213,195
17710,7205,Otrokovice,35,424,228,196
17711,7205,Otrokovice,36,424,229,195
17712,7205,Otrokovice,37,431,231,200
17713,7205,Otrokovice,38,493,261,232
17714,7205,Otrokovice,39,497,248,249
17715,7205,Otrokovice,40,508,267,241
17716,7205,Otrokovice,41,529,281,248
17717,7205,Otrokovice,42,573,273,300
17718,7205,Otrokovice,43,638,331,307
17719,7205,Otrokovice,44,653,337,316
17720,7205,Otrokovice,45,627,343,284
17721,7205,Otrokovice,46,661,323,338
17722,7205,Otrokovice,47,624,332,292
17723,7205,Otrokovice,48,554,307,247
17724,7205,Otrokovice,49,485,254,231
17725,7205,Otrokovice,50,536,276,260
17726,7205,Otrokovice,51,468,238,230
17727,7205,Otrokovice,52,446,221,225
17728,7205,Otrokovice,53,420,221,199
17729,7205,Otrokovice,54,390,202,188
17730,7205,Otrokovice,55,426,222,204
17731,7205,Otrokovice,56,480,249,231
17732,7205,Otrokovice,57,419,234,185
17733,7205,Otrokovice,58,401,192,209
17734,7205,Otrokovice,59,401,179,222
17735,7205,Otrokovice,60,384,191,193
17736,7205,Otrokovice,61,385,184,201
17737,7205,Otrokovice,62,419,191,228
17738,7205,Otrokovice,63,438,206,232
17739,7205,Otrokovice,64,479,216,263
17740,7205,Otrokovice,65,452,202,250
17741,7205,Otrokovice,66,481,232,249
17742,7205,Otrokovice,67,523,240,283
17743,7205,Otrokovice,68,477,216,261
17744,7205,Otrokovice,69,470,193,277
17745,7205,Otrokovice,70,462,206,256
17746,7205,Otrokovice,71,417,188,229
17747,7205,Otrokovice,72,426,189,237
17748,7205,Otrokovice,73,446,189,257
17749,7205,Otrokovice,74,382,167,215
17750,7205,Otrokovice,75,285,96,189
17751,7205,Otrokovice,76,282,120,162
17752,7205,Otrokovice,77,267,108,159
17753,7205,Otrokovice,78,291,115,176
17754,7205,Otrokovice,79,227,83,144
17755,7205,Otrokovice,80,199,73,126
17756,7205,Otrokovice,81,181,69,112
17757,7205,Otrokovice,82,151,51,100
17758,7205,Otrokovice,83,135,47,88
17759,7205,Otrokovice,84,151,50,101
17760,7205,Otrokovice,85,114,34,80
17761,7205,Otrokovice,86,113,35,78
17762,7205,Otrokovice,87,106,30,76
17763,7205,Otrokovice,88,94,17,77
17764,7205,Otrokovice,89,66,14,52
17765,7205,Otrokovice,90,66,22,44
17766,7205,Otrokovice,91,42,10,32
17767,7205,Otrokovice,92,42,9,33
17768,7205,Otrokovice,93,19,4,15
17769,7205,Otrokovice,94,15,4,11
17770,7205,Otrokovice,95,10,3,7
17771,7205,Otrokovice,96,9,2,7
17772,7205,Otrokovice,97,5,3,2
17773,7205,Otrokovice,98,3,1,2
17774,7205,Otrokovice,99,3,1,2
17775,7205,Otrokovice,100,4,3,1
17776,7206,Rožnov pod Radhoštěm,0,341,162,179
17777,7206,Rožnov pod Radhoštěm,1,354,189,165
17778,7206,Rožnov pod Radhoštěm,2,361,163,198
17779,7206,Rožnov pod Radhoštěm,3,364,179,185
17780,7206,Rožnov pod Radhoštěm,4,336,182,154
17781,7206,Rožnov pod Radhoštěm,5,356,159,197
17782,7206,Rožnov pod Radhoštěm,6,328,164,164
17783,7206,Rožnov pod Radhoštěm,7,327,181,146
17784,7206,Rožnov pod Radhoštěm,8,349,190,159
17785,7206,Rožnov pod Radhoštěm,9,362,192,170
17786,7206,Rožnov pod Radhoštěm,10,381,191,190
17787,7206,Rožnov pod Radhoštěm,11,401,217,184
17788,7206,Rožnov pod Radhoštěm,12,395,209,186
17789,7206,Rožnov pod Radhoštěm,13,384,213,171
17790,7206,Rožnov pod Radhoštěm,14,341,177,164
17791,7206,Rožnov pod Radhoštěm,15,355,169,186
17792,7206,Rožnov pod Radhoštěm,16,319,161,158
17793,7206,Rožnov pod Radhoštěm,17,296,152,144
17794,7206,Rožnov pod Radhoštěm,18,302,144,158
17795,7206,Rožnov pod Radhoštěm,19,303,154,149
17796,7206,Rožnov pod Radhoštěm,20,303,165,138
17797,7206,Rožnov pod Radhoštěm,21,310,142,168
17798,7206,Rožnov pod Radhoštěm,22,306,152,154
17799,7206,Rožnov pod Radhoštěm,23,312,162,150
17800,7206,Rožnov pod Radhoštěm,24,326,161,165
17801,7206,Rožnov pod Radhoštěm,25,382,202,180
17802,7206,Rožnov pod Radhoštěm,26,387,206,181
17803,7206,Rožnov pod Radhoštěm,27,423,224,199
17804,7206,Rožnov pod Radhoštěm,28,430,220,210
17805,7206,Rožnov pod Radhoštěm,29,477,258,219
17806,7206,Rožnov pod Radhoštěm,30,441,248,193
17807,7206,Rožnov pod Radhoštěm,31,430,217,213
17808,7206,Rožnov pod Radhoštěm,32,446,237,209
17809,7206,Rožnov pod Radhoštěm,33,437,224,213
17810,7206,Rožnov pod Radhoštěm,34,430,217,213
17811,7206,Rožnov pod Radhoštěm,35,455,238,217
17812,7206,Rožnov pod Radhoštěm,36,447,224,223
17813,7206,Rožnov pod Radhoštěm,37,431,221,210
17814,7206,Rožnov pod Radhoštěm,38,456,247,209
17815,7206,Rožnov pod Radhoštěm,39,443,238,205
17816,7206,Rožnov pod Radhoštěm,40,490,273,217
17817,7206,Rožnov pod Radhoštěm,41,532,281,251
17818,7206,Rožnov pod Radhoštěm,42,509,242,267
17819,7206,Rožnov pod Radhoštěm,43,558,288,270
17820,7206,Rožnov pod Radhoštěm,44,600,312,288
17821,7206,Rožnov pod Radhoštěm,45,609,308,301
17822,7206,Rožnov pod Radhoštěm,46,599,321,278
17823,7206,Rožnov pod Radhoštěm,47,544,289,255
17824,7206,Rožnov pod Radhoštěm,48,541,284,257
17825,7206,Rožnov pod Radhoštěm,49,509,242,267
17826,7206,Rožnov pod Radhoštěm,50,464,230,234
17827,7206,Rožnov pod Radhoštěm,51,448,245,203
17828,7206,Rožnov pod Radhoštěm,52,425,206,219
17829,7206,Rožnov pod Radhoštěm,53,461,231,230
17830,7206,Rožnov pod Radhoštěm,54,452,217,235
17831,7206,Rožnov pod Radhoštěm,55,502,235,267
17832,7206,Rožnov pod Radhoštěm,56,538,273,265
17833,7206,Rožnov pod Radhoštěm,57,541,271,270
17834,7206,Rožnov pod Radhoštěm,58,454,224,230
17835,7206,Rožnov pod Radhoštěm,59,455,242,213
17836,7206,Rožnov pod Radhoštěm,60,391,187,204
17837,7206,Rožnov pod Radhoštěm,61,404,202,202
17838,7206,Rožnov pod Radhoštěm,62,439,191,248
17839,7206,Rožnov pod Radhoštěm,63,449,221,228
17840,7206,Rožnov pod Radhoštěm,64,461,215,246
17841,7206,Rožnov pod Radhoštěm,65,443,185,258
17842,7206,Rožnov pod Radhoštěm,66,488,231,257
17843,7206,Rožnov pod Radhoštěm,67,482,250,232
17844,7206,Rožnov pod Radhoštěm,68,453,203,250
17845,7206,Rožnov pod Radhoštěm,69,452,194,258
17846,7206,Rožnov pod Radhoštěm,70,439,199,240
17847,7206,Rožnov pod Radhoštěm,71,423,196,227
17848,7206,Rožnov pod Radhoštěm,72,432,182,250
17849,7206,Rožnov pod Radhoštěm,73,407,184,223
17850,7206,Rožnov pod Radhoštěm,74,402,171,231
17851,7206,Rožnov pod Radhoštěm,75,356,167,189
17852,7206,Rožnov pod Radhoštěm,76,323,132,191
17853,7206,Rožnov pod Radhoštěm,77,297,126,171
17854,7206,Rožnov pod Radhoštěm,78,250,110,140
17855,7206,Rožnov pod Radhoštěm,79,253,100,153
17856,7206,Rožnov pod Radhoštěm,80,236,92,144
17857,7206,Rožnov pod Radhoštěm,81,197,73,124
17858,7206,Rožnov pod Radhoštěm,82,177,63,114
17859,7206,Rožnov pod Radhoštěm,83,165,49,116
17860,7206,Rožnov pod Radhoštěm,84,147,51,96
17861,7206,Rožnov pod Radhoštěm,85,149,52,97
17862,7206,Rožnov pod Radhoštěm,86,119,37,82
17863,7206,Rožnov pod Radhoštěm,87,118,44,74
17864,7206,Rožnov pod Radhoštěm,88,102,26,76
17865,7206,Rožnov pod Radhoštěm,89,75,17,58
17866,7206,Rožnov pod Radhoštěm,90,71,18,53
17867,7206,Rožnov pod Radhoštěm,91,44,12,32
17868,7206,Rožnov pod Radhoštěm,92,46,7,39
17869,7206,Rožnov pod Radhoštěm,93,33,8,25
17870,7206,Rožnov pod Radhoštěm,94,17,3,14
17871,7206,Rožnov pod Radhoštěm,95,22,5,17
17872,7206,Rožnov pod Radhoštěm,96,5,2,3
17873,7206,Rožnov pod Radhoštěm,97,9,1,8
17874,7206,Rožnov pod Radhoštěm,98,3,0,3
17875,7206,Rožnov pod Radhoštěm,99,4,2,2
17876,7206,Rožnov pod Radhoštěm,100,2,0,2
17877,7207,Uherské Hradiště,0,849,447,402
17878,7207,Uherské Hradiště,1,953,509,444
17879,7207,Uherské Hradiště,2,887,460,427
17880,7207,Uherské Hradiště,3,957,485,472
17881,7207,Uherské Hradiště,4,883,488,395
17882,7207,Uherské Hradiště,5,905,468,437
17883,7207,Uherské Hradiště,6,880,456,424
17884,7207,Uherské Hradiště,7,896,461,435
17885,7207,Uherské Hradiště,8,850,426,424
17886,7207,Uherské Hradiště,9,877,464,413
17887,7207,Uherské Hradiště,10,950,470,480
17888,7207,Uherské Hradiště,11,977,487,490
17889,7207,Uherské Hradiště,12,948,472,476
17890,7207,Uherské Hradiště,13,958,502,456
17891,7207,Uherské Hradiště,14,870,448,422
17892,7207,Uherské Hradiště,15,863,408,455
17893,7207,Uherské Hradiště,16,793,384,409
17894,7207,Uherské Hradiště,17,820,408,412
17895,7207,Uherské Hradiště,18,803,427,376
17896,7207,Uherské Hradiště,19,778,369,409
17897,7207,Uherské Hradiště,20,764,388,376
17898,7207,Uherské Hradiště,21,776,385,391
17899,7207,Uherské Hradiště,22,806,378,428
17900,7207,Uherské Hradiště,23,755,368,387
17901,7207,Uherské Hradiště,24,769,394,375
17902,7207,Uherské Hradiště,25,863,447,416
17903,7207,Uherské Hradiště,26,961,492,469
17904,7207,Uherské Hradiště,27,1074,567,507
17905,7207,Uherské Hradiště,28,1099,536,563
17906,7207,Uherské Hradiště,29,1111,589,522
17907,7207,Uherské Hradiště,30,1112,586,526
17908,7207,Uherské Hradiště,31,1116,562,554
17909,7207,Uherské Hradiště,32,1186,606,580
17910,7207,Uherské Hradiště,33,1158,583,575
17911,7207,Uherské Hradiště,34,1142,620,522
17912,7207,Uherské Hradiště,35,1174,617,557
17913,7207,Uherské Hradiště,36,1236,622,614
17914,7207,Uherské Hradiště,37,1186,634,552
17915,7207,Uherské Hradiště,38,1231,608,623
17916,7207,Uherské Hradiště,39,1217,645,572
17917,7207,Uherské Hradiště,40,1273,645,628
17918,7207,Uherské Hradiště,41,1534,821,713
17919,7207,Uherské Hradiště,42,1452,766,686
17920,7207,Uherské Hradiště,43,1446,738,708
17921,7207,Uherské Hradiště,44,1454,728,726
17922,7207,Uherské Hradiště,45,1607,823,784
17923,7207,Uherské Hradiště,46,1500,770,730
17924,7207,Uherské Hradiště,47,1466,740,726
17925,7207,Uherské Hradiště,48,1380,695,685
17926,7207,Uherské Hradiště,49,1252,649,603
17927,7207,Uherské Hradiště,50,1229,647,582
17928,7207,Uherské Hradiště,51,1221,606,615
17929,7207,Uherské Hradiště,52,1211,568,643
17930,7207,Uherské Hradiště,53,1175,577,598
17931,7207,Uherské Hradiště,54,1267,650,617
17932,7207,Uherské Hradiště,55,1275,664,611
17933,7207,Uherské Hradiště,56,1329,672,657
17934,7207,Uherské Hradiště,57,1298,644,654
17935,7207,Uherské Hradiště,58,1133,562,571
17936,7207,Uherské Hradiště,59,1114,568,546
17937,7207,Uherské Hradiště,60,1161,576,585
17938,7207,Uherské Hradiště,61,1109,562,547
17939,7207,Uherské Hradiště,62,1163,560,603
17940,7207,Uherské Hradiště,63,1175,597,578
17941,7207,Uherské Hradiště,64,1233,595,638
17942,7207,Uherské Hradiště,65,1176,587,589
17943,7207,Uherské Hradiště,66,1195,537,658
17944,7207,Uherské Hradiště,67,1085,493,592
17945,7207,Uherské Hradiště,68,1110,517,593
17946,7207,Uherské Hradiště,69,1142,523,619
17947,7207,Uherské Hradiště,70,1034,453,581
17948,7207,Uherské Hradiště,71,995,427,568
17949,7207,Uherské Hradiště,72,991,431,560
17950,7207,Uherské Hradiště,73,1042,459,583
17951,7207,Uherské Hradiště,74,1000,418,582
17952,7207,Uherské Hradiště,75,821,328,493
17953,7207,Uherské Hradiště,76,792,290,502
17954,7207,Uherské Hradiště,77,767,316,451
17955,7207,Uherské Hradiště,78,645,264,381
17956,7207,Uherské Hradiště,79,611,224,387
17957,7207,Uherské Hradiště,80,581,212,369
17958,7207,Uherské Hradiště,81,560,184,376
17959,7207,Uherské Hradiště,82,435,158,277
17960,7207,Uherské Hradiště,83,420,155,265
17961,7207,Uherské Hradiště,84,396,140,256
17962,7207,Uherské Hradiště,85,350,124,226
17963,7207,Uherské Hradiště,86,337,108,229
17964,7207,Uherské Hradiště,87,264,69,195
17965,7207,Uherské Hradiště,88,231,65,166
17966,7207,Uherské Hradiště,89,179,49,130
17967,7207,Uherské Hradiště,90,157,34,123
17968,7207,Uherské Hradiště,91,136,40,96
17969,7207,Uherské Hradiště,92,98,23,75
17970,7207,Uherské Hradiště,93,81,20,61
17971,7207,Uherské Hradiště,94,49,10,39
17972,7207,Uherské Hradiště,95,34,6,28
17973,7207,Uherské Hradiště,96,32,6,26
17974,7207,Uherské Hradiště,97,13,1,12
17975,7207,Uherské Hradiště,98,7,1,6
17976,7207,Uherské Hradiště,99,10,0,10
17977,7207,Uherské Hradiště,100,4,1,3
17978,7208,Uherský Brod,0,542,276,266
17979,7208,Uherský Brod,1,477,241,236
17980,7208,Uherský Brod,2,543,270,273
17981,7208,Uherský Brod,3,525,251,274
17982,7208,Uherský Brod,4,499,251,248
17983,7208,Uherský Brod,5,479,254,225
17984,7208,Uherský Brod,6,510,280,230
17985,7208,Uherský Brod,7,457,223,234
17986,7208,Uherský Brod,8,453,238,215
17987,7208,Uherský Brod,9,495,277,218
17988,7208,Uherský Brod,10,539,271,268
17989,7208,Uherský Brod,11,527,266,261
17990,7208,Uherský Brod,12,555,306,249
17991,7208,Uherský Brod,13,513,282,231
17992,7208,Uherský Brod,14,509,263,246
17993,7208,Uherský Brod,15,508,260,248
17994,7208,Uherský Brod,16,465,239,226
17995,7208,Uherský Brod,17,500,273,227
17996,7208,Uherský Brod,18,480,243,237
17997,7208,Uherský Brod,19,456,249,207
17998,7208,Uherský Brod,20,481,273,208
17999,7208,Uherský Brod,21,516,279,237
18000,7208,Uherský Brod,22,491,266,225
18001,7208,Uherský Brod,23,470,237,233
18002,7208,Uherský Brod,24,564,296,268
18003,7208,Uherský Brod,25,569,311,258
18004,7208,Uherský Brod,26,587,316,271
18005,7208,Uherský Brod,27,668,338,330
18006,7208,Uherský Brod,28,645,327,318
18007,7208,Uherský Brod,29,684,333,351
18008,7208,Uherský Brod,30,652,316,336
18009,7208,Uherský Brod,31,608,316,292
18010,7208,Uherský Brod,32,634,323,311
18011,7208,Uherský Brod,33,691,365,326
18012,7208,Uherský Brod,34,653,350,303
18013,7208,Uherský Brod,35,637,332,305
18014,7208,Uherský Brod,36,690,372,318
18015,7208,Uherský Brod,37,669,369,300
18016,7208,Uherský Brod,38,702,388,314
18017,7208,Uherský Brod,39,726,392,334
18018,7208,Uherský Brod,40,703,353,350
18019,7208,Uherský Brod,41,780,417,363
18020,7208,Uherský Brod,42,827,434,393
18021,7208,Uherský Brod,43,847,457,390
18022,7208,Uherský Brod,44,857,461,396
18023,7208,Uherský Brod,45,849,447,402
18024,7208,Uherský Brod,46,897,454,443
18025,7208,Uherský Brod,47,882,449,433
18026,7208,Uherský Brod,48,799,393,406
18027,7208,Uherský Brod,49,768,387,381
18028,7208,Uherský Brod,50,717,389,328
18029,7208,Uherský Brod,51,731,393,338
18030,7208,Uherský Brod,52,702,349,353
18031,7208,Uherský Brod,53,676,367,309
18032,7208,Uherský Brod,54,674,337,337
18033,7208,Uherský Brod,55,688,353,335
18034,7208,Uherský Brod,56,726,375,351
18035,7208,Uherský Brod,57,721,366,355
18036,7208,Uherský Brod,58,678,349,329
18037,7208,Uherský Brod,59,645,332,313
18038,7208,Uherský Brod,60,606,313,293
18039,7208,Uherský Brod,61,623,293,330
18040,7208,Uherský Brod,62,701,348,353
18041,7208,Uherský Brod,63,752,358,394
18042,7208,Uherský Brod,64,695,327,368
18043,7208,Uherský Brod,65,705,341,364
18044,7208,Uherský Brod,66,660,331,329
18045,7208,Uherský Brod,67,660,308,352
18046,7208,Uherský Brod,68,650,312,338
18047,7208,Uherský Brod,69,617,298,319
18048,7208,Uherský Brod,70,690,316,374
18049,7208,Uherský Brod,71,611,277,334
18050,7208,Uherský Brod,72,610,263,347
18051,7208,Uherský Brod,73,586,257,329
18052,7208,Uherský Brod,74,595,263,332
18053,7208,Uherský Brod,75,467,193,274
18054,7208,Uherský Brod,76,471,188,283
18055,7208,Uherský Brod,77,463,193,270
18056,7208,Uherský Brod,78,360,123,237
18057,7208,Uherský Brod,79,333,130,203
18058,7208,Uherský Brod,80,348,140,208
18059,7208,Uherský Brod,81,303,117,186
18060,7208,Uherský Brod,82,283,90,193
18061,7208,Uherský Brod,83,246,87,159
18062,7208,Uherský Brod,84,250,65,185
18063,7208,Uherský Brod,85,198,71,127
18064,7208,Uherský Brod,86,184,63,121
18065,7208,Uherský Brod,87,166,53,113
18066,7208,Uherský Brod,88,147,38,109
18067,7208,Uherský Brod,89,119,34,85
18068,7208,Uherský Brod,90,89,26,63
18069,7208,Uherský Brod,91,61,17,44
18070,7208,Uherský Brod,92,44,11,33
18071,7208,Uherský Brod,93,46,12,34
18072,7208,Uherský Brod,94,34,7,27
18073,7208,Uherský Brod,95,22,4,18
18074,7208,Uherský Brod,96,11,3,8
18075,7208,Uherský Brod,97,11,1,10
18076,7208,Uherský Brod,98,3,3,0
18077,7208,Uherský Brod,99,1,0,1
18078,7208,Uherský Brod,100,3,0,3
18079,7209,Valašské Klobouky,0,255,129,126
18080,7209,Valašské Klobouky,1,242,130,112
18081,7209,Valašské Klobouky,2,260,136,124
18082,7209,Valašské Klobouky,3,264,142,122
18083,7209,Valašské Klobouky,4,229,124,105
18084,7209,Valašské Klobouky,5,225,122,103
18085,7209,Valašské Klobouky,6,242,111,131
18086,7209,Valašské Klobouky,7,222,122,100
18087,7209,Valašské Klobouky,8,216,112,104
18088,7209,Valašské Klobouky,9,221,115,106
18089,7209,Valašské Klobouky,10,245,126,119
18090,7209,Valašské Klobouky,11,227,123,104
18091,7209,Valašské Klobouky,12,261,132,129
18092,7209,Valašské Klobouky,13,244,133,111
18093,7209,Valašské Klobouky,14,224,112,112
18094,7209,Valašské Klobouky,15,221,109,112
18095,7209,Valašské Klobouky,16,212,110,102
18096,7209,Valašské Klobouky,17,216,115,101
18097,7209,Valašské Klobouky,18,239,126,113
18098,7209,Valašské Klobouky,19,223,112,111
18099,7209,Valašské Klobouky,20,277,154,123
18100,7209,Valašské Klobouky,21,243,118,125
18101,7209,Valašské Klobouky,22,266,153,113
18102,7209,Valašské Klobouky,23,255,135,120
18103,7209,Valašské Klobouky,24,262,132,130
18104,7209,Valašské Klobouky,25,294,144,150
18105,7209,Valašské Klobouky,26,312,162,150
18106,7209,Valašské Klobouky,27,342,185,157
18107,7209,Valašské Klobouky,28,299,167,132
18108,7209,Valašské Klobouky,29,333,175,158
18109,7209,Valašské Klobouky,30,336,201,135
18110,7209,Valašské Klobouky,31,326,176,150
18111,7209,Valašské Klobouky,32,313,177,136
18112,7209,Valašské Klobouky,33,294,143,151
18113,7209,Valašské Klobouky,34,283,144,139
18114,7209,Valašské Klobouky,35,286,160,126
18115,7209,Valašské Klobouky,36,281,148,133
18116,7209,Valašské Klobouky,37,290,171,119
18117,7209,Valašské Klobouky,38,289,149,140
18118,7209,Valašské Klobouky,39,284,149,135
18119,7209,Valašské Klobouky,40,320,172,148
18120,7209,Valašské Klobouky,41,338,184,154
18121,7209,Valašské Klobouky,42,331,174,157
18122,7209,Valašské Klobouky,43,331,162,169
18123,7209,Valašské Klobouky,44,349,174,175
18124,7209,Valašské Klobouky,45,369,195,174
18125,7209,Valašské Klobouky,46,359,188,171
18126,7209,Valašské Klobouky,47,373,188,185
18127,7209,Valašské Klobouky,48,362,203,159
18128,7209,Valašské Klobouky,49,330,179,151
18129,7209,Valašské Klobouky,50,333,166,167
18130,7209,Valašské Klobouky,51,320,164,156
18131,7209,Valašské Klobouky,52,320,161,159
18132,7209,Valašské Klobouky,53,290,167,123
18133,7209,Valašské Klobouky,54,322,161,161
18134,7209,Valašské Klobouky,55,337,178,159
18135,7209,Valašské Klobouky,56,337,184,153
18136,7209,Valašské Klobouky,57,337,169,168
18137,7209,Valašské Klobouky,58,324,168,156
18138,7209,Valašské Klobouky,59,340,176,164
18139,7209,Valašské Klobouky,60,280,139,141
18140,7209,Valašské Klobouky,61,268,141,127
18141,7209,Valašské Klobouky,62,295,150,145
18142,7209,Valašské Klobouky,63,307,171,136
18143,7209,Valašské Klobouky,64,275,151,124
18144,7209,Valašské Klobouky,65,286,142,144
18145,7209,Valašské Klobouky,66,274,124,150
18146,7209,Valašské Klobouky,67,274,137,137
18147,7209,Valašské Klobouky,68,279,134,145
18148,7209,Valašské Klobouky,69,275,127,148
18149,7209,Valašské Klobouky,70,254,114,140
18150,7209,Valašské Klobouky,71,234,93,141
18151,7209,Valašské Klobouky,72,206,96,110
18152,7209,Valašské Klobouky,73,202,85,117
18153,7209,Valašské Klobouky,74,222,94,128
18154,7209,Valašské Klobouky,75,183,73,110
18155,7209,Valašské Klobouky,76,183,68,115
18156,7209,Valašské Klobouky,77,161,65,96
18157,7209,Valašské Klobouky,78,161,63,98
18158,7209,Valašské Klobouky,79,145,47,98
18159,7209,Valašské Klobouky,80,130,52,78
18160,7209,Valašské Klobouky,81,122,35,87
18161,7209,Valašské Klobouky,82,100,33,67
18162,7209,Valašské Klobouky,83,117,29,88
18163,7209,Valašské Klobouky,84,101,41,60
18164,7209,Valašské Klobouky,85,84,27,57
18165,7209,Valašské Klobouky,86,78,24,54
18166,7209,Valašské Klobouky,87,63,15,48
18167,7209,Valašské Klobouky,88,55,15,40
18168,7209,Valašské Klobouky,89,49,15,34
18169,7209,Valašské Klobouky,90,35,6,29
18170,7209,Valašské Klobouky,91,17,4,13
18171,7209,Valašské Klobouky,92,16,4,12
18172,7209,Valašské Klobouky,93,21,5,16
18173,7209,Valašské Klobouky,94,13,3,10
18174,7209,Valašské Klobouky,95,3,1,2
18175,7209,Valašské Klobouky,96,3,1,2
18176,7209,Valašské Klobouky,97,2,0,2
18177,7209,Valašské Klobouky,98,1,1,0
18178,7209,Valašské Klobouky,99,2,0,2
18179,7209,Valašské Klobouky,100,2,0,2
18180,7210,Valašské Meziříčí,0,468,243,225
18181,7210,Valašské Meziříčí,1,475,248,227
18182,7210,Valašské Meziříčí,2,449,247,202
18183,7210,Valašské Meziříčí,3,476,255,221
18184,7210,Valašské Meziříčí,4,445,244,201
18185,7210,Valašské Meziříčí,5,436,218,218
18186,7210,Valašské Meziříčí,6,440,242,198
18187,7210,Valašské Meziříčí,7,428,233,195
18188,7210,Valašské Meziříčí,8,403,202,201
18189,7210,Valašské Meziříčí,9,412,213,199
18190,7210,Valašské Meziříčí,10,441,236,205
18191,7210,Valašské Meziříčí,11,464,227,237
18192,7210,Valašské Meziříčí,12,484,251,233
18193,7210,Valašské Meziříčí,13,514,257,257
18194,7210,Valašské Meziříčí,14,422,217,205
18195,7210,Valašské Meziříčí,15,452,247,205
18196,7210,Valašské Meziříčí,16,390,214,176
18197,7210,Valašské Meziříčí,17,382,195,187
18198,7210,Valašské Meziříčí,18,426,220,206
18199,7210,Valašské Meziříčí,19,356,190,166
18200,7210,Valašské Meziříčí,20,409,230,179
18201,7210,Valašské Meziříčí,21,425,229,196
18202,7210,Valašské Meziříčí,22,404,205,199
18203,7210,Valašské Meziříčí,23,385,207,178
18204,7210,Valašské Meziříčí,24,423,211,212
18205,7210,Valašské Meziříčí,25,373,195,178
18206,7210,Valašské Meziříčí,26,478,263,215
18207,7210,Valašské Meziříčí,27,543,287,256
18208,7210,Valašské Meziříčí,28,517,246,271
18209,7210,Valašské Meziříčí,29,546,283,263
18210,7210,Valašské Meziříčí,30,534,256,278
18211,7210,Valašské Meziříčí,31,543,268,275
18212,7210,Valašské Meziříčí,32,564,282,282
18213,7210,Valašské Meziříčí,33,539,273,266
18214,7210,Valašské Meziříčí,34,541,305,236
18215,7210,Valašské Meziříčí,35,538,259,279
18216,7210,Valašské Meziříčí,36,516,289,227
18217,7210,Valašské Meziříčí,37,569,301,268
18218,7210,Valašské Meziříčí,38,540,267,273
18219,7210,Valašské Meziříčí,39,532,293,239
18220,7210,Valašské Meziříčí,40,574,298,276
18221,7210,Valašské Meziříčí,41,620,335,285
18222,7210,Valašské Meziříčí,42,637,342,295
18223,7210,Valašské Meziříčí,43,630,312,318
18224,7210,Valašské Meziříčí,44,715,376,339
18225,7210,Valašské Meziříčí,45,714,355,359
18226,7210,Valašské Meziříčí,46,762,396,366
18227,7210,Valašské Meziříčí,47,657,331,326
18228,7210,Valašské Meziříčí,48,649,337,312
18229,7210,Valašské Meziříčí,49,585,285,300
18230,7210,Valašské Meziříčí,50,596,301,295
18231,7210,Valašské Meziříčí,51,572,296,276
18232,7210,Valašské Meziříčí,52,562,292,270
18233,7210,Valašské Meziříčí,53,513,256,257
18234,7210,Valašské Meziříčí,54,558,272,286
18235,7210,Valašské Meziříčí,55,614,302,312
18236,7210,Valašské Meziříčí,56,593,305,288
18237,7210,Valašské Meziříčí,57,607,289,318
18238,7210,Valašské Meziříčí,58,519,265,254
18239,7210,Valašské Meziříčí,59,479,227,252
18240,7210,Valašské Meziříčí,60,508,253,255
18241,7210,Valašské Meziříčí,61,477,224,253
18242,7210,Valašské Meziříčí,62,473,235,238
18243,7210,Valašské Meziříčí,63,527,273,254
18244,7210,Valašské Meziříčí,64,534,255,279
18245,7210,Valašské Meziříčí,65,509,220,289
18246,7210,Valašské Meziříčí,66,494,237,257
18247,7210,Valašské Meziříčí,67,496,223,273
18248,7210,Valašské Meziříčí,68,517,240,277
18249,7210,Valašské Meziříčí,69,499,221,278
18250,7210,Valašské Meziříčí,70,455,195,260
18251,7210,Valašské Meziříčí,71,456,200,256
18252,7210,Valašské Meziříčí,72,514,215,299
18253,7210,Valašské Meziříčí,73,447,171,276
18254,7210,Valašské Meziříčí,74,480,203,277
18255,7210,Valašské Meziříčí,75,370,148,222
18256,7210,Valašské Meziříčí,76,405,161,244
18257,7210,Valašské Meziříčí,77,355,134,221
18258,7210,Valašské Meziříčí,78,299,118,181
18259,7210,Valašské Meziříčí,79,276,104,172
18260,7210,Valašské Meziříčí,80,258,109,149
18261,7210,Valašské Meziříčí,81,230,87,143
18262,7210,Valašské Meziříčí,82,211,95,116
18263,7210,Valašské Meziříčí,83,183,68,115
18264,7210,Valašské Meziříčí,84,159,60,99
18265,7210,Valašské Meziříčí,85,148,45,103
18266,7210,Valašské Meziříčí,86,110,37,73
18267,7210,Valašské Meziříčí,87,102,28,74
18268,7210,Valašské Meziříčí,88,93,24,69
18269,7210,Valašské Meziříčí,89,81,27,54
18270,7210,Valašské Meziříčí,90,70,20,50
18271,7210,Valašské Meziříčí,91,41,16,25
18272,7210,Valašské Meziříčí,92,39,11,28
18273,7210,Valašské Meziříčí,93,32,7,25
18274,7210,Valašské Meziříčí,94,13,2,11
18275,7210,Valašské Meziříčí,95,10,3,7
18276,7210,Valašské Meziříčí,96,8,2,6
18277,7210,Valašské Meziříčí,97,5,0,5
18278,7210,Valašské Meziříčí,98,1,0,1
18279,7210,Valašské Meziříčí,99,2,0,2
18280,7210,Valašské Meziříčí,100,2,0,2
18281,7211,Vizovice,0,203,102,101
18282,7211,Vizovice,1,194,113,81
18283,7211,Vizovice,2,191,97,94
18284,7211,Vizovice,3,202,97,105
18285,7211,Vizovice,4,191,98,93
18286,7211,Vizovice,5,154,76,78
18287,7211,Vizovice,6,176,96,80
18288,7211,Vizovice,7,175,78,97
18289,7211,Vizovice,8,181,100,81
18290,7211,Vizovice,9,160,80,80
18291,7211,Vizovice,10,193,93,100
18292,7211,Vizovice,11,189,93,96
18293,7211,Vizovice,12,213,96,117
18294,7211,Vizovice,13,185,98,87
18295,7211,Vizovice,14,177,82,95
18296,7211,Vizovice,15,182,87,95
18297,7211,Vizovice,16,176,89,87
18298,7211,Vizovice,17,172,87,85
18299,7211,Vizovice,18,156,78,78
18300,7211,Vizovice,19,149,73,76
18301,7211,Vizovice,20,171,93,78
18302,7211,Vizovice,21,159,77,82
18303,7211,Vizovice,22,159,92,67
18304,7211,Vizovice,23,163,82,81
18305,7211,Vizovice,24,154,80,74
18306,7211,Vizovice,25,143,83,60
18307,7211,Vizovice,26,190,99,91
18308,7211,Vizovice,27,222,107,115
18309,7211,Vizovice,28,266,127,139
18310,7211,Vizovice,29,235,130,105
18311,7211,Vizovice,30,250,120,130
18312,7211,Vizovice,31,239,121,118
18313,7211,Vizovice,32,209,123,86
18314,7211,Vizovice,33,228,125,103
18315,7211,Vizovice,34,200,108,92
18316,7211,Vizovice,35,218,113,105
18317,7211,Vizovice,36,243,131,112
18318,7211,Vizovice,37,230,116,114
18319,7211,Vizovice,38,229,121,108
18320,7211,Vizovice,39,245,128,117
18321,7211,Vizovice,40,241,129,112
18322,7211,Vizovice,41,322,154,168
18323,7211,Vizovice,42,306,158,148
18324,7211,Vizovice,43,291,142,149
18325,7211,Vizovice,44,325,177,148
18326,7211,Vizovice,45,299,162,137
18327,7211,Vizovice,46,318,163,155
18328,7211,Vizovice,47,296,147,149
18329,7211,Vizovice,48,256,125,131
18330,7211,Vizovice,49,268,156,112
18331,7211,Vizovice,50,249,144,105
18332,7211,Vizovice,51,222,109,113
18333,7211,Vizovice,52,227,112,115
18334,7211,Vizovice,53,232,110,122
18335,7211,Vizovice,54,234,119,115
18336,7211,Vizovice,55,231,109,122
18337,7211,Vizovice,56,247,120,127
18338,7211,Vizovice,57,223,108,115
18339,7211,Vizovice,58,197,103,94
18340,7211,Vizovice,59,229,118,111
18341,7211,Vizovice,60,205,115,90
18342,7211,Vizovice,61,182,96,86
18343,7211,Vizovice,62,238,110,128
18344,7211,Vizovice,63,196,90,106
18345,7211,Vizovice,64,240,118,122
18346,7211,Vizovice,65,216,107,109
18347,7211,Vizovice,66,236,114,122
18348,7211,Vizovice,67,210,97,113
18349,7211,Vizovice,68,212,102,110
18350,7211,Vizovice,69,206,99,107
18351,7211,Vizovice,70,223,112,111
18352,7211,Vizovice,71,170,82,88
18353,7211,Vizovice,72,156,72,84
18354,7211,Vizovice,73,188,93,95
18355,7211,Vizovice,74,169,67,102
18356,7211,Vizovice,75,129,59,70
18357,7211,Vizovice,76,123,51,72
18358,7211,Vizovice,77,121,43,78
18359,7211,Vizovice,78,110,46,64
18360,7211,Vizovice,79,85,35,50
18361,7211,Vizovice,80,84,28,56
18362,7211,Vizovice,81,82,33,49
18363,7211,Vizovice,82,72,27,45
18364,7211,Vizovice,83,47,16,31
18365,7211,Vizovice,84,46,15,31
18366,7211,Vizovice,85,52,17,35
18367,7211,Vizovice,86,41,12,29
18368,7211,Vizovice,87,35,5,30
18369,7211,Vizovice,88,38,10,28
18370,7211,Vizovice,89,28,9,19
18371,7211,Vizovice,90,23,4,19
18372,7211,Vizovice,91,15,1,14
18373,7211,Vizovice,92,17,4,13
18374,7211,Vizovice,93,10,3,7
18375,7211,Vizovice,94,9,2,7
18376,7211,Vizovice,95,8,0,8
18377,7211,Vizovice,96,2,0,2
18378,7211,Vizovice,97,1,1,0
18379,7211,Vizovice,98,0,0,0
18380,7211,Vizovice,99,0,0,0
18381,7211,Vizovice,100,2,1,1
18382,7212,Vsetín,0,642,324,318
18383,7212,Vsetín,1,603,298,305
18384,7212,Vsetín,2,694,342,352
18385,7212,Vsetín,3,665,350,315
18386,7212,Vsetín,4,618,312,306
18387,7212,Vsetín,5,691,343,348
18388,7212,Vsetín,6,644,320,324
18389,7212,Vsetín,7,646,333,313
18390,7212,Vsetín,8,599,299,300
18391,7212,Vsetín,9,655,326,329
18392,7212,Vsetín,10,698,382,316
18393,7212,Vsetín,11,702,370,332
18394,7212,Vsetín,12,726,368,358
18395,7212,Vsetín,13,706,386,320
18396,7212,Vsetín,14,637,316,321
18397,7212,Vsetín,15,657,336,321
18398,7212,Vsetín,16,600,334,266
18399,7212,Vsetín,17,617,310,307
18400,7212,Vsetín,18,574,293,281
18401,7212,Vsetín,19,614,320,294
18402,7212,Vsetín,20,633,334,299
18403,7212,Vsetín,21,652,364,288
18404,7212,Vsetín,22,628,330,298
18405,7212,Vsetín,23,629,337,292
18406,7212,Vsetín,24,624,331,293
18407,7212,Vsetín,25,714,350,364
18408,7212,Vsetín,26,726,378,348
18409,7212,Vsetín,27,791,387,404
18410,7212,Vsetín,28,812,418,394
18411,7212,Vsetín,29,935,500,435
18412,7212,Vsetín,30,849,434,415
18413,7212,Vsetín,31,827,434,393
18414,7212,Vsetín,32,843,441,402
18415,7212,Vsetín,33,807,422,385
18416,7212,Vsetín,34,852,462,390
18417,7212,Vsetín,35,815,418,397
18418,7212,Vsetín,36,786,391,395
18419,7212,Vsetín,37,867,470,397
18420,7212,Vsetín,38,854,460,394
18421,7212,Vsetín,39,836,444,392
18422,7212,Vsetín,40,918,493,425
18423,7212,Vsetín,41,992,532,460
18424,7212,Vsetín,42,1067,557,510
18425,7212,Vsetín,43,1062,520,542
18426,7212,Vsetín,44,1056,569,487
18427,7212,Vsetín,45,1162,605,557
18428,7212,Vsetín,46,1100,591,509
18429,7212,Vsetín,47,1075,562,513
18430,7212,Vsetín,48,996,521,475
18431,7212,Vsetín,49,960,507,453
18432,7212,Vsetín,50,890,443,447
18433,7212,Vsetín,51,891,465,426
18434,7212,Vsetín,52,851,426,425
18435,7212,Vsetín,53,827,432,395
18436,7212,Vsetín,54,890,488,402
18437,7212,Vsetín,55,878,444,434
18438,7212,Vsetín,56,967,485,482
18439,7212,Vsetín,57,900,419,481
18440,7212,Vsetín,58,800,409,391
18441,7212,Vsetín,59,856,416,440
18442,7212,Vsetín,60,816,398,418
18443,7212,Vsetín,61,766,377,389
18444,7212,Vsetín,62,815,404,411
18445,7212,Vsetín,63,873,391,482
18446,7212,Vsetín,64,942,452,490
18447,7212,Vsetín,65,864,407,457
18448,7212,Vsetín,66,836,358,478
18449,7212,Vsetín,67,800,355,445
18450,7212,Vsetín,68,831,394,437
18451,7212,Vsetín,69,812,372,440
18452,7212,Vsetín,70,780,372,408
18453,7212,Vsetín,71,764,324,440
18454,7212,Vsetín,72,721,293,428
18455,7212,Vsetín,73,747,320,427
18456,7212,Vsetín,74,696,273,423
18457,7212,Vsetín,75,612,255,357
18458,7212,Vsetín,76,538,202,336
18459,7212,Vsetín,77,515,210,305
18460,7212,Vsetín,78,464,182,282
18461,7212,Vsetín,79,466,162,304
18462,7212,Vsetín,80,399,160,239
18463,7212,Vsetín,81,326,95,231
18464,7212,Vsetín,82,345,97,248
18465,7212,Vsetín,83,267,82,185
18466,7212,Vsetín,84,257,82,175
18467,7212,Vsetín,85,224,68,156
18468,7212,Vsetín,86,197,66,131
18469,7212,Vsetín,87,171,47,124
18470,7212,Vsetín,88,153,43,110
18471,7212,Vsetín,89,146,41,105
18472,7212,Vsetín,90,114,31,83
18473,7212,Vsetín,91,77,24,53
18474,7212,Vsetín,92,51,20,31
18475,7212,Vsetín,93,42,7,35
18476,7212,Vsetín,94,36,4,32
18477,7212,Vsetín,95,21,8,13
18478,7212,Vsetín,96,13,1,12
18479,7212,Vsetín,97,7,2,5
18480,7212,Vsetín,98,4,3,1
18481,7212,Vsetín,99,4,1,3
18482,7212,Vsetín,100,8,5,3
18483,7213,Zlín,0,934,483,451
18484,7213,Zlín,1,970,508,462
18485,7213,Zlín,2,1056,538,518
18486,7213,Zlín,3,1051,556,495
18487,7213,Zlín,4,1030,520,510
18488,7213,Zlín,5,1068,548,520
18489,7213,Zlín,6,951,460,491
18490,7213,Zlín,7,958,514,444
18491,7213,Zlín,8,988,512,476
18492,7213,Zlín,9,944,481,463
18493,7213,Zlín,10,1107,571,536
18494,7213,Zlín,11,1070,559,511
18495,7213,Zlín,12,1176,611,565
18496,7213,Zlín,13,1067,539,528
18497,7213,Zlín,14,1031,522,509
18498,7213,Zlín,15,974,519,455
18499,7213,Zlín,16,863,453,410
18500,7213,Zlín,17,871,446,425
18501,7213,Zlín,18,840,439,401
18502,7213,Zlín,19,882,455,427
18503,7213,Zlín,20,857,428,429
18504,7213,Zlín,21,786,389,397
18505,7213,Zlín,22,789,387,402
18506,7213,Zlín,23,818,423,395
18507,7213,Zlín,24,827,429,398
18508,7213,Zlín,25,832,441,391
18509,7213,Zlín,26,963,482,481
18510,7213,Zlín,27,1084,534,550
18511,7213,Zlín,28,1117,577,540
18512,7213,Zlín,29,1215,612,603
18513,7213,Zlín,30,1281,636,645
18514,7213,Zlín,31,1265,636,629
18515,7213,Zlín,32,1326,704,622
18516,7213,Zlín,33,1286,664,622
18517,7213,Zlín,34,1316,698,618
18518,7213,Zlín,35,1330,687,643
18519,7213,Zlín,36,1293,636,657
18520,7213,Zlín,37,1318,660,658
18521,7213,Zlín,38,1337,687,650
18522,7213,Zlín,39,1394,711,683
18523,7213,Zlín,40,1408,731,677
18524,7213,Zlín,41,1584,795,789
18525,7213,Zlín,42,1634,817,817
18526,7213,Zlín,43,1713,840,873
18527,7213,Zlín,44,1754,879,875
18528,7213,Zlín,45,1832,911,921
18529,7213,Zlín,46,1844,961,883
18530,7213,Zlín,47,1636,833,803
18531,7213,Zlín,48,1531,753,778
18532,7213,Zlín,49,1351,700,651
18533,7213,Zlín,50,1301,654,647
18534,7213,Zlín,51,1277,647,630
18535,7213,Zlín,52,1184,606,578
18536,7213,Zlín,53,1114,545,569
18537,7213,Zlín,54,1207,601,606
18538,7213,Zlín,55,1222,582,640
18539,7213,Zlín,56,1354,662,692
18540,7213,Zlín,57,1372,676,696
18541,7213,Zlín,58,1192,577,615
18542,7213,Zlín,59,1180,572,608
18543,7213,Zlín,60,1131,587,544
18544,7213,Zlín,61,1220,613,607
18545,7213,Zlín,62,1112,546,566
18546,7213,Zlín,63,1315,630,685
18547,7213,Zlín,64,1309,589,720
18548,7213,Zlín,65,1334,649,685
18549,7213,Zlín,66,1289,604,685
18550,7213,Zlín,67,1365,597,768
18551,7213,Zlín,68,1316,596,720
18552,7213,Zlín,69,1306,558,748
18553,7213,Zlín,70,1274,562,712
18554,7213,Zlín,71,1168,521,647
18555,7213,Zlín,72,1128,472,656
18556,7213,Zlín,73,1088,453,635
18557,7213,Zlín,74,1134,463,671
18558,7213,Zlín,75,863,333,530
18559,7213,Zlín,76,961,391,570
18560,7213,Zlín,77,853,328,525
18561,7213,Zlín,78,760,324,436
18562,7213,Zlín,79,773,289,484
18563,7213,Zlín,80,763,284,479
18564,7213,Zlín,81,612,221,391
18565,7213,Zlín,82,594,243,351
18566,7213,Zlín,83,444,139,305
18567,7213,Zlín,84,415,136,279
18568,7213,Zlín,85,415,159,256
18569,7213,Zlín,86,410,132,278
18570,7213,Zlín,87,353,125,228
18571,7213,Zlín,88,334,102,232
18572,7213,Zlín,89,261,62,199
18573,7213,Zlín,90,181,52,129
18574,7213,Zlín,91,144,30,114
18575,7213,Zlín,92,110,29,81
18576,7213,Zlín,93,87,24,63
18577,7213,Zlín,94,70,20,50
18578,7213,Zlín,95,43,7,36
18579,7213,Zlín,96,22,5,17
18580,7213,Zlín,97,15,2,13
18581,7213,Zlín,98,19,5,14
18582,7213,Zlín,99,8,0,8
18583,7213,Zlín,100,9,1,8
18584,8001,Bílovec,0,268,150,118
18585,8001,Bílovec,1,259,133,126
18586,8001,Bílovec,2,295,153,142
18587,8001,Bílovec,3,280,139,141
18588,8001,Bílovec,4,285,144,141
18589,8001,Bílovec,5,279,140,139
18590,8001,Bílovec,6,253,133,120
18591,8001,Bílovec,7,278,135,143
18592,8001,Bílovec,8,268,149,119
18593,8001,Bílovec,9,219,101,118
18594,8001,Bílovec,10,296,140,156
18595,8001,Bílovec,11,300,149,151
18596,8001,Bílovec,12,285,140,145
18597,8001,Bílovec,13,278,151,127
18598,8001,Bílovec,14,251,142,109
18599,8001,Bílovec,15,254,125,129
18600,8001,Bílovec,16,240,127,113
18601,8001,Bílovec,17,241,127,114
18602,8001,Bílovec,18,268,132,136
18603,8001,Bílovec,19,238,128,110
18604,8001,Bílovec,20,235,126,109
18605,8001,Bílovec,21,248,127,121
18606,8001,Bílovec,22,261,128,133
18607,8001,Bílovec,23,243,114,129
18608,8001,Bílovec,24,249,128,121
18609,8001,Bílovec,25,254,128,126
18610,8001,Bílovec,26,333,186,147
18611,8001,Bílovec,27,305,149,156
18612,8001,Bílovec,28,341,183,158
18613,8001,Bílovec,29,345,190,155
18614,8001,Bílovec,30,334,171,163
18615,8001,Bílovec,31,316,179,137
18616,8001,Bílovec,32,342,168,174
18617,8001,Bílovec,33,310,167,143
18618,8001,Bílovec,34,348,179,169
18619,8001,Bílovec,35,351,192,159
18620,8001,Bílovec,36,298,155,143
18621,8001,Bílovec,37,355,189,166
18622,8001,Bílovec,38,319,156,163
18623,8001,Bílovec,39,327,181,146
18624,8001,Bílovec,40,368,196,172
18625,8001,Bílovec,41,399,198,201
18626,8001,Bílovec,42,390,197,193
18627,8001,Bílovec,43,406,201,205
18628,8001,Bílovec,44,437,236,201
18629,8001,Bílovec,45,438,215,223
18630,8001,Bílovec,46,431,229,202
18631,8001,Bílovec,47,404,223,181
18632,8001,Bílovec,48,378,206,172
18633,8001,Bílovec,49,399,202,197
18634,8001,Bílovec,50,340,162,178
18635,8001,Bílovec,51,360,192,168
18636,8001,Bílovec,52,330,158,172
18637,8001,Bílovec,53,383,206,177
18638,8001,Bílovec,54,349,181,168
18639,8001,Bílovec,55,355,192,163
18640,8001,Bílovec,56,361,198,163
18641,8001,Bílovec,57,366,189,177
18642,8001,Bílovec,58,311,159,152
18643,8001,Bílovec,59,313,154,159
18644,8001,Bílovec,60,293,146,147
18645,8001,Bílovec,61,313,139,174
18646,8001,Bílovec,62,344,168,176
18647,8001,Bílovec,63,328,158,170
18648,8001,Bílovec,64,320,155,165
18649,8001,Bílovec,65,306,136,170
18650,8001,Bílovec,66,338,157,181
18651,8001,Bílovec,67,320,150,170
18652,8001,Bílovec,68,318,154,164
18653,8001,Bílovec,69,347,139,208
18654,8001,Bílovec,70,277,122,155
18655,8001,Bílovec,71,305,148,157
18656,8001,Bílovec,72,297,141,156
18657,8001,Bílovec,73,280,118,162
18658,8001,Bílovec,74,274,128,146
18659,8001,Bílovec,75,190,75,115
18660,8001,Bílovec,76,235,86,149
18661,8001,Bílovec,77,217,93,124
18662,8001,Bílovec,78,166,59,107
18663,8001,Bílovec,79,173,72,101
18664,8001,Bílovec,80,172,74,98
18665,8001,Bílovec,81,136,34,102
18666,8001,Bílovec,82,121,46,75
18667,8001,Bílovec,83,96,36,60
18668,8001,Bílovec,84,89,32,57
18669,8001,Bílovec,85,74,20,54
18670,8001,Bílovec,86,54,17,37
18671,8001,Bílovec,87,57,15,42
18672,8001,Bílovec,88,61,18,43
18673,8001,Bílovec,89,52,17,35
18674,8001,Bílovec,90,38,14,24
18675,8001,Bílovec,91,21,8,13
18676,8001,Bílovec,92,26,6,20
18677,8001,Bílovec,93,11,1,10
18678,8001,Bílovec,94,8,2,6
18679,8001,Bílovec,95,7,0,7
18680,8001,Bílovec,96,9,2,7
18681,8001,Bílovec,97,2,0,2
18682,8001,Bílovec,98,2,0,2
18683,8001,Bílovec,99,2,0,2
18684,8001,Bílovec,100,4,1,3
18685,8002,Bohumín,0,308,167,141
18686,8002,Bohumín,1,304,162,142
18687,8002,Bohumín,2,326,159,167
18688,8002,Bohumín,3,325,169,156
18689,8002,Bohumín,4,314,148,166
18690,8002,Bohumín,5,306,170,136
18691,8002,Bohumín,6,333,174,159
18692,8002,Bohumín,7,318,167,151
18693,8002,Bohumín,8,313,158,155
18694,8002,Bohumín,9,330,180,150
18695,8002,Bohumín,10,381,201,180
18696,8002,Bohumín,11,363,179,184
18697,8002,Bohumín,12,372,193,179
18698,8002,Bohumín,13,360,183,177
18699,8002,Bohumín,14,375,195,180
18700,8002,Bohumín,15,312,165,147
18701,8002,Bohumín,16,300,159,141
18702,8002,Bohumín,17,280,126,154
18703,8002,Bohumín,18,313,158,155
18704,8002,Bohumín,19,295,151,144
18705,8002,Bohumín,20,290,162,128
18706,8002,Bohumín,21,329,159,170
18707,8002,Bohumín,22,287,146,141
18708,8002,Bohumín,23,339,182,157
18709,8002,Bohumín,24,303,168,135
18710,8002,Bohumín,25,313,148,165
18711,8002,Bohumín,26,356,187,169
18712,8002,Bohumín,27,381,201,180
18713,8002,Bohumín,28,407,211,196
18714,8002,Bohumín,29,470,228,242
18715,8002,Bohumín,30,441,234,207
18716,8002,Bohumín,31,421,237,184
18717,8002,Bohumín,32,406,204,202
18718,8002,Bohumín,33,427,215,212
18719,8002,Bohumín,34,439,223,216
18720,8002,Bohumín,35,459,232,227
18721,8002,Bohumín,36,411,212,199
18722,8002,Bohumín,37,441,223,218
18723,8002,Bohumín,38,420,230,190
18724,8002,Bohumín,39,401,224,177
18725,8002,Bohumín,40,470,265,205
18726,8002,Bohumín,41,512,276,236
18727,8002,Bohumín,42,562,281,281
18728,8002,Bohumín,43,520,269,251
18729,8002,Bohumín,44,582,284,298
18730,8002,Bohumín,45,582,313,269
18731,8002,Bohumín,46,592,303,289
18732,8002,Bohumín,47,559,303,256
18733,8002,Bohumín,48,502,252,250
18734,8002,Bohumín,49,500,241,259
18735,8002,Bohumín,50,493,246,247
18736,8002,Bohumín,51,487,233,254
18737,8002,Bohumín,52,461,228,233
18738,8002,Bohumín,53,486,248,238
18739,8002,Bohumín,54,459,235,224
18740,8002,Bohumín,55,487,241,246
18741,8002,Bohumín,56,501,252,249
18742,8002,Bohumín,57,467,226,241
18743,8002,Bohumín,58,395,205,190
18744,8002,Bohumín,59,396,204,192
18745,8002,Bohumín,60,404,189,215
18746,8002,Bohumín,61,364,160,204
18747,8002,Bohumín,62,411,187,224
18748,8002,Bohumín,63,457,199,258
18749,8002,Bohumín,64,472,230,242
18750,8002,Bohumín,65,476,231,245
18751,8002,Bohumín,66,422,185,237
18752,8002,Bohumín,67,442,211,231
18753,8002,Bohumín,68,448,216,232
18754,8002,Bohumín,69,437,200,237
18755,8002,Bohumín,70,414,206,208
18756,8002,Bohumín,71,395,161,234
18757,8002,Bohumín,72,406,180,226
18758,8002,Bohumín,73,383,159,224
18759,8002,Bohumín,74,308,120,188
18760,8002,Bohumín,75,290,122,168
18761,8002,Bohumín,76,288,115,173
18762,8002,Bohumín,77,284,106,178
18763,8002,Bohumín,78,253,97,156
18764,8002,Bohumín,79,273,93,180
18765,8002,Bohumín,80,200,72,128
18766,8002,Bohumín,81,180,58,122
18767,8002,Bohumín,82,130,56,74
18768,8002,Bohumín,83,112,46,66
18769,8002,Bohumín,84,102,43,59
18770,8002,Bohumín,85,87,28,59
18771,8002,Bohumín,86,92,30,62
18772,8002,Bohumín,87,70,21,49
18773,8002,Bohumín,88,58,13,45
18774,8002,Bohumín,89,58,14,44
18775,8002,Bohumín,90,42,13,29
18776,8002,Bohumín,91,44,13,31
18777,8002,Bohumín,92,27,5,22
18778,8002,Bohumín,93,24,3,21
18779,8002,Bohumín,94,14,4,10
18780,8002,Bohumín,95,9,1,8
18781,8002,Bohumín,96,6,1,5
18782,8002,Bohumín,97,9,1,8
18783,8002,Bohumín,98,2,0,2
18784,8002,Bohumín,99,1,0,1
18785,8002,Bohumín,100,2,0,2
18786,8003,Bruntál,0,315,157,158
18787,8003,Bruntál,1,316,165,151
18788,8003,Bruntál,2,363,196,167
18789,8003,Bruntál,3,348,175,173
18790,8003,Bruntál,4,355,196,159
18791,8003,Bruntál,5,331,177,154
18792,8003,Bruntál,6,347,198,149
18793,8003,Bruntál,7,341,179,162
18794,8003,Bruntál,8,321,163,158
18795,8003,Bruntál,9,329,167,162
18796,8003,Bruntál,10,411,207,204
18797,8003,Bruntál,11,395,192,203
18798,8003,Bruntál,12,456,230,226
18799,8003,Bruntál,13,433,232,201
18800,8003,Bruntál,14,407,200,207
18801,8003,Bruntál,15,342,168,174
18802,8003,Bruntál,16,371,205,166
18803,8003,Bruntál,17,328,167,161
18804,8003,Bruntál,18,356,170,186
18805,8003,Bruntál,19,350,192,158
18806,8003,Bruntál,20,339,170,169
18807,8003,Bruntál,21,330,168,162
18808,8003,Bruntál,22,387,198,189
18809,8003,Bruntál,23,375,185,190
18810,8003,Bruntál,24,388,199,189
18811,8003,Bruntál,25,382,190,192
18812,8003,Bruntál,26,417,207,210
18813,8003,Bruntál,27,423,236,187
18814,8003,Bruntál,28,436,226,210
18815,8003,Bruntál,29,479,253,226
18816,8003,Bruntál,30,510,269,241
18817,8003,Bruntál,31,425,222,203
18818,8003,Bruntál,32,453,243,210
18819,8003,Bruntál,33,437,240,197
18820,8003,Bruntál,34,418,234,184
18821,8003,Bruntál,35,456,223,233
18822,8003,Bruntál,36,449,232,217
18823,8003,Bruntál,37,444,217,227
18824,8003,Bruntál,38,455,242,213
18825,8003,Bruntál,39,462,248,214
18826,8003,Bruntál,40,521,280,241
18827,8003,Bruntál,41,544,288,256
18828,8003,Bruntál,42,626,334,292
18829,8003,Bruntál,43,610,336,274
18830,8003,Bruntál,44,605,314,291
18831,8003,Bruntál,45,650,352,298
18832,8003,Bruntál,46,628,295,333
18833,8003,Bruntál,47,595,300,295
18834,8003,Bruntál,48,565,290,275
18835,8003,Bruntál,49,512,256,256
18836,8003,Bruntál,50,501,250,251
18837,8003,Bruntál,51,496,253,243
18838,8003,Bruntál,52,520,253,267
18839,8003,Bruntál,53,505,259,246
18840,8003,Bruntál,54,475,245,230
18841,8003,Bruntál,55,488,221,267
18842,8003,Bruntál,56,492,254,238
18843,8003,Bruntál,57,486,232,254
18844,8003,Bruntál,58,430,200,230
18845,8003,Bruntál,59,410,201,209
18846,8003,Bruntál,60,388,191,197
18847,8003,Bruntál,61,413,185,228
18848,8003,Bruntál,62,491,229,262
18849,8003,Bruntál,63,547,276,271
18850,8003,Bruntál,64,518,243,275
18851,8003,Bruntál,65,505,243,262
18852,8003,Bruntál,66,522,243,279
18853,8003,Bruntál,67,524,238,286
18854,8003,Bruntál,68,507,224,283
18855,8003,Bruntál,69,507,214,293
18856,8003,Bruntál,70,498,249,249
18857,8003,Bruntál,71,492,210,282
18858,8003,Bruntál,72,475,229,246
18859,8003,Bruntál,73,494,232,262
18860,8003,Bruntál,74,394,175,219
18861,8003,Bruntál,75,283,111,172
18862,8003,Bruntál,76,286,108,178
18863,8003,Bruntál,77,239,98,141
18864,8003,Bruntál,78,222,90,132
18865,8003,Bruntál,79,221,90,131
18866,8003,Bruntál,80,193,79,114
18867,8003,Bruntál,81,159,65,94
18868,8003,Bruntál,82,121,42,79
18869,8003,Bruntál,83,114,31,83
18870,8003,Bruntál,84,92,29,63
18871,8003,Bruntál,85,105,28,77
18872,8003,Bruntál,86,90,27,63
18873,8003,Bruntál,87,73,18,55
18874,8003,Bruntál,88,62,22,40
18875,8003,Bruntál,89,49,17,32
18876,8003,Bruntál,90,41,9,32
18877,8003,Bruntál,91,28,6,22
18878,8003,Bruntál,92,28,7,21
18879,8003,Bruntál,93,16,3,13
18880,8003,Bruntál,94,6,0,6
18881,8003,Bruntál,95,13,4,9
18882,8003,Bruntál,96,8,0,8
18883,8003,Bruntál,97,11,1,10
18884,8003,Bruntál,98,3,1,2
18885,8003,Bruntál,99,0,0,0
18886,8003,Bruntál,100,1,0,1
18887,8004,Český Těšín,0,227,117,110
18888,8004,Český Těšín,1,214,104,110
18889,8004,Český Těšín,2,243,130,113
18890,8004,Český Těšín,3,262,136,126
18891,8004,Český Těšín,4,268,148,120
18892,8004,Český Těšín,5,266,125,141
18893,8004,Český Těšín,6,258,122,136
18894,8004,Český Těšín,7,241,119,122
18895,8004,Český Těšín,8,252,122,130
18896,8004,Český Těšín,9,245,122,123
18897,8004,Český Těšín,10,282,145,137
18898,8004,Český Těšín,11,288,152,136
18899,8004,Český Těšín,12,299,156,143
18900,8004,Český Těšín,13,252,119,133
18901,8004,Český Těšín,14,270,117,153
18902,8004,Český Těšín,15,255,115,140
18903,8004,Český Těšín,16,247,126,121
18904,8004,Český Těšín,17,239,119,120
18905,8004,Český Těšín,18,256,117,139
18906,8004,Český Těšín,19,250,135,115
18907,8004,Český Těšín,20,261,134,127
18908,8004,Český Těšín,21,210,104,106
18909,8004,Český Těšín,22,247,112,135
18910,8004,Český Těšín,23,229,122,107
18911,8004,Český Těšín,24,236,124,112
18912,8004,Český Těšín,25,235,127,108
18913,8004,Český Těšín,26,276,151,125
18914,8004,Český Těšín,27,300,161,139
18915,8004,Český Těšín,28,325,172,153
18916,8004,Český Těšín,29,301,158,143
18917,8004,Český Těšín,30,302,160,142
18918,8004,Český Těšín,31,335,154,181
18919,8004,Český Těšín,32,360,184,176
18920,8004,Český Těšín,33,364,182,182
18921,8004,Český Těšín,34,393,204,189
18922,8004,Český Těšín,35,413,218,195
18923,8004,Český Těšín,36,345,185,160
18924,8004,Český Těšín,37,363,185,178
18925,8004,Český Těšín,38,331,179,152
18926,8004,Český Těšín,39,361,194,167
18927,8004,Český Těšín,40,325,173,152
18928,8004,Český Těšín,41,366,184,182
18929,8004,Český Těšín,42,434,212,222
18930,8004,Český Těšín,43,403,213,190
18931,8004,Český Těšín,44,420,207,213
18932,8004,Český Těšín,45,448,223,225
18933,8004,Český Těšín,46,398,207,191
18934,8004,Český Těšín,47,430,212,218
18935,8004,Český Těšín,48,356,192,164
18936,8004,Český Těšín,49,346,176,170
18937,8004,Český Těšín,50,313,157,156
18938,8004,Český Těšín,51,305,157,148
18939,8004,Český Těšín,52,294,135,159
18940,8004,Český Těšín,53,334,163,171
18941,8004,Český Těšín,54,396,190,206
18942,8004,Český Těšín,55,386,192,194
18943,8004,Český Těšín,56,412,193,219
18944,8004,Český Těšín,57,383,204,179
18945,8004,Český Těšín,58,355,176,179
18946,8004,Český Těšín,59,358,191,167
18947,8004,Český Těšín,60,302,150,152
18948,8004,Český Těšín,61,309,167,142
18949,8004,Český Těšín,62,300,141,159
18950,8004,Český Těšín,63,361,173,188
18951,8004,Český Těšín,64,401,180,221
18952,8004,Český Těšín,65,350,141,209
18953,8004,Český Těšín,66,324,150,174
18954,8004,Český Těšín,67,367,179,188
18955,8004,Český Těšín,68,330,140,190
18956,8004,Český Těšín,69,378,155,223
18957,8004,Český Těšín,70,335,151,184
18958,8004,Český Těšín,71,289,134,155
18959,8004,Český Těšín,72,256,109,147
18960,8004,Český Těšín,73,271,114,157
18961,8004,Český Těšín,74,215,81,134
18962,8004,Český Těšín,75,161,61,100
18963,8004,Český Těšín,76,206,97,109
18964,8004,Český Těšín,77,207,72,135
18965,8004,Český Těšín,78,206,68,138
18966,8004,Český Těšín,79,188,69,119
18967,8004,Český Těšín,80,152,56,96
18968,8004,Český Těšín,81,118,50,68
18969,8004,Český Těšín,82,93,39,54
18970,8004,Český Těšín,83,97,33,64
18971,8004,Český Těšín,84,82,32,50
18972,8004,Český Těšín,85,76,32,44
18973,8004,Český Těšín,86,57,23,34
18974,8004,Český Těšín,87,61,17,44
18975,8004,Český Těšín,88,44,11,33
18976,8004,Český Těšín,89,41,13,28
18977,8004,Český Těšín,90,31,6,25
18978,8004,Český Těšín,91,30,9,21
18979,8004,Český Těšín,92,19,4,15
18980,8004,Český Těšín,93,14,3,11
18981,8004,Český Těšín,94,17,5,12
18982,8004,Český Těšín,95,13,2,11
18983,8004,Český Těšín,96,6,1,5
18984,8004,Český Těšín,97,1,1,0
18985,8004,Český Těšín,98,1,0,1
18986,8004,Český Těšín,99,1,0,1
18987,8004,Český Těšín,100,5,1,4
18988,8005,Frenštát pod Radhoštěm,0,199,114,85
18989,8005,Frenštát pod Radhoštěm,1,199,98,101
18990,8005,Frenštát pod Radhoštěm,2,222,114,108
18991,8005,Frenštát pod Radhoštěm,3,203,98,105
18992,8005,Frenštát pod Radhoštěm,4,210,112,98
18993,8005,Frenštát pod Radhoštěm,5,207,122,85
18994,8005,Frenštát pod Radhoštěm,6,211,109,102
18995,8005,Frenštát pod Radhoštěm,7,216,111,105
18996,8005,Frenštát pod Radhoštěm,8,207,113,94
18997,8005,Frenštát pod Radhoštěm,9,212,115,97
18998,8005,Frenštát pod Radhoštěm,10,235,121,114
18999,8005,Frenštát pod Radhoštěm,11,207,108,99
19000,8005,Frenštát pod Radhoštěm,12,224,120,104
19001,8005,Frenštát pod Radhoštěm,13,206,107,99
19002,8005,Frenštát pod Radhoštěm,14,224,115,109
19003,8005,Frenštát pod Radhoštěm,15,192,101,91
19004,8005,Frenštát pod Radhoštěm,16,184,106,78
19005,8005,Frenštát pod Radhoštěm,17,185,98,87
19006,8005,Frenštát pod Radhoštěm,18,158,81,77
19007,8005,Frenštát pod Radhoštěm,19,183,102,81
19008,8005,Frenštát pod Radhoštěm,20,162,85,77
19009,8005,Frenštát pod Radhoštěm,21,188,90,98
19010,8005,Frenštát pod Radhoštěm,22,171,79,92
19011,8005,Frenštát pod Radhoštěm,23,167,87,80
19012,8005,Frenštát pod Radhoštěm,24,193,102,91
19013,8005,Frenštát pod Radhoštěm,25,204,106,98
19014,8005,Frenštát pod Radhoštěm,26,220,118,102
19015,8005,Frenštát pod Radhoštěm,27,252,120,132
19016,8005,Frenštát pod Radhoštěm,28,258,130,128
19017,8005,Frenštát pod Radhoštěm,29,269,118,151
19018,8005,Frenštát pod Radhoštěm,30,276,147,129
19019,8005,Frenštát pod Radhoštěm,31,255,148,107
19020,8005,Frenštát pod Radhoštěm,32,276,117,159
19021,8005,Frenštát pod Radhoštěm,33,265,145,120
19022,8005,Frenštát pod Radhoštěm,34,263,137,126
19023,8005,Frenštát pod Radhoštěm,35,239,115,124
19024,8005,Frenštát pod Radhoštěm,36,253,139,114
19025,8005,Frenštát pod Radhoštěm,37,276,153,123
19026,8005,Frenštát pod Radhoštěm,38,249,125,124
19027,8005,Frenštát pod Radhoštěm,39,247,127,120
19028,8005,Frenštát pod Radhoštěm,40,269,147,122
19029,8005,Frenštát pod Radhoštěm,41,307,158,149
19030,8005,Frenštát pod Radhoštěm,42,327,169,158
19031,8005,Frenštát pod Radhoštěm,43,286,145,141
19032,8005,Frenštát pod Radhoštěm,44,343,184,159
19033,8005,Frenštát pod Radhoštěm,45,322,167,155
19034,8005,Frenštát pod Radhoštěm,46,369,190,179
19035,8005,Frenštát pod Radhoštěm,47,295,152,143
19036,8005,Frenštát pod Radhoštěm,48,293,148,145
19037,8005,Frenštát pod Radhoštěm,49,304,144,160
19038,8005,Frenštát pod Radhoštěm,50,282,144,138
19039,8005,Frenštát pod Radhoštěm,51,264,137,127
19040,8005,Frenštát pod Radhoštěm,52,263,134,129
19041,8005,Frenštát pod Radhoštěm,53,244,127,117
19042,8005,Frenštát pod Radhoštěm,54,227,107,120
19043,8005,Frenštát pod Radhoštěm,55,272,148,124
19044,8005,Frenštát pod Radhoštěm,56,272,148,124
19045,8005,Frenštát pod Radhoštěm,57,264,140,124
19046,8005,Frenštát pod Radhoštěm,58,248,135,113
19047,8005,Frenštát pod Radhoštěm,59,227,110,117
19048,8005,Frenštát pod Radhoštěm,60,259,127,132
19049,8005,Frenštát pod Radhoštěm,61,216,104,112
19050,8005,Frenštát pod Radhoštěm,62,238,119,119
19051,8005,Frenštát pod Radhoštěm,63,234,115,119
19052,8005,Frenštát pod Radhoštěm,64,218,112,106
19053,8005,Frenštát pod Radhoštěm,65,235,114,121
19054,8005,Frenštát pod Radhoštěm,66,274,114,160
19055,8005,Frenštát pod Radhoštěm,67,239,104,135
19056,8005,Frenštát pod Radhoštěm,68,249,98,151
19057,8005,Frenštát pod Radhoštěm,69,265,121,144
19058,8005,Frenštát pod Radhoštěm,70,217,105,112
19059,8005,Frenštát pod Radhoštěm,71,245,105,140
19060,8005,Frenštát pod Radhoštěm,72,214,97,117
19061,8005,Frenštát pod Radhoštěm,73,211,95,116
19062,8005,Frenštát pod Radhoštěm,74,198,65,133
19063,8005,Frenštát pod Radhoštěm,75,177,84,93
19064,8005,Frenštát pod Radhoštěm,76,157,66,91
19065,8005,Frenštát pod Radhoštěm,77,161,52,109
19066,8005,Frenštát pod Radhoštěm,78,128,52,76
19067,8005,Frenštát pod Radhoštěm,79,141,56,85
19068,8005,Frenštát pod Radhoštěm,80,149,65,84
19069,8005,Frenštát pod Radhoštěm,81,91,30,61
19070,8005,Frenštát pod Radhoštěm,82,71,29,42
19071,8005,Frenštát pod Radhoštěm,83,76,23,53
19072,8005,Frenštát pod Radhoštěm,84,52,19,33
19073,8005,Frenštát pod Radhoštěm,85,64,23,41
19074,8005,Frenštát pod Radhoštěm,86,39,10,29
19075,8005,Frenštát pod Radhoštěm,87,57,23,34
19076,8005,Frenštát pod Radhoštěm,88,37,7,30
19077,8005,Frenštát pod Radhoštěm,89,41,13,28
19078,8005,Frenštát pod Radhoštěm,90,27,8,19
19079,8005,Frenštát pod Radhoštěm,91,24,10,14
19080,8005,Frenštát pod Radhoštěm,92,15,2,13
19081,8005,Frenštát pod Radhoštěm,93,6,1,5
19082,8005,Frenštát pod Radhoštěm,94,12,5,7
19083,8005,Frenštát pod Radhoštěm,95,11,1,10
19084,8005,Frenštát pod Radhoštěm,96,2,0,2
19085,8005,Frenštát pod Radhoštěm,97,7,1,6
19086,8005,Frenštát pod Radhoštěm,98,4,0,4
19087,8005,Frenštát pod Radhoštěm,99,0,0,0
19088,8005,Frenštát pod Radhoštěm,100,0,0,0
19089,8006,Frýdek-Místek,0,1154,570,584
19090,8006,Frýdek-Místek,1,1136,594,542
19091,8006,Frýdek-Místek,2,1229,665,564
19092,8006,Frýdek-Místek,3,1239,615,624
19093,8006,Frýdek-Místek,4,1204,630,574
19094,8006,Frýdek-Místek,5,1151,581,570
19095,8006,Frýdek-Místek,6,1158,594,564
19096,8006,Frýdek-Místek,7,1124,588,536
19097,8006,Frýdek-Místek,8,1149,608,541
19098,8006,Frýdek-Místek,9,1128,604,524
19099,8006,Frýdek-Místek,10,1326,674,652
19100,8006,Frýdek-Místek,11,1272,659,613
19101,8006,Frýdek-Místek,12,1255,638,617
19102,8006,Frýdek-Místek,13,1288,662,626
19103,8006,Frýdek-Místek,14,1129,574,555
19104,8006,Frýdek-Místek,15,1122,553,569
19105,8006,Frýdek-Místek,16,1047,516,531
19106,8006,Frýdek-Místek,17,1056,523,533
19107,8006,Frýdek-Místek,18,1011,508,503
19108,8006,Frýdek-Místek,19,961,504,457
19109,8006,Frýdek-Místek,20,1019,541,478
19110,8006,Frýdek-Místek,21,1004,532,472
19111,8006,Frýdek-Místek,22,1038,503,535
19112,8006,Frýdek-Místek,23,1006,493,513
19113,8006,Frýdek-Místek,24,1030,545,485
19114,8006,Frýdek-Místek,25,1177,604,573
19115,8006,Frýdek-Místek,26,1165,600,565
19116,8006,Frýdek-Místek,27,1418,735,683
19117,8006,Frýdek-Místek,28,1426,749,677
19118,8006,Frýdek-Místek,29,1501,751,750
19119,8006,Frýdek-Místek,30,1574,831,743
19120,8006,Frýdek-Místek,31,1516,754,762
19121,8006,Frýdek-Místek,32,1547,809,738
19122,8006,Frýdek-Místek,33,1533,799,734
19123,8006,Frýdek-Místek,34,1467,780,687
19124,8006,Frýdek-Místek,35,1496,793,703
19125,8006,Frýdek-Místek,36,1473,784,689
19126,8006,Frýdek-Místek,37,1498,782,716
19127,8006,Frýdek-Místek,38,1560,795,765
19128,8006,Frýdek-Místek,39,1412,719,693
19129,8006,Frýdek-Místek,40,1538,774,764
19130,8006,Frýdek-Místek,41,1653,884,769
19131,8006,Frýdek-Místek,42,1763,901,862
19132,8006,Frýdek-Místek,43,1928,1008,920
19133,8006,Frýdek-Místek,44,1938,977,961
19134,8006,Frýdek-Místek,45,1977,1008,969
19135,8006,Frýdek-Místek,46,2013,1037,976
19136,8006,Frýdek-Místek,47,1963,1009,954
19137,8006,Frýdek-Místek,48,1743,896,847
19138,8006,Frýdek-Místek,49,1774,906,868
19139,8006,Frýdek-Místek,50,1556,772,784
19140,8006,Frýdek-Místek,51,1548,775,773
19141,8006,Frýdek-Místek,52,1461,722,739
19142,8006,Frýdek-Místek,53,1555,789,766
19143,8006,Frýdek-Místek,54,1592,844,748
19144,8006,Frýdek-Místek,55,1609,837,772
19145,8006,Frýdek-Místek,56,1684,846,838
19146,8006,Frýdek-Místek,57,1514,787,727
19147,8006,Frýdek-Místek,58,1433,686,747
19148,8006,Frýdek-Místek,59,1347,696,651
19149,8006,Frýdek-Místek,60,1314,664,650
19150,8006,Frýdek-Místek,61,1264,601,663
19151,8006,Frýdek-Místek,62,1305,635,670
19152,8006,Frýdek-Místek,63,1428,698,730
19153,8006,Frýdek-Místek,64,1410,643,767
19154,8006,Frýdek-Místek,65,1329,641,688
19155,8006,Frýdek-Místek,66,1334,613,721
19156,8006,Frýdek-Místek,67,1358,611,747
19157,8006,Frýdek-Místek,68,1451,651,800
19158,8006,Frýdek-Místek,69,1413,634,779
19159,8006,Frýdek-Místek,70,1369,606,763
19160,8006,Frýdek-Místek,71,1403,621,782
19161,8006,Frýdek-Místek,72,1321,597,724
19162,8006,Frýdek-Místek,73,1221,505,716
19163,8006,Frýdek-Místek,74,1149,481,668
19164,8006,Frýdek-Místek,75,968,414,554
19165,8006,Frýdek-Místek,76,1013,388,625
19166,8006,Frýdek-Místek,77,959,397,562
19167,8006,Frýdek-Místek,78,794,319,475
19168,8006,Frýdek-Místek,79,776,295,481
19169,8006,Frýdek-Místek,80,712,309,403
19170,8006,Frýdek-Místek,81,540,229,311
19171,8006,Frýdek-Místek,82,439,182,257
19172,8006,Frýdek-Místek,83,363,149,214
19173,8006,Frýdek-Místek,84,334,106,228
19174,8006,Frýdek-Místek,85,290,89,201
19175,8006,Frýdek-Místek,86,246,82,164
19176,8006,Frýdek-Místek,87,218,58,160
19177,8006,Frýdek-Místek,88,210,66,144
19178,8006,Frýdek-Místek,89,176,48,128
19179,8006,Frýdek-Místek,90,157,37,120
19180,8006,Frýdek-Místek,91,119,25,94
19181,8006,Frýdek-Místek,92,98,32,66
19182,8006,Frýdek-Místek,93,61,14,47
19183,8006,Frýdek-Místek,94,49,10,39
19184,8006,Frýdek-Místek,95,38,12,26
19185,8006,Frýdek-Místek,96,25,3,22
19186,8006,Frýdek-Místek,97,25,0,25
19187,8006,Frýdek-Místek,98,11,1,10
19188,8006,Frýdek-Místek,99,5,0,5
19189,8006,Frýdek-Místek,100,6,2,4
19190,8007,Frýdlant nad Ostravicí,0,245,123,122
19191,8007,Frýdlant nad Ostravicí,1,246,124,122
19192,8007,Frýdlant nad Ostravicí,2,249,129,120
19193,8007,Frýdlant nad Ostravicí,3,284,136,148
19194,8007,Frýdlant nad Ostravicí,4,266,136,130
19195,8007,Frýdlant nad Ostravicí,5,262,155,107
19196,8007,Frýdlant nad Ostravicí,6,281,152,129
19197,8007,Frýdlant nad Ostravicí,7,263,146,117
19198,8007,Frýdlant nad Ostravicí,8,268,124,144
19199,8007,Frýdlant nad Ostravicí,9,289,146,143
19200,8007,Frýdlant nad Ostravicí,10,277,152,125
19201,8007,Frýdlant nad Ostravicí,11,284,150,134
19202,8007,Frýdlant nad Ostravicí,12,304,146,158
19203,8007,Frýdlant nad Ostravicí,13,318,157,161
19204,8007,Frýdlant nad Ostravicí,14,238,125,113
19205,8007,Frýdlant nad Ostravicí,15,253,124,129
19206,8007,Frýdlant nad Ostravicí,16,266,139,127
19207,8007,Frýdlant nad Ostravicí,17,241,125,116
19208,8007,Frýdlant nad Ostravicí,18,202,91,111
19209,8007,Frýdlant nad Ostravicí,19,228,119,109
19210,8007,Frýdlant nad Ostravicí,20,224,105,119
19211,8007,Frýdlant nad Ostravicí,21,211,108,103
19212,8007,Frýdlant nad Ostravicí,22,202,99,103
19213,8007,Frýdlant nad Ostravicí,23,211,103,108
19214,8007,Frýdlant nad Ostravicí,24,218,116,102
19215,8007,Frýdlant nad Ostravicí,25,230,119,111
19216,8007,Frýdlant nad Ostravicí,26,252,130,122
19217,8007,Frýdlant nad Ostravicí,27,255,136,119
19218,8007,Frýdlant nad Ostravicí,28,274,138,136
19219,8007,Frýdlant nad Ostravicí,29,277,153,124
19220,8007,Frýdlant nad Ostravicí,30,298,154,144
19221,8007,Frýdlant nad Ostravicí,31,285,155,130
19222,8007,Frýdlant nad Ostravicí,32,314,161,153
19223,8007,Frýdlant nad Ostravicí,33,296,155,141
19224,8007,Frýdlant nad Ostravicí,34,294,141,153
19225,8007,Frýdlant nad Ostravicí,35,339,164,175
19226,8007,Frýdlant nad Ostravicí,36,324,156,168
19227,8007,Frýdlant nad Ostravicí,37,345,163,182
19228,8007,Frýdlant nad Ostravicí,38,339,156,183
19229,8007,Frýdlant nad Ostravicí,39,349,187,162
19230,8007,Frýdlant nad Ostravicí,40,338,182,156
19231,8007,Frýdlant nad Ostravicí,41,407,218,189
19232,8007,Frýdlant nad Ostravicí,42,380,172,208
19233,8007,Frýdlant nad Ostravicí,43,460,234,226
19234,8007,Frýdlant nad Ostravicí,44,442,225,217
19235,8007,Frýdlant nad Ostravicí,45,460,247,213
19236,8007,Frýdlant nad Ostravicí,46,475,243,232
19237,8007,Frýdlant nad Ostravicí,47,434,225,209
19238,8007,Frýdlant nad Ostravicí,48,415,222,193
19239,8007,Frýdlant nad Ostravicí,49,399,209,190
19240,8007,Frýdlant nad Ostravicí,50,348,178,170
19241,8007,Frýdlant nad Ostravicí,51,332,169,163
19242,8007,Frýdlant nad Ostravicí,52,294,155,139
19243,8007,Frýdlant nad Ostravicí,53,353,158,195
19244,8007,Frýdlant nad Ostravicí,54,339,173,166
19245,8007,Frýdlant nad Ostravicí,55,359,198,161
19246,8007,Frýdlant nad Ostravicí,56,327,175,152
19247,8007,Frýdlant nad Ostravicí,57,317,162,155
19248,8007,Frýdlant nad Ostravicí,58,312,151,161
19249,8007,Frýdlant nad Ostravicí,59,305,165,140
19250,8007,Frýdlant nad Ostravicí,60,307,173,134
19251,8007,Frýdlant nad Ostravicí,61,313,167,146
19252,8007,Frýdlant nad Ostravicí,62,263,125,138
19253,8007,Frýdlant nad Ostravicí,63,323,156,167
19254,8007,Frýdlant nad Ostravicí,64,305,156,149
19255,8007,Frýdlant nad Ostravicí,65,321,161,160
19256,8007,Frýdlant nad Ostravicí,66,377,197,180
19257,8007,Frýdlant nad Ostravicí,67,345,164,181
19258,8007,Frýdlant nad Ostravicí,68,310,139,171
19259,8007,Frýdlant nad Ostravicí,69,331,157,174
19260,8007,Frýdlant nad Ostravicí,70,319,140,179
19261,8007,Frýdlant nad Ostravicí,71,332,136,196
19262,8007,Frýdlant nad Ostravicí,72,288,149,139
19263,8007,Frýdlant nad Ostravicí,73,305,143,162
19264,8007,Frýdlant nad Ostravicí,74,248,114,134
19265,8007,Frýdlant nad Ostravicí,75,248,98,150
19266,8007,Frýdlant nad Ostravicí,76,250,101,149
19267,8007,Frýdlant nad Ostravicí,77,249,98,151
19268,8007,Frýdlant nad Ostravicí,78,183,82,101
19269,8007,Frýdlant nad Ostravicí,79,186,78,108
19270,8007,Frýdlant nad Ostravicí,80,146,63,83
19271,8007,Frýdlant nad Ostravicí,81,105,43,62
19272,8007,Frýdlant nad Ostravicí,82,120,40,80
19273,8007,Frýdlant nad Ostravicí,83,85,32,53
19274,8007,Frýdlant nad Ostravicí,84,91,34,57
19275,8007,Frýdlant nad Ostravicí,85,69,23,46
19276,8007,Frýdlant nad Ostravicí,86,81,24,57
19277,8007,Frýdlant nad Ostravicí,87,76,18,58
19278,8007,Frýdlant nad Ostravicí,88,58,16,42
19279,8007,Frýdlant nad Ostravicí,89,55,12,43
19280,8007,Frýdlant nad Ostravicí,90,43,12,31
19281,8007,Frýdlant nad Ostravicí,91,34,6,28
19282,8007,Frýdlant nad Ostravicí,92,17,1,16
19283,8007,Frýdlant nad Ostravicí,93,18,4,14
19284,8007,Frýdlant nad Ostravicí,94,16,1,15
19285,8007,Frýdlant nad Ostravicí,95,8,0,8
19286,8007,Frýdlant nad Ostravicí,96,4,0,4
19287,8007,Frýdlant nad Ostravicí,97,3,2,1
19288,8007,Frýdlant nad Ostravicí,98,1,1,0
19289,8007,Frýdlant nad Ostravicí,99,2,0,2
19290,8007,Frýdlant nad Ostravicí,100,3,1,2
19291,8008,Havířov,0,801,427,374
19292,8008,Havířov,1,774,387,387
19293,8008,Havířov,2,831,412,419
19294,8008,Havířov,3,751,414,337
19295,8008,Havířov,4,788,409,379
19296,8008,Havířov,5,773,420,353
19297,8008,Havířov,6,781,397,384
19298,8008,Havířov,7,770,384,386
19299,8008,Havířov,8,779,417,362
19300,8008,Havířov,9,760,387,373
19301,8008,Havířov,10,904,456,448
19302,8008,Havířov,11,886,425,461
19303,8008,Havířov,12,920,438,482
19304,8008,Havířov,13,958,499,459
19305,8008,Havířov,14,862,449,413
19306,8008,Havířov,15,777,428,349
19307,8008,Havířov,16,768,411,357
19308,8008,Havířov,17,777,413,364
19309,8008,Havířov,18,765,410,355
19310,8008,Havířov,19,766,404,362
19311,8008,Havířov,20,788,400,388
19312,8008,Havířov,21,770,389,381
19313,8008,Havířov,22,803,390,413
19314,8008,Havířov,23,764,399,365
19315,8008,Havířov,24,855,460,395
19316,8008,Havířov,25,913,478,435
19317,8008,Havířov,26,1012,533,479
19318,8008,Havířov,27,1063,547,516
19319,8008,Havířov,28,1098,585,513
19320,8008,Havířov,29,1181,628,553
19321,8008,Havířov,30,1184,641,543
19322,8008,Havířov,31,1055,554,501
19323,8008,Havířov,32,1094,565,529
19324,8008,Havířov,33,1109,584,525
19325,8008,Havířov,34,1070,584,486
19326,8008,Havířov,35,1117,595,522
19327,8008,Havířov,36,1061,583,478
19328,8008,Havířov,37,1123,576,547
19329,8008,Havířov,38,1024,536,488
19330,8008,Havířov,39,1046,536,510
19331,8008,Havířov,40,1059,573,486
19332,8008,Havířov,41,1178,607,571
19333,8008,Havířov,42,1218,617,601
19334,8008,Havířov,43,1287,677,610
19335,8008,Havířov,44,1274,653,621
19336,8008,Havířov,45,1285,650,635
19337,8008,Havířov,46,1344,658,686
19338,8008,Havířov,47,1312,677,635
19339,8008,Havířov,48,1296,638,658
19340,8008,Havířov,49,1252,646,606
19341,8008,Havířov,50,1200,586,614
19342,8008,Havířov,51,1210,617,593
19343,8008,Havířov,52,1120,533,587
19344,8008,Havířov,53,1243,657,586
19345,8008,Havířov,54,1299,660,639
19346,8008,Havířov,55,1289,613,676
19347,8008,Havířov,56,1415,697,718
19348,8008,Havířov,57,1253,609,644
19349,8008,Havířov,58,1233,624,609
19350,8008,Havířov,59,1152,579,573
19351,8008,Havířov,60,1147,554,593
19352,8008,Havířov,61,1043,517,526
19353,8008,Havířov,62,1186,598,588
19354,8008,Havířov,63,1214,606,608
19355,8008,Havířov,64,1128,546,582
19356,8008,Havířov,65,1139,519,620
19357,8008,Havířov,66,1027,477,550
19358,8008,Havířov,67,1041,467,574
19359,8008,Havířov,68,1089,509,580
19360,8008,Havířov,69,1094,461,633
19361,8008,Havířov,70,1058,450,608
19362,8008,Havířov,71,991,455,536
19363,8008,Havířov,72,1082,439,643
19364,8008,Havířov,73,1027,412,615
19365,8008,Havířov,74,860,303,557
19366,8008,Havířov,75,767,282,485
19367,8008,Havířov,76,874,330,544
19368,8008,Havířov,77,818,306,512
19369,8008,Havířov,78,751,290,461
19370,8008,Havířov,79,757,279,478
19371,8008,Havířov,80,678,230,448
19372,8008,Havířov,81,567,193,374
19373,8008,Havířov,82,477,178,299
19374,8008,Havířov,83,435,159,276
19375,8008,Havířov,84,372,132,240
19376,8008,Havířov,85,343,115,228
19377,8008,Havířov,86,275,79,196
19378,8008,Havířov,87,248,62,186
19379,8008,Havířov,88,204,52,152
19380,8008,Havířov,89,150,35,115
19381,8008,Havířov,90,135,38,97
19382,8008,Havířov,91,109,30,79
19383,8008,Havířov,92,80,26,54
19384,8008,Havířov,93,60,17,43
19385,8008,Havířov,94,32,9,23
19386,8008,Havířov,95,33,10,23
19387,8008,Havířov,96,13,6,7
19388,8008,Havířov,97,10,2,8
19389,8008,Havířov,98,10,1,9
19390,8008,Havířov,99,7,1,6
19391,8008,Havířov,100,7,3,4
19392,8009,Hlučín,0,395,203,192
19393,8009,Hlučín,1,411,219,192
19394,8009,Hlučín,2,459,247,212
19395,8009,Hlučín,3,395,198,197
19396,8009,Hlučín,4,440,237,203
19397,8009,Hlučín,5,417,205,212
19398,8009,Hlučín,6,434,213,221
19399,8009,Hlučín,7,456,224,232
19400,8009,Hlučín,8,397,211,186
19401,8009,Hlučín,9,427,224,203
19402,8009,Hlučín,10,428,210,218
19403,8009,Hlučín,11,447,226,221
19404,8009,Hlučín,12,465,236,229
19405,8009,Hlučín,13,463,223,240
19406,8009,Hlučín,14,456,237,219
19407,8009,Hlučín,15,423,221,202
19408,8009,Hlučín,16,386,196,190
19409,8009,Hlučín,17,361,176,185
19410,8009,Hlučín,18,352,179,173
19411,8009,Hlučín,19,378,199,179
19412,8009,Hlučín,20,354,178,176
19413,8009,Hlučín,21,360,183,177
19414,8009,Hlučín,22,379,202,177
19415,8009,Hlučín,23,410,221,189
19416,8009,Hlučín,24,358,190,168
19417,8009,Hlučín,25,399,203,196
19418,8009,Hlučín,26,386,200,186
19419,8009,Hlučín,27,503,254,249
19420,8009,Hlučín,28,450,240,210
19421,8009,Hlučín,29,501,256,245
19422,8009,Hlučín,30,560,287,273
19423,8009,Hlučín,31,490,265,225
19424,8009,Hlučín,32,536,262,274
19425,8009,Hlučín,33,500,240,260
19426,8009,Hlučín,34,539,261,278
19427,8009,Hlučín,35,523,262,261
19428,8009,Hlučín,36,559,278,281
19429,8009,Hlučín,37,559,276,283
19430,8009,Hlučín,38,601,313,288
19431,8009,Hlučín,39,580,297,283
19432,8009,Hlučín,40,608,319,289
19433,8009,Hlučín,41,629,332,297
19434,8009,Hlučín,42,694,338,356
19435,8009,Hlučín,43,636,318,318
19436,8009,Hlučín,44,685,351,334
19437,8009,Hlučín,45,714,366,348
19438,8009,Hlučín,46,711,354,357
19439,8009,Hlučín,47,691,363,328
19440,8009,Hlučín,48,617,324,293
19441,8009,Hlučín,49,586,295,291
19442,8009,Hlučín,50,594,299,295
19443,8009,Hlučín,51,525,269,256
19444,8009,Hlučín,52,547,276,271
19445,8009,Hlučín,53,545,285,260
19446,8009,Hlučín,54,554,296,258
19447,8009,Hlučín,55,580,313,267
19448,8009,Hlučín,56,586,290,296
19449,8009,Hlučín,57,585,297,288
19450,8009,Hlučín,58,526,261,265
19451,8009,Hlučín,59,534,249,285
19452,8009,Hlučín,60,488,243,245
19453,8009,Hlučín,61,505,238,267
19454,8009,Hlučín,62,543,270,273
19455,8009,Hlučín,63,512,241,271
19456,8009,Hlučín,64,513,258,255
19457,8009,Hlučín,65,520,231,289
19458,8009,Hlučín,66,534,262,272
19459,8009,Hlučín,67,501,241,260
19460,8009,Hlučín,68,451,214,237
19461,8009,Hlučín,69,550,267,283
19462,8009,Hlučín,70,474,193,281
19463,8009,Hlučín,71,483,213,270
19464,8009,Hlučín,72,433,193,240
19465,8009,Hlučín,73,415,181,234
19466,8009,Hlučín,74,326,137,189
19467,8009,Hlučín,75,262,87,175
19468,8009,Hlučín,76,312,110,202
19469,8009,Hlučín,77,321,130,191
19470,8009,Hlučín,78,263,98,165
19471,8009,Hlučín,79,270,95,175
19472,8009,Hlučín,80,319,134,185
19473,8009,Hlučín,81,331,111,220
19474,8009,Hlučín,82,181,63,118
19475,8009,Hlučín,83,179,66,113
19476,8009,Hlučín,84,163,63,100
19477,8009,Hlučín,85,125,41,84
19478,8009,Hlučín,86,106,39,67
19479,8009,Hlučín,87,119,35,84
19480,8009,Hlučín,88,97,25,72
19481,8009,Hlučín,89,73,21,52
19482,8009,Hlučín,90,57,14,43
19483,8009,Hlučín,91,41,9,32
19484,8009,Hlučín,92,31,3,28
19485,8009,Hlučín,93,15,3,12
19486,8009,Hlučín,94,15,4,11
19487,8009,Hlučín,95,12,3,9
19488,8009,Hlučín,96,12,1,11
19489,8009,Hlučín,97,8,0,8
19490,8009,Hlučín,98,4,1,3
19491,8009,Hlučín,99,2,0,2
19492,8009,Hlučín,100,6,1,5
19493,8010,Jablunkov,0,240,107,133
19494,8010,Jablunkov,1,247,130,117
19495,8010,Jablunkov,2,253,132,121
19496,8010,Jablunkov,3,269,150,119
19497,8010,Jablunkov,4,255,133,122
19498,8010,Jablunkov,5,248,131,117
19499,8010,Jablunkov,6,238,108,130
19500,8010,Jablunkov,7,248,130,118
19501,8010,Jablunkov,8,265,121,144
19502,8010,Jablunkov,9,218,114,104
19503,8010,Jablunkov,10,287,146,141
19504,8010,Jablunkov,11,280,146,134
19505,8010,Jablunkov,12,255,129,126
19506,8010,Jablunkov,13,254,134,120
19507,8010,Jablunkov,14,248,126,122
19508,8010,Jablunkov,15,227,103,124
19509,8010,Jablunkov,16,251,126,125
19510,8010,Jablunkov,17,218,105,113
19511,8010,Jablunkov,18,243,119,124
19512,8010,Jablunkov,19,225,127,98
19513,8010,Jablunkov,20,229,126,103
19514,8010,Jablunkov,21,207,109,98
19515,8010,Jablunkov,22,228,112,116
19516,8010,Jablunkov,23,251,140,111
19517,8010,Jablunkov,24,228,114,114
19518,8010,Jablunkov,25,219,121,98
19519,8010,Jablunkov,26,264,153,111
19520,8010,Jablunkov,27,303,154,149
19521,8010,Jablunkov,28,292,162,130
19522,8010,Jablunkov,29,297,156,141
19523,8010,Jablunkov,30,304,157,147
19524,8010,Jablunkov,31,335,158,177
19525,8010,Jablunkov,32,305,169,136
19526,8010,Jablunkov,33,304,150,154
19527,8010,Jablunkov,34,299,156,143
19528,8010,Jablunkov,35,313,161,152
19529,8010,Jablunkov,36,311,171,140
19530,8010,Jablunkov,37,280,152,128
19531,8010,Jablunkov,38,332,177,155
19532,8010,Jablunkov,39,337,178,159
19533,8010,Jablunkov,40,337,184,153
19534,8010,Jablunkov,41,398,200,198
19535,8010,Jablunkov,42,364,201,163
19536,8010,Jablunkov,43,402,205,197
19537,8010,Jablunkov,44,358,178,180
19538,8010,Jablunkov,45,352,183,169
19539,8010,Jablunkov,46,341,164,177
19540,8010,Jablunkov,47,345,173,172
19541,8010,Jablunkov,48,341,187,154
19542,8010,Jablunkov,49,330,173,157
19543,8010,Jablunkov,50,270,139,131
19544,8010,Jablunkov,51,262,140,122
19545,8010,Jablunkov,52,277,147,130
19546,8010,Jablunkov,53,283,139,144
19547,8010,Jablunkov,54,274,123,151
19548,8010,Jablunkov,55,326,158,168
19549,8010,Jablunkov,56,311,164,147
19550,8010,Jablunkov,57,319,168,151
19551,8010,Jablunkov,58,336,178,158
19552,8010,Jablunkov,59,311,152,159
19553,8010,Jablunkov,60,291,149,142
19554,8010,Jablunkov,61,278,145,133
19555,8010,Jablunkov,62,293,136,157
19556,8010,Jablunkov,63,313,149,164
19557,8010,Jablunkov,64,326,165,161
19558,8010,Jablunkov,65,279,143,136
19559,8010,Jablunkov,66,293,139,154
19560,8010,Jablunkov,67,281,143,138
19561,8010,Jablunkov,68,291,139,152
19562,8010,Jablunkov,69,261,132,129
19563,8010,Jablunkov,70,257,104,153
19564,8010,Jablunkov,71,206,97,109
19565,8010,Jablunkov,72,250,110,140
19566,8010,Jablunkov,73,232,118,114
19567,8010,Jablunkov,74,155,57,98
19568,8010,Jablunkov,75,97,39,58
19569,8010,Jablunkov,76,111,36,75
19570,8010,Jablunkov,77,133,52,81
19571,8010,Jablunkov,78,130,44,86
19572,8010,Jablunkov,79,138,33,105
19573,8010,Jablunkov,80,131,43,88
19574,8010,Jablunkov,81,108,32,76
19575,8010,Jablunkov,82,97,37,60
19576,8010,Jablunkov,83,86,29,57
19577,8010,Jablunkov,84,72,21,51
19578,8010,Jablunkov,85,68,17,51
19579,8010,Jablunkov,86,81,22,59
19580,8010,Jablunkov,87,40,14,26
19581,8010,Jablunkov,88,61,17,44
19582,8010,Jablunkov,89,42,11,31
19583,8010,Jablunkov,90,37,9,28
19584,8010,Jablunkov,91,28,10,18
19585,8010,Jablunkov,92,22,10,12
19586,8010,Jablunkov,93,13,5,8
19587,8010,Jablunkov,94,9,3,6
19588,8010,Jablunkov,95,8,4,4
19589,8010,Jablunkov,96,5,1,4
19590,8010,Jablunkov,97,1,0,1
19591,8010,Jablunkov,98,4,1,3
19592,8010,Jablunkov,99,2,1,1
19593,8010,Jablunkov,100,2,0,2
19594,8011,Karviná,0,517,257,260
19595,8011,Karviná,1,591,295,296
19596,8011,Karviná,2,541,287,254
19597,8011,Karviná,3,577,300,277
19598,8011,Karviná,4,553,295,258
19599,8011,Karviná,5,541,279,262
19600,8011,Karviná,6,533,269,264
19601,8011,Karviná,7,546,284,262
19602,8011,Karviná,8,545,281,264
19603,8011,Karviná,9,554,270,284
19604,8011,Karviná,10,630,327,303
19605,8011,Karviná,11,651,332,319
19606,8011,Karviná,12,641,312,329
19607,8011,Karviná,13,634,321,313
19608,8011,Karviná,14,591,306,285
19609,8011,Karviná,15,521,269,252
19610,8011,Karviná,16,586,328,258
19611,8011,Karviná,17,540,273,267
19612,8011,Karviná,18,595,328,267
19613,8011,Karviná,19,567,314,253
19614,8011,Karviná,20,561,310,251
19615,8011,Karviná,21,609,286,323
19616,8011,Karviná,22,574,317,257
19617,8011,Karviná,23,548,261,287
19618,8011,Karviná,24,648,339,309
19619,8011,Karviná,25,655,325,330
19620,8011,Karviná,26,689,361,328
19621,8011,Karviná,27,820,416,404
19622,8011,Karviná,28,814,438,376
19623,8011,Karviná,29,799,448,351
19624,8011,Karviná,30,850,458,392
19625,8011,Karviná,31,790,403,387
19626,8011,Karviná,32,791,414,377
19627,8011,Karviná,33,817,457,360
19628,8011,Karviná,34,817,409,408
19629,8011,Karviná,35,813,410,403
19630,8011,Karviná,36,741,401,340
19631,8011,Karviná,37,759,419,340
19632,8011,Karviná,38,757,392,365
19633,8011,Karviná,39,728,371,357
19634,8011,Karviná,40,762,419,343
19635,8011,Karviná,41,854,465,389
19636,8011,Karviná,42,864,464,400
19637,8011,Karviná,43,854,449,405
19638,8011,Karviná,44,892,459,433
19639,8011,Karviná,45,907,470,437
19640,8011,Karviná,46,1059,518,541
19641,8011,Karviná,47,1077,540,537
19642,8011,Karviná,48,988,494,494
19643,8011,Karviná,49,955,466,489
19644,8011,Karviná,50,931,489,442
19645,8011,Karviná,51,928,489,439
19646,8011,Karviná,52,890,486,404
19647,8011,Karviná,53,854,425,429
19648,8011,Karviná,54,944,484,460
19649,8011,Karviná,55,896,432,464
19650,8011,Karviná,56,1026,530,496
19651,8011,Karviná,57,987,487,500
19652,8011,Karviná,58,875,424,451
19653,8011,Karviná,59,801,392,409
19654,8011,Karviná,60,788,368,420
19655,8011,Karviná,61,745,383,362
19656,8011,Karviná,62,820,398,422
19657,8011,Karviná,63,774,356,418
19658,8011,Karviná,64,836,409,427
19659,8011,Karviná,65,848,410,438
19660,8011,Karviná,66,745,360,385
19661,8011,Karviná,67,763,311,452
19662,8011,Karviná,68,804,329,475
19663,8011,Karviná,69,802,351,451
19664,8011,Karviná,70,778,333,445
19665,8011,Karviná,71,726,308,418
19666,8011,Karviná,72,779,327,452
19667,8011,Karviná,73,764,307,457
19668,8011,Karviná,74,650,249,401
19669,8011,Karviná,75,562,207,355
19670,8011,Karviná,76,615,191,424
19671,8011,Karviná,77,622,221,401
19672,8011,Karviná,78,604,218,386
19673,8011,Karviná,79,593,201,392
19674,8011,Karviná,80,472,180,292
19675,8011,Karviná,81,411,140,271
19676,8011,Karviná,82,334,122,212
19677,8011,Karviná,83,271,111,160
19678,8011,Karviná,84,248,78,170
19679,8011,Karviná,85,193,77,116
19680,8011,Karviná,86,169,58,111
19681,8011,Karviná,87,135,41,94
19682,8011,Karviná,88,105,44,61
19683,8011,Karviná,89,107,31,76
19684,8011,Karviná,90,75,19,56
19685,8011,Karviná,91,51,9,42
19686,8011,Karviná,92,36,5,31
19687,8011,Karviná,93,45,11,34
19688,8011,Karviná,94,23,5,18
19689,8011,Karviná,95,19,6,13
19690,8011,Karviná,96,7,4,3
19691,8011,Karviná,97,10,3,7
19692,8011,Karviná,98,4,2,2
19693,8011,Karviná,99,4,0,4
19694,8011,Karviná,100,3,1,2
19695,8012,Kopřivnice,0,412,204,208
19696,8012,Kopřivnice,1,446,235,211
19697,8012,Kopřivnice,2,482,236,246
19698,8012,Kopřivnice,3,429,226,203
19699,8012,Kopřivnice,4,418,203,215
19700,8012,Kopřivnice,5,439,236,203
19701,8012,Kopřivnice,6,443,228,215
19702,8012,Kopřivnice,7,393,207,186
19703,8012,Kopřivnice,8,396,205,191
19704,8012,Kopřivnice,9,393,201,192
19705,8012,Kopřivnice,10,447,240,207
19706,8012,Kopřivnice,11,459,251,208
19707,8012,Kopřivnice,12,420,221,199
19708,8012,Kopřivnice,13,467,222,245
19709,8012,Kopřivnice,14,404,202,202
19710,8012,Kopřivnice,15,415,206,209
19711,8012,Kopřivnice,16,415,229,186
19712,8012,Kopřivnice,17,369,184,185
19713,8012,Kopřivnice,18,356,180,176
19714,8012,Kopřivnice,19,378,194,184
19715,8012,Kopřivnice,20,369,194,175
19716,8012,Kopřivnice,21,357,175,182
19717,8012,Kopřivnice,22,368,203,165
19718,8012,Kopřivnice,23,404,228,176
19719,8012,Kopřivnice,24,373,184,189
19720,8012,Kopřivnice,25,416,214,202
19721,8012,Kopřivnice,26,437,232,205
19722,8012,Kopřivnice,27,517,261,256
19723,8012,Kopřivnice,28,487,241,246
19724,8012,Kopřivnice,29,593,329,264
19725,8012,Kopřivnice,30,536,296,240
19726,8012,Kopřivnice,31,555,290,265
19727,8012,Kopřivnice,32,560,288,272
19728,8012,Kopřivnice,33,587,328,259
19729,8012,Kopřivnice,34,567,292,275
19730,8012,Kopřivnice,35,498,247,251
19731,8012,Kopřivnice,36,546,301,245
19732,8012,Kopřivnice,37,532,290,242
19733,8012,Kopřivnice,38,515,262,253
19734,8012,Kopřivnice,39,514,248,266
19735,8012,Kopřivnice,40,543,293,250
19736,8012,Kopřivnice,41,567,301,266
19737,8012,Kopřivnice,42,608,328,280
19738,8012,Kopřivnice,43,657,340,317
19739,8012,Kopřivnice,44,740,365,375
19740,8012,Kopřivnice,45,736,380,356
19741,8012,Kopřivnice,46,718,359,359
19742,8012,Kopřivnice,47,642,317,325
19743,8012,Kopřivnice,48,560,287,273
19744,8012,Kopřivnice,49,592,293,299
19745,8012,Kopřivnice,50,589,317,272
19746,8012,Kopřivnice,51,551,287,264
19747,8012,Kopřivnice,52,508,259,249
19748,8012,Kopřivnice,53,580,304,276
19749,8012,Kopřivnice,54,581,276,305
19750,8012,Kopřivnice,55,601,315,286
19751,8012,Kopřivnice,56,597,301,296
19752,8012,Kopřivnice,57,603,300,303
19753,8012,Kopřivnice,58,513,258,255
19754,8012,Kopřivnice,59,471,247,224
19755,8012,Kopřivnice,60,478,249,229
19756,8012,Kopřivnice,61,470,219,251
19757,8012,Kopřivnice,62,492,245,247
19758,8012,Kopřivnice,63,560,273,287
19759,8012,Kopřivnice,64,508,244,264
19760,8012,Kopřivnice,65,495,215,280
19761,8012,Kopřivnice,66,515,220,295
19762,8012,Kopřivnice,67,553,270,283
19763,8012,Kopřivnice,68,515,226,289
19764,8012,Kopřivnice,69,480,215,265
19765,8012,Kopřivnice,70,469,196,273
19766,8012,Kopřivnice,71,448,204,244
19767,8012,Kopřivnice,72,453,192,261
19768,8012,Kopřivnice,73,471,198,273
19769,8012,Kopřivnice,74,407,168,239
19770,8012,Kopřivnice,75,327,142,185
19771,8012,Kopřivnice,76,339,136,203
19772,8012,Kopřivnice,77,332,126,206
19773,8012,Kopřivnice,78,288,102,186
19774,8012,Kopřivnice,79,273,125,148
19775,8012,Kopřivnice,80,274,110,164
19776,8012,Kopřivnice,81,206,72,134
19777,8012,Kopřivnice,82,199,73,126
19778,8012,Kopřivnice,83,164,59,105
19779,8012,Kopřivnice,84,123,42,81
19780,8012,Kopřivnice,85,126,41,85
19781,8012,Kopřivnice,86,112,34,78
19782,8012,Kopřivnice,87,95,36,59
19783,8012,Kopřivnice,88,71,21,50
19784,8012,Kopřivnice,89,56,18,38
19785,8012,Kopřivnice,90,59,18,41
19786,8012,Kopřivnice,91,43,11,32
19787,8012,Kopřivnice,92,29,11,18
19788,8012,Kopřivnice,93,16,1,15
19789,8012,Kopřivnice,94,23,4,19
19790,8012,Kopřivnice,95,6,3,3
19791,8012,Kopřivnice,96,10,1,9
19792,8012,Kopřivnice,97,2,0,2
19793,8012,Kopřivnice,98,5,1,4
19794,8012,Kopřivnice,99,3,0,3
19795,8012,Kopřivnice,100,2,2,0
19796,8013,Kravaře,0,239,126,113
19797,8013,Kravaře,1,200,105,95
19798,8013,Kravaře,2,246,133,113
19799,8013,Kravaře,3,250,135,115
19800,8013,Kravaře,4,219,120,99
19801,8013,Kravaře,5,215,115,100
19802,8013,Kravaře,6,252,123,129
19803,8013,Kravaře,7,226,107,119
19804,8013,Kravaře,8,238,121,117
19805,8013,Kravaře,9,244,148,96
19806,8013,Kravaře,10,248,127,121
19807,8013,Kravaře,11,225,114,111
19808,8013,Kravaře,12,265,134,131
19809,8013,Kravaře,13,257,129,128
19810,8013,Kravaře,14,212,112,100
19811,8013,Kravaře,15,218,105,113
19812,8013,Kravaře,16,249,133,116
19813,8013,Kravaře,17,201,99,102
19814,8013,Kravaře,18,180,93,87
19815,8013,Kravaře,19,222,93,129
19816,8013,Kravaře,20,196,90,106
19817,8013,Kravaře,21,177,85,92
19818,8013,Kravaře,22,198,100,98
19819,8013,Kravaře,23,219,114,105
19820,8013,Kravaře,24,210,111,99
19821,8013,Kravaře,25,212,105,107
19822,8013,Kravaře,26,227,114,113
19823,8013,Kravaře,27,244,139,105
19824,8013,Kravaře,28,254,132,122
19825,8013,Kravaře,29,276,133,143
19826,8013,Kravaře,30,309,151,158
19827,8013,Kravaře,31,302,152,150
19828,8013,Kravaře,32,304,175,129
19829,8013,Kravaře,33,306,151,155
19830,8013,Kravaře,34,275,144,131
19831,8013,Kravaře,35,307,155,152
19832,8013,Kravaře,36,321,169,152
19833,8013,Kravaře,37,334,183,151
19834,8013,Kravaře,38,280,137,143
19835,8013,Kravaře,39,293,159,134
19836,8013,Kravaře,40,334,179,155
19837,8013,Kravaře,41,391,198,193
19838,8013,Kravaře,42,370,181,189
19839,8013,Kravaře,43,375,204,171
19840,8013,Kravaře,44,339,167,172
19841,8013,Kravaře,45,320,178,142
19842,8013,Kravaře,46,398,204,194
19843,8013,Kravaře,47,334,171,163
19844,8013,Kravaře,48,313,169,144
19845,8013,Kravaře,49,299,151,148
19846,8013,Kravaře,50,263,132,131
19847,8013,Kravaře,51,274,138,136
19848,8013,Kravaře,52,237,130,107
19849,8013,Kravaře,53,223,125,98
19850,8013,Kravaře,54,264,129,135
19851,8013,Kravaře,55,271,138,133
19852,8013,Kravaře,56,337,165,172
19853,8013,Kravaře,57,297,149,148
19854,8013,Kravaře,58,263,121,142
19855,8013,Kravaře,59,277,132,145
19856,8013,Kravaře,60,301,160,141
19857,8013,Kravaře,61,261,128,133
19858,8013,Kravaře,62,328,152,176
19859,8013,Kravaře,63,311,147,164
19860,8013,Kravaře,64,302,145,157
19861,8013,Kravaře,65,322,157,165
19862,8013,Kravaře,66,246,121,125
19863,8013,Kravaře,67,284,135,149
19864,8013,Kravaře,68,253,136,117
19865,8013,Kravaře,69,283,140,143
19866,8013,Kravaře,70,246,114,132
19867,8013,Kravaře,71,224,96,128
19868,8013,Kravaře,72,215,98,117
19869,8013,Kravaře,73,195,85,110
19870,8013,Kravaře,74,107,40,67
19871,8013,Kravaře,75,76,31,45
19872,8013,Kravaře,76,117,41,76
19873,8013,Kravaře,77,110,47,63
19874,8013,Kravaře,78,106,43,63
19875,8013,Kravaře,79,112,38,74
19876,8013,Kravaře,80,165,54,111
19877,8013,Kravaře,81,140,52,88
19878,8013,Kravaře,82,97,34,63
19879,8013,Kravaře,83,72,24,48
19880,8013,Kravaře,84,68,28,40
19881,8013,Kravaře,85,53,16,37
19882,8013,Kravaře,86,61,17,44
19883,8013,Kravaře,87,48,18,30
19884,8013,Kravaře,88,41,15,26
19885,8013,Kravaře,89,28,4,24
19886,8013,Kravaře,90,24,6,18
19887,8013,Kravaře,91,24,4,20
19888,8013,Kravaře,92,15,2,13
19889,8013,Kravaře,93,9,4,5
19890,8013,Kravaře,94,5,0,5
19891,8013,Kravaře,95,8,1,7
19892,8013,Kravaře,96,4,2,2
19893,8013,Kravaře,97,3,0,3
19894,8013,Kravaře,98,3,0,3
19895,8013,Kravaře,99,2,1,1
19896,8013,Kravaře,100,4,0,4
19897,8014,Krnov,0,349,171,178
19898,8014,Krnov,1,386,190,196
19899,8014,Krnov,2,341,178,163
19900,8014,Krnov,3,374,201,173
19901,8014,Krnov,4,389,206,183
19902,8014,Krnov,5,358,181,177
19903,8014,Krnov,6,388,198,190
19904,8014,Krnov,7,336,164,172
19905,8014,Krnov,8,366,188,178
19906,8014,Krnov,9,350,181,169
19907,8014,Krnov,10,395,197,198
19908,8014,Krnov,11,433,222,211
19909,8014,Krnov,12,409,212,197
19910,8014,Krnov,13,475,261,214
19911,8014,Krnov,14,397,231,166
19912,8014,Krnov,15,395,226,169
19913,8014,Krnov,16,380,186,194
19914,8014,Krnov,17,401,183,218
19915,8014,Krnov,18,404,212,192
19916,8014,Krnov,19,396,199,197
19917,8014,Krnov,20,382,188,194
19918,8014,Krnov,21,391,197,194
19919,8014,Krnov,22,402,202,200
19920,8014,Krnov,23,413,228,185
19921,8014,Krnov,24,421,207,214
19922,8014,Krnov,25,419,228,191
19923,8014,Krnov,26,435,230,205
19924,8014,Krnov,27,510,261,249
19925,8014,Krnov,28,506,286,220
19926,8014,Krnov,29,517,264,253
19927,8014,Krnov,30,481,245,236
19928,8014,Krnov,31,500,266,234
19929,8014,Krnov,32,480,250,230
19930,8014,Krnov,33,464,238,226
19931,8014,Krnov,34,445,220,225
19932,8014,Krnov,35,481,257,224
19933,8014,Krnov,36,485,252,233
19934,8014,Krnov,37,445,246,199
19935,8014,Krnov,38,501,267,234
19936,8014,Krnov,39,463,248,215
19937,8014,Krnov,40,530,284,246
19938,8014,Krnov,41,598,306,292
19939,8014,Krnov,42,606,327,279
19940,8014,Krnov,43,655,330,325
19941,8014,Krnov,44,668,350,318
19942,8014,Krnov,45,683,353,330
19943,8014,Krnov,46,689,347,342
19944,8014,Krnov,47,711,357,354
19945,8014,Krnov,48,661,331,330
19946,8014,Krnov,49,587,305,282
19947,8014,Krnov,50,560,294,266
19948,8014,Krnov,51,562,284,278
19949,8014,Krnov,52,569,297,272
19950,8014,Krnov,53,455,228,227
19951,8014,Krnov,54,521,284,237
19952,8014,Krnov,55,532,257,275
19953,8014,Krnov,56,530,262,268
19954,8014,Krnov,57,508,251,257
19955,8014,Krnov,58,444,218,226
19956,8014,Krnov,59,474,240,234
19957,8014,Krnov,60,449,229,220
19958,8014,Krnov,61,490,242,248
19959,8014,Krnov,62,503,235,268
19960,8014,Krnov,63,558,273,285
19961,8014,Krnov,64,581,265,316
19962,8014,Krnov,65,551,259,292
19963,8014,Krnov,66,536,266,270
19964,8014,Krnov,67,594,268,326
19965,8014,Krnov,68,578,248,330
19966,8014,Krnov,69,648,285,363
19967,8014,Krnov,70,555,248,307
19968,8014,Krnov,71,526,224,302
19969,8014,Krnov,72,602,253,349
19970,8014,Krnov,73,588,242,346
19971,8014,Krnov,74,522,218,304
19972,8014,Krnov,75,337,154,183
19973,8014,Krnov,76,360,161,199
19974,8014,Krnov,77,285,107,178
19975,8014,Krnov,78,302,118,184
19976,8014,Krnov,79,246,109,137
19977,8014,Krnov,80,235,93,142
19978,8014,Krnov,81,191,74,117
19979,8014,Krnov,82,163,57,106
19980,8014,Krnov,83,146,46,100
19981,8014,Krnov,84,131,40,91
19982,8014,Krnov,85,120,42,78
19983,8014,Krnov,86,123,37,86
19984,8014,Krnov,87,96,27,69
19985,8014,Krnov,88,78,27,51
19986,8014,Krnov,89,64,22,42
19987,8014,Krnov,90,48,9,39
19988,8014,Krnov,91,38,7,31
19989,8014,Krnov,92,42,11,31
19990,8014,Krnov,93,30,5,25
19991,8014,Krnov,94,24,4,20
19992,8014,Krnov,95,19,5,14
19993,8014,Krnov,96,9,0,9
19994,8014,Krnov,97,9,2,7
19995,8014,Krnov,98,7,0,7
19996,8014,Krnov,99,1,0,1
19997,8014,Krnov,100,1,0,1
19998,8015,Nový Jičín,0,524,267,257
19999,8015,Nový Jičín,1,542,266,276
20000,8015,Nový Jičín,2,552,272,280
20001,8015,Nový Jičín,3,551,284,267
20002,8015,Nový Jičín,4,510,256,254
20003,8015,Nový Jičín,5,519,254,265
20004,8015,Nový Jičín,6,505,225,280
20005,8015,Nový Jičín,7,505,259,246
20006,8015,Nový Jičín,8,519,284,235
20007,8015,Nový Jičín,9,512,277,235
20008,8015,Nový Jičín,10,581,283,298
20009,8015,Nový Jičín,11,605,283,322
20010,8015,Nový Jičín,12,566,293,273
20011,8015,Nový Jičín,13,597,298,299
20012,8015,Nový Jičín,14,528,288,240
20013,8015,Nový Jičín,15,518,281,237
20014,8015,Nový Jičín,16,439,234,205
20015,8015,Nový Jičín,17,464,231,233
20016,8015,Nový Jičín,18,447,213,234
20017,8015,Nový Jičín,19,457,228,229
20018,8015,Nový Jičín,20,436,229,207
20019,8015,Nový Jičín,21,470,232,238
20020,8015,Nový Jičín,22,449,213,236
20021,8015,Nový Jičín,23,500,267,233
20022,8015,Nový Jičín,24,427,224,203
20023,8015,Nový Jičín,25,465,243,222
20024,8015,Nový Jičín,26,573,289,284
20025,8015,Nový Jičín,27,593,308,285
20026,8015,Nový Jičín,28,632,300,332
20027,8015,Nový Jičín,29,658,335,323
20028,8015,Nový Jičín,30,691,341,350
20029,8015,Nový Jičín,31,596,296,300
20030,8015,Nový Jičín,32,648,343,305
20031,8015,Nový Jičín,33,603,312,291
20032,8015,Nový Jičín,34,638,360,278
20033,8015,Nový Jičín,35,608,307,301
20034,8015,Nový Jičín,36,615,331,284
20035,8015,Nový Jičín,37,701,354,347
20036,8015,Nový Jičín,38,652,348,304
20037,8015,Nový Jičín,39,676,354,322
20038,8015,Nový Jičín,40,741,374,367
20039,8015,Nový Jičín,41,815,395,420
20040,8015,Nový Jičín,42,814,430,384
20041,8015,Nový Jičín,43,807,432,375
20042,8015,Nový Jičín,44,857,467,390
20043,8015,Nový Jičín,45,836,415,421
20044,8015,Nový Jičín,46,863,426,437
20045,8015,Nový Jičín,47,779,414,365
20046,8015,Nový Jičín,48,700,339,361
20047,8015,Nový Jičín,49,685,357,328
20048,8015,Nový Jičín,50,671,339,332
20049,8015,Nový Jičín,51,705,329,376
20050,8015,Nový Jičín,52,648,336,312
20051,8015,Nový Jičín,53,629,321,308
20052,8015,Nový Jičín,54,577,306,271
20053,8015,Nový Jičín,55,579,306,273
20054,8015,Nový Jičín,56,632,289,343
20055,8015,Nový Jičín,57,632,296,336
20056,8015,Nový Jičín,58,569,274,295
20057,8015,Nový Jičín,59,579,291,288
20058,8015,Nový Jičín,60,535,265,270
20059,8015,Nový Jičín,61,566,275,291
20060,8015,Nový Jičín,62,554,253,301
20061,8015,Nový Jičín,63,598,269,329
20062,8015,Nový Jičín,64,647,303,344
20063,8015,Nový Jičín,65,574,273,301
20064,8015,Nový Jičín,66,638,299,339
20065,8015,Nový Jičín,67,644,297,347
20066,8015,Nový Jičín,68,623,274,349
20067,8015,Nový Jičín,69,643,288,355
20068,8015,Nový Jičín,70,593,250,343
20069,8015,Nový Jičín,71,604,274,330
20070,8015,Nový Jičín,72,574,256,318
20071,8015,Nový Jičín,73,588,254,334
20072,8015,Nový Jičín,74,559,243,316
20073,8015,Nový Jičín,75,401,180,221
20074,8015,Nový Jičín,76,386,168,218
20075,8015,Nový Jičín,77,390,179,211
20076,8015,Nový Jičín,78,318,112,206
20077,8015,Nový Jičín,79,316,129,187
20078,8015,Nový Jičín,80,271,106,165
20079,8015,Nový Jičín,81,226,86,140
20080,8015,Nový Jičín,82,207,68,139
20081,8015,Nový Jičín,83,165,56,109
20082,8015,Nový Jičín,84,136,40,96
20083,8015,Nový Jičín,85,144,53,91
20084,8015,Nový Jičín,86,92,36,56
20085,8015,Nový Jičín,87,100,25,75
20086,8015,Nový Jičín,88,87,24,63
20087,8015,Nový Jičín,89,98,19,79
20088,8015,Nový Jičín,90,62,17,45
20089,8015,Nový Jičín,91,66,18,48
20090,8015,Nový Jičín,92,50,9,41
20091,8015,Nový Jičín,93,31,5,26
20092,8015,Nový Jičín,94,21,1,20
20093,8015,Nový Jičín,95,15,2,13
20094,8015,Nový Jičín,96,11,2,9
20095,8015,Nový Jičín,97,8,0,8
20096,8015,Nový Jičín,98,8,2,6
20097,8015,Nový Jičín,99,1,0,1
20098,8015,Nový Jičín,100,3,1,2
20099,8016,Odry,0,182,91,91
20100,8016,Odry,1,208,103,105
20101,8016,Odry,2,162,74,88
20102,8016,Odry,3,172,86,86
20103,8016,Odry,4,176,92,84
20104,8016,Odry,5,183,96,87
20105,8016,Odry,6,155,79,76
20106,8016,Odry,7,172,86,86
20107,8016,Odry,8,133,62,71
20108,8016,Odry,9,180,90,90
20109,8016,Odry,10,181,94,87
20110,8016,Odry,11,184,89,95
20111,8016,Odry,12,198,107,91
20112,8016,Odry,13,202,96,106
20113,8016,Odry,14,180,89,91
20114,8016,Odry,15,173,89,84
20115,8016,Odry,16,173,92,81
20116,8016,Odry,17,181,79,102
20117,8016,Odry,18,186,97,89
20118,8016,Odry,19,172,77,95
20119,8016,Odry,20,184,85,99
20120,8016,Odry,21,169,89,80
20121,8016,Odry,22,180,89,91
20122,8016,Odry,23,160,85,75
20123,8016,Odry,24,171,86,85
20124,8016,Odry,25,181,91,90
20125,8016,Odry,26,205,104,101
20126,8016,Odry,27,212,105,107
20127,8016,Odry,28,221,136,85
20128,8016,Odry,29,221,111,110
20129,8016,Odry,30,247,116,131
20130,8016,Odry,31,219,132,87
20131,8016,Odry,32,228,130,98
20132,8016,Odry,33,195,103,92
20133,8016,Odry,34,180,95,85
20134,8016,Odry,35,207,95,112
20135,8016,Odry,36,214,120,94
20136,8016,Odry,37,226,124,102
20137,8016,Odry,38,236,135,101
20138,8016,Odry,39,220,114,106
20139,8016,Odry,40,232,116,116
20140,8016,Odry,41,267,136,131
20141,8016,Odry,42,269,135,134
20142,8016,Odry,43,292,156,136
20143,8016,Odry,44,296,161,135
20144,8016,Odry,45,305,157,148
20145,8016,Odry,46,284,163,121
20146,8016,Odry,47,288,141,147
20147,8016,Odry,48,271,141,130
20148,8016,Odry,49,257,152,105
20149,8016,Odry,50,230,124,106
20150,8016,Odry,51,227,116,111
20151,8016,Odry,52,223,133,90
20152,8016,Odry,53,218,113,105
20153,8016,Odry,54,203,103,100
20154,8016,Odry,55,233,120,113
20155,8016,Odry,56,244,131,113
20156,8016,Odry,57,211,102,109
20157,8016,Odry,58,164,75,89
20158,8016,Odry,59,169,73,96
20159,8016,Odry,60,196,108,88
20160,8016,Odry,61,182,84,98
20161,8016,Odry,62,212,114,98
20162,8016,Odry,63,232,120,112
20163,8016,Odry,64,225,100,125
20164,8016,Odry,65,202,89,113
20165,8016,Odry,66,247,116,131
20166,8016,Odry,67,218,104,114
20167,8016,Odry,68,201,87,114
20168,8016,Odry,69,223,93,130
20169,8016,Odry,70,228,104,124
20170,8016,Odry,71,217,96,121
20171,8016,Odry,72,226,97,129
20172,8016,Odry,73,186,86,100
20173,8016,Odry,74,175,72,103
20174,8016,Odry,75,149,63,86
20175,8016,Odry,76,131,54,77
20176,8016,Odry,77,116,40,76
20177,8016,Odry,78,101,47,54
20178,8016,Odry,79,110,48,62
20179,8016,Odry,80,95,36,59
20180,8016,Odry,81,79,30,49
20181,8016,Odry,82,80,26,54
20182,8016,Odry,83,57,17,40
20183,8016,Odry,84,58,17,41
20184,8016,Odry,85,48,18,30
20185,8016,Odry,86,50,20,30
20186,8016,Odry,87,39,11,28
20187,8016,Odry,88,44,11,33
20188,8016,Odry,89,26,4,22
20189,8016,Odry,90,19,7,12
20190,8016,Odry,91,14,4,10
20191,8016,Odry,92,11,5,6
20192,8016,Odry,93,5,2,3
20193,8016,Odry,94,8,3,5
20194,8016,Odry,95,3,1,2
20195,8016,Odry,96,3,1,2
20196,8016,Odry,97,2,0,2
20197,8016,Odry,98,2,1,1
20198,8016,Odry,99,1,0,1
20199,8016,Odry,100,0,0,0
20200,8017,Opava,0,1016,511,505
20201,8017,Opava,1,1043,556,487
20202,8017,Opava,2,1054,534,520
20203,8017,Opava,3,989,481,508
20204,8017,Opava,4,1028,550,478
20205,8017,Opava,5,1032,520,512
20206,8017,Opava,6,973,485,488
20207,8017,Opava,7,981,516,465
20208,8017,Opava,8,965,512,453
20209,8017,Opava,9,997,514,483
20210,8017,Opava,10,1065,541,524
20211,8017,Opava,11,1190,619,571
20212,8017,Opava,12,1193,637,556
20213,8017,Opava,13,1168,581,587
20214,8017,Opava,14,1105,547,558
20215,8017,Opava,15,1020,519,501
20216,8017,Opava,16,1000,530,470
20217,8017,Opava,17,951,487,464
20218,8017,Opava,18,987,531,456
20219,8017,Opava,19,873,450,423
20220,8017,Opava,20,902,452,450
20221,8017,Opava,21,914,467,447
20222,8017,Opava,22,914,466,448
20223,8017,Opava,23,919,479,440
20224,8017,Opava,24,960,509,451
20225,8017,Opava,25,997,498,499
20226,8017,Opava,26,1085,543,542
20227,8017,Opava,27,1149,590,559
20228,8017,Opava,28,1208,605,603
20229,8017,Opava,29,1294,687,607
20230,8017,Opava,30,1250,612,638
20231,8017,Opava,31,1298,639,659
20232,8017,Opava,32,1373,706,667
20233,8017,Opava,33,1342,716,626
20234,8017,Opava,34,1375,710,665
20235,8017,Opava,35,1317,673,644
20236,8017,Opava,36,1297,651,646
20237,8017,Opava,37,1320,688,632
20238,8017,Opava,38,1317,673,644
20239,8017,Opava,39,1315,681,634
20240,8017,Opava,40,1447,765,682
20241,8017,Opava,41,1565,781,784
20242,8017,Opava,42,1572,820,752
20243,8017,Opava,43,1697,879,818
20244,8017,Opava,44,1700,856,844
20245,8017,Opava,45,1712,872,840
20246,8017,Opava,46,1836,944,892
20247,8017,Opava,47,1739,848,891
20248,8017,Opava,48,1591,806,785
20249,8017,Opava,49,1417,724,693
20250,8017,Opava,50,1430,737,693
20251,8017,Opava,51,1247,633,614
20252,8017,Opava,52,1217,602,615
20253,8017,Opava,53,1207,602,605
20254,8017,Opava,54,1313,661,652
20255,8017,Opava,55,1307,640,667
20256,8017,Opava,56,1438,670,768
20257,8017,Opava,57,1367,689,678
20258,8017,Opava,58,1266,628,638
20259,8017,Opava,59,1223,595,628
20260,8017,Opava,60,1217,562,655
20261,8017,Opava,61,1153,574,579
20262,8017,Opava,62,1289,641,648
20263,8017,Opava,63,1355,640,715
20264,8017,Opava,64,1446,704,742
20265,8017,Opava,65,1352,593,759
20266,8017,Opava,66,1258,576,682
20267,8017,Opava,67,1314,636,678
20268,8017,Opava,68,1370,585,785
20269,8017,Opava,69,1359,612,747
20270,8017,Opava,70,1322,613,709
20271,8017,Opava,71,1202,538,664
20272,8017,Opava,72,1187,486,701
20273,8017,Opava,73,1146,484,662
20274,8017,Opava,74,1017,419,598
20275,8017,Opava,75,761,289,472
20276,8017,Opava,76,828,331,497
20277,8017,Opava,77,774,287,487
20278,8017,Opava,78,743,304,439
20279,8017,Opava,79,670,269,401
20280,8017,Opava,80,718,253,465
20281,8017,Opava,81,569,221,348
20282,8017,Opava,82,440,157,283
20283,8017,Opava,83,364,126,238
20284,8017,Opava,84,388,136,252
20285,8017,Opava,85,328,108,220
20286,8017,Opava,86,282,81,201
20287,8017,Opava,87,244,73,171
20288,8017,Opava,88,237,78,159
20289,8017,Opava,89,200,54,146
20290,8017,Opava,90,142,45,97
20291,8017,Opava,91,114,31,83
20292,8017,Opava,92,109,22,87
20293,8017,Opava,93,73,22,51
20294,8017,Opava,94,49,6,43
20295,8017,Opava,95,35,11,24
20296,8017,Opava,96,27,6,21
20297,8017,Opava,97,10,1,9
20298,8017,Opava,98,11,3,8
20299,8017,Opava,99,6,1,5
20300,8017,Opava,100,6,1,5
20301,8018,Orlová,0,372,173,199
20302,8018,Orlová,1,388,207,181
20303,8018,Orlová,2,376,192,184
20304,8018,Orlová,3,384,200,184
20305,8018,Orlová,4,382,207,175
20306,8018,Orlová,5,340,179,161
20307,8018,Orlová,6,376,195,181
20308,8018,Orlová,7,316,146,170
20309,8018,Orlová,8,347,173,174
20310,8018,Orlová,9,342,167,175
20311,8018,Orlová,10,403,218,185
20312,8018,Orlová,11,403,206,197
20313,8018,Orlová,12,422,205,217
20314,8018,Orlová,13,403,207,196
20315,8018,Orlová,14,341,168,173
20316,8018,Orlová,15,357,163,194
20317,8018,Orlová,16,348,177,171
20318,8018,Orlová,17,324,159,165
20319,8018,Orlová,18,334,169,165
20320,8018,Orlová,19,328,165,163
20321,8018,Orlová,20,323,176,147
20322,8018,Orlová,21,351,178,173
20323,8018,Orlová,22,362,196,166
20324,8018,Orlová,23,333,165,168
20325,8018,Orlová,24,358,170,188
20326,8018,Orlová,25,358,190,168
20327,8018,Orlová,26,455,235,220
20328,8018,Orlová,27,502,252,250
20329,8018,Orlová,28,515,260,255
20330,8018,Orlová,29,503,269,234
20331,8018,Orlová,30,515,268,247
20332,8018,Orlová,31,546,306,240
20333,8018,Orlová,32,532,273,259
20334,8018,Orlová,33,507,257,250
20335,8018,Orlová,34,499,284,215
20336,8018,Orlová,35,490,254,236
20337,8018,Orlová,36,467,234,233
20338,8018,Orlová,37,518,259,259
20339,8018,Orlová,38,491,264,227
20340,8018,Orlová,39,436,245,191
20341,8018,Orlová,40,493,244,249
20342,8018,Orlová,41,557,294,263
20343,8018,Orlová,42,513,287,226
20344,8018,Orlová,43,548,288,260
20345,8018,Orlová,44,587,274,313
20346,8018,Orlová,45,581,278,303
20347,8018,Orlová,46,632,309,323
20348,8018,Orlová,47,602,306,296
20349,8018,Orlová,48,538,264,274
20350,8018,Orlová,49,523,244,279
20351,8018,Orlová,50,537,273,264
20352,8018,Orlová,51,573,283,290
20353,8018,Orlová,52,561,270,291
20354,8018,Orlová,53,578,284,294
20355,8018,Orlová,54,611,310,301
20356,8018,Orlová,55,569,282,287
20357,8018,Orlová,56,604,301,303
20358,8018,Orlová,57,584,290,294
20359,8018,Orlová,58,516,256,260
20360,8018,Orlová,59,499,250,249
20361,8018,Orlová,60,502,257,245
20362,8018,Orlová,61,424,204,220
20363,8018,Orlová,62,521,243,278
20364,8018,Orlová,63,488,249,239
20365,8018,Orlová,64,515,254,261
20366,8018,Orlová,65,478,212,266
20367,8018,Orlová,66,461,198,263
20368,8018,Orlová,67,466,211,255
20369,8018,Orlová,68,487,238,249
20370,8018,Orlová,69,394,172,222
20371,8018,Orlová,70,396,152,244
20372,8018,Orlová,71,401,169,232
20373,8018,Orlová,72,425,181,244
20374,8018,Orlová,73,405,168,237
20375,8018,Orlová,74,367,150,217
20376,8018,Orlová,75,315,133,182
20377,8018,Orlová,76,311,130,181
20378,8018,Orlová,77,278,124,154
20379,8018,Orlová,78,249,93,156
20380,8018,Orlová,79,207,78,129
20381,8018,Orlová,80,191,79,112
20382,8018,Orlová,81,139,59,80
20383,8018,Orlová,82,137,44,93
20384,8018,Orlová,83,103,35,68
20385,8018,Orlová,84,88,23,65
20386,8018,Orlová,85,81,30,51
20387,8018,Orlová,86,69,16,53
20388,8018,Orlová,87,61,16,45
20389,8018,Orlová,88,55,18,37
20390,8018,Orlová,89,69,16,53
20391,8018,Orlová,90,52,16,36
20392,8018,Orlová,91,37,7,30
20393,8018,Orlová,92,27,5,22
20394,8018,Orlová,93,19,0,19
20395,8018,Orlová,94,18,5,13
20396,8018,Orlová,95,10,5,5
20397,8018,Orlová,96,12,3,9
20398,8018,Orlová,97,8,2,6
20399,8018,Orlová,98,2,0,2
20400,8018,Orlová,99,1,0,1
20401,8018,Orlová,100,5,1,4
20402,8019,Ostrava,0,3176,1657,1519
20403,8019,Ostrava,1,3289,1703,1586
20404,8019,Ostrava,2,3266,1694,1572
20405,8019,Ostrava,3,3139,1591,1548
20406,8019,Ostrava,4,3132,1649,1483
20407,8019,Ostrava,5,3110,1587,1523
20408,8019,Ostrava,6,3139,1595,1544
20409,8019,Ostrava,7,3016,1503,1513
20410,8019,Ostrava,8,2982,1529,1453
20411,8019,Ostrava,9,2965,1567,1398
20412,8019,Ostrava,10,3360,1682,1678
20413,8019,Ostrava,11,3440,1773,1667
20414,8019,Ostrava,12,3556,1848,1708
20415,8019,Ostrava,13,3472,1719,1753
20416,8019,Ostrava,14,3231,1652,1579
20417,8019,Ostrava,15,3165,1622,1543
20418,8019,Ostrava,16,2897,1518,1379
20419,8019,Ostrava,17,2945,1534,1411
20420,8019,Ostrava,18,2803,1369,1434
20421,8019,Ostrava,19,2919,1495,1424
20422,8019,Ostrava,20,2861,1516,1345
20423,8019,Ostrava,21,2851,1449,1402
20424,8019,Ostrava,22,2813,1395,1418
20425,8019,Ostrava,23,2964,1512,1452
20426,8019,Ostrava,24,3001,1509,1492
20427,8019,Ostrava,25,3152,1676,1476
20428,8019,Ostrava,26,3504,1779,1725
20429,8019,Ostrava,27,3959,1993,1966
20430,8019,Ostrava,28,4016,2064,1952
20431,8019,Ostrava,29,4388,2241,2147
20432,8019,Ostrava,30,4537,2287,2250
20433,8019,Ostrava,31,4382,2269,2113
20434,8019,Ostrava,32,4576,2381,2195
20435,8019,Ostrava,33,4279,2227,2052
20436,8019,Ostrava,34,4553,2318,2235
20437,8019,Ostrava,35,4286,2298,1988
20438,8019,Ostrava,36,4317,2283,2034
20439,8019,Ostrava,37,4246,2259,1987
20440,8019,Ostrava,38,4206,2156,2050
20441,8019,Ostrava,39,4227,2237,1990
20442,8019,Ostrava,40,4400,2303,2097
20443,8019,Ostrava,41,5044,2575,2469
20444,8019,Ostrava,42,5172,2629,2543
20445,8019,Ostrava,43,5080,2583,2497
20446,8019,Ostrava,44,5164,2699,2465
20447,8019,Ostrava,45,5335,2714,2621
20448,8019,Ostrava,46,5488,2805,2683
20449,8019,Ostrava,47,5244,2659,2585
20450,8019,Ostrava,48,4749,2385,2364
20451,8019,Ostrava,49,4592,2340,2252
20452,8019,Ostrava,50,4484,2276,2208
20453,8019,Ostrava,51,4315,2160,2155
20454,8019,Ostrava,52,4065,2076,1989
20455,8019,Ostrava,53,4135,2068,2067
20456,8019,Ostrava,54,4393,2185,2208
20457,8019,Ostrava,55,4511,2209,2302
20458,8019,Ostrava,56,4677,2318,2359
20459,8019,Ostrava,57,4559,2292,2267
20460,8019,Ostrava,58,4045,1968,2077
20461,8019,Ostrava,59,3846,1887,1959
20462,8019,Ostrava,60,3571,1765,1806
20463,8019,Ostrava,61,3586,1739,1847
20464,8019,Ostrava,62,3912,1821,2091
20465,8019,Ostrava,63,3942,1769,2173
20466,8019,Ostrava,64,3935,1747,2188
20467,8019,Ostrava,65,4024,1808,2216
20468,8019,Ostrava,66,3995,1811,2184
20469,8019,Ostrava,67,3970,1836,2134
20470,8019,Ostrava,68,3847,1739,2108
20471,8019,Ostrava,69,3980,1672,2308
20472,8019,Ostrava,70,3741,1559,2182
20473,8019,Ostrava,71,3632,1465,2167
20474,8019,Ostrava,72,3590,1561,2029
20475,8019,Ostrava,73,3615,1471,2144
20476,8019,Ostrava,74,3386,1394,1992
20477,8019,Ostrava,75,2785,1054,1731
20478,8019,Ostrava,76,2996,1153,1843
20479,8019,Ostrava,77,2846,1052,1794
20480,8019,Ostrava,78,2415,939,1476
20481,8019,Ostrava,79,2309,886,1423
20482,8019,Ostrava,80,2314,869,1445
20483,8019,Ostrava,81,1730,603,1127
20484,8019,Ostrava,82,1451,508,943
20485,8019,Ostrava,83,1288,479,809
20486,8019,Ostrava,84,1108,399,709
20487,8019,Ostrava,85,982,343,639
20488,8019,Ostrava,86,912,263,649
20489,8019,Ostrava,87,745,225,520
20490,8019,Ostrava,88,750,221,529
20491,8019,Ostrava,89,655,215,440
20492,8019,Ostrava,90,524,139,385
20493,8019,Ostrava,91,402,90,312
20494,8019,Ostrava,92,285,66,219
20495,8019,Ostrava,93,229,49,180
20496,8019,Ostrava,94,161,39,122
20497,8019,Ostrava,95,94,21,73
20498,8019,Ostrava,96,65,9,56
20499,8019,Ostrava,97,58,11,47
20500,8019,Ostrava,98,29,6,23
20501,8019,Ostrava,99,28,7,21
20502,8019,Ostrava,100,17,6,11
20503,8020,Rýmařov,0,135,69,66
20504,8020,Rýmařov,1,120,60,60
20505,8020,Rýmařov,2,121,66,55
20506,8020,Rýmařov,3,144,73,71
20507,8020,Rýmařov,4,127,73,54
20508,8020,Rýmařov,5,122,61,61
20509,8020,Rýmařov,6,160,75,85
20510,8020,Rýmařov,7,123,73,50
20511,8020,Rýmařov,8,132,75,57
20512,8020,Rýmařov,9,140,70,70
20513,8020,Rýmařov,10,143,88,55
20514,8020,Rýmařov,11,161,88,73
20515,8020,Rýmařov,12,172,85,87
20516,8020,Rýmařov,13,147,71,76
20517,8020,Rýmařov,14,131,75,56
20518,8020,Rýmařov,15,163,89,74
20519,8020,Rýmařov,16,151,70,81
20520,8020,Rýmařov,17,130,76,54
20521,8020,Rýmařov,18,133,66,67
20522,8020,Rýmařov,19,128,76,52
20523,8020,Rýmařov,20,144,72,72
20524,8020,Rýmařov,21,145,79,66
20525,8020,Rýmařov,22,128,72,56
20526,8020,Rýmařov,23,140,71,69
20527,8020,Rýmařov,24,121,66,55
20528,8020,Rýmařov,25,139,73,66
20529,8020,Rýmařov,26,166,90,76
20530,8020,Rýmařov,27,194,97,97
20531,8020,Rýmařov,28,182,95,87
20532,8020,Rýmařov,29,213,114,99
20533,8020,Rýmařov,30,210,110,100
20534,8020,Rýmařov,31,179,98,81
20535,8020,Rýmařov,32,178,85,93
20536,8020,Rýmařov,33,187,107,80
20537,8020,Rýmařov,34,208,122,86
20538,8020,Rýmařov,35,181,98,83
20539,8020,Rýmařov,36,190,89,101
20540,8020,Rýmařov,37,185,113,72
20541,8020,Rýmařov,38,193,108,85
20542,8020,Rýmařov,39,159,85,74
20543,8020,Rýmařov,40,204,112,92
20544,8020,Rýmařov,41,207,111,96
20545,8020,Rýmařov,42,216,98,118
20546,8020,Rýmařov,43,227,118,109
20547,8020,Rýmařov,44,259,133,126
20548,8020,Rýmařov,45,254,140,114
20549,8020,Rýmařov,46,263,137,126
20550,8020,Rýmařov,47,266,149,117
20551,8020,Rýmařov,48,206,106,100
20552,8020,Rýmařov,49,207,113,94
20553,8020,Rýmařov,50,205,122,83
20554,8020,Rýmařov,51,201,96,105
20555,8020,Rýmařov,52,197,87,110
20556,8020,Rýmařov,53,191,89,102
20557,8020,Rýmařov,54,195,100,95
20558,8020,Rýmařov,55,201,114,87
20559,8020,Rýmařov,56,230,123,107
20560,8020,Rýmařov,57,205,113,92
20561,8020,Rýmařov,58,170,89,81
20562,8020,Rýmařov,59,206,103,103
20563,8020,Rýmařov,60,186,88,98
20564,8020,Rýmařov,61,197,97,100
20565,8020,Rýmařov,62,183,91,92
20566,8020,Rýmařov,63,227,120,107
20567,8020,Rýmařov,64,207,98,109
20568,8020,Rýmařov,65,226,99,127
20569,8020,Rýmařov,66,238,113,125
20570,8020,Rýmařov,67,244,114,130
20571,8020,Rýmařov,68,232,118,114
20572,8020,Rýmařov,69,250,98,152
20573,8020,Rýmařov,70,247,126,121
20574,8020,Rýmařov,71,260,121,139
20575,8020,Rýmařov,72,251,126,125
20576,8020,Rýmařov,73,235,112,123
20577,8020,Rýmařov,74,173,78,95
20578,8020,Rýmařov,75,122,62,60
20579,8020,Rýmařov,76,144,53,91
20580,8020,Rýmařov,77,124,51,73
20581,8020,Rýmařov,78,121,41,80
20582,8020,Rýmařov,79,83,27,56
20583,8020,Rýmařov,80,100,25,75
20584,8020,Rýmařov,81,70,28,42
20585,8020,Rýmařov,82,59,15,44
20586,8020,Rýmařov,83,69,26,43
20587,8020,Rýmařov,84,49,12,37
20588,8020,Rýmařov,85,52,14,38
20589,8020,Rýmařov,86,45,14,31
20590,8020,Rýmařov,87,38,16,22
20591,8020,Rýmařov,88,32,10,22
20592,8020,Rýmařov,89,23,13,10
20593,8020,Rýmařov,90,21,6,15
20594,8020,Rýmařov,91,19,2,17
20595,8020,Rýmařov,92,13,4,9
20596,8020,Rýmařov,93,7,0,7
20597,8020,Rýmařov,94,10,4,6
20598,8020,Rýmařov,95,5,0,5
20599,8020,Rýmařov,96,2,0,2
20600,8020,Rýmařov,97,0,0,0
20601,8020,Rýmařov,98,1,0,1
20602,8020,Rýmařov,99,0,0,0
20603,8020,Rýmařov,100,1,1,0
20604,8021,Třinec,0,547,258,289
20605,8021,Třinec,1,538,268,270
20606,8021,Třinec,2,580,315,265
20607,8021,Třinec,3,499,241,258
20608,8021,Třinec,4,489,260,229
20609,8021,Třinec,5,529,277,252
20610,8021,Třinec,6,580,297,283
20611,8021,Třinec,7,554,297,257
20612,8021,Třinec,8,586,301,285
20613,8021,Třinec,9,541,267,274
20614,8021,Třinec,10,618,305,313
20615,8021,Třinec,11,628,317,311
20616,8021,Třinec,12,607,334,273
20617,8021,Třinec,13,609,296,313
20618,8021,Třinec,14,585,314,271
20619,8021,Třinec,15,548,299,249
20620,8021,Třinec,16,529,268,261
20621,8021,Třinec,17,493,236,257
20622,8021,Třinec,18,470,246,224
20623,8021,Třinec,19,507,249,258
20624,8021,Třinec,20,511,266,245
20625,8021,Třinec,21,534,287,247
20626,8021,Třinec,22,514,256,258
20627,8021,Třinec,23,538,288,250
20628,8021,Třinec,24,556,288,268
20629,8021,Třinec,25,574,323,251
20630,8021,Třinec,26,621,314,307
20631,8021,Třinec,27,663,339,324
20632,8021,Třinec,28,698,355,343
20633,8021,Třinec,29,707,361,346
20634,8021,Třinec,30,659,337,322
20635,8021,Třinec,31,711,381,330
20636,8021,Třinec,32,756,405,351
20637,8021,Třinec,33,699,342,357
20638,8021,Třinec,34,703,369,334
20639,8021,Třinec,35,727,390,337
20640,8021,Třinec,36,729,387,342
20641,8021,Třinec,37,676,343,333
20642,8021,Třinec,38,690,357,333
20643,8021,Třinec,39,690,364,326
20644,8021,Třinec,40,768,421,347
20645,8021,Třinec,41,807,419,388
20646,8021,Třinec,42,939,487,452
20647,8021,Třinec,43,866,442,424
20648,8021,Třinec,44,882,452,430
20649,8021,Třinec,45,903,469,434
20650,8021,Třinec,46,869,432,437
20651,8021,Třinec,47,894,465,429
20652,8021,Třinec,48,803,394,409
20653,8021,Třinec,49,728,358,370
20654,8021,Třinec,50,686,346,340
20655,8021,Třinec,51,772,399,373
20656,8021,Třinec,52,721,372,349
20657,8021,Třinec,53,708,359,349
20658,8021,Třinec,54,733,363,370
20659,8021,Třinec,55,775,394,381
20660,8021,Třinec,56,823,406,417
20661,8021,Třinec,57,763,378,385
20662,8021,Třinec,58,727,356,371
20663,8021,Třinec,59,737,382,355
20664,8021,Třinec,60,640,315,325
20665,8021,Třinec,61,609,308,301
20666,8021,Třinec,62,710,350,360
20667,8021,Třinec,63,686,334,352
20668,8021,Třinec,64,754,340,414
20669,8021,Třinec,65,719,364,355
20670,8021,Třinec,66,695,313,382
20671,8021,Třinec,67,711,318,393
20672,8021,Třinec,68,667,312,355
20673,8021,Třinec,69,737,319,418
20674,8021,Třinec,70,679,321,358
20675,8021,Třinec,71,594,250,344
20676,8021,Třinec,72,634,249,385
20677,8021,Třinec,73,588,246,342
20678,8021,Třinec,74,486,198,288
20679,8021,Třinec,75,377,143,234
20680,8021,Třinec,76,445,170,275
20681,8021,Třinec,77,429,163,266
20682,8021,Třinec,78,429,158,271
20683,8021,Třinec,79,426,146,280
20684,8021,Třinec,80,389,150,239
20685,8021,Třinec,81,318,114,204
20686,8021,Třinec,82,263,100,163
20687,8021,Třinec,83,241,91,150
20688,8021,Třinec,84,236,89,147
20689,8021,Třinec,85,201,72,129
20690,8021,Třinec,86,167,58,109
20691,8021,Třinec,87,136,45,91
20692,8021,Třinec,88,140,56,84
20693,8021,Třinec,89,115,36,79
20694,8021,Třinec,90,91,19,72
20695,8021,Třinec,91,60,24,36
20696,8021,Třinec,92,62,21,41
20697,8021,Třinec,93,51,6,45
20698,8021,Třinec,94,26,7,19
20699,8021,Třinec,95,30,8,22
20700,8021,Třinec,96,19,4,15
20701,8021,Třinec,97,12,2,10
20702,8021,Třinec,98,10,4,6
20703,8021,Třinec,99,6,0,6
20704,8021,Třinec,100,2,1,1
20705,8022,Vítkov,0,121,62,59
20706,8022,Vítkov,1,138,63,75
20707,8022,Vítkov,2,137,72,65
20708,8022,Vítkov,3,139,80,59
20709,8022,Vítkov,4,136,68,68
20710,8022,Vítkov,5,152,77,75
20711,8022,Vítkov,6,108,55,53
20712,8022,Vítkov,7,132,67,65
20713,8022,Vítkov,8,129,53,76
20714,8022,Vítkov,9,119,64,55
20715,8022,Vítkov,10,148,61,87
20716,8022,Vítkov,11,153,77,76
20717,8022,Vítkov,12,140,76,64
20718,8022,Vítkov,13,176,97,79
20719,8022,Vítkov,14,159,96,63
20720,8022,Vítkov,15,134,69,65
20721,8022,Vítkov,16,141,79,62
20722,8022,Vítkov,17,130,74,56
20723,8022,Vítkov,18,127,66,61
20724,8022,Vítkov,19,117,54,63
20725,8022,Vítkov,20,107,54,53
20726,8022,Vítkov,21,128,64,64
20727,8022,Vítkov,22,121,58,63
20728,8022,Vítkov,23,135,76,59
20729,8022,Vítkov,24,151,76,75
20730,8022,Vítkov,25,139,79,60
20731,8022,Vítkov,26,146,71,75
20732,8022,Vítkov,27,172,90,82
20733,8022,Vítkov,28,151,79,72
20734,8022,Vítkov,29,172,97,75
20735,8022,Vítkov,30,157,86,71
20736,8022,Vítkov,31,182,95,87
20737,8022,Vítkov,32,176,92,84
20738,8022,Vítkov,33,153,90,63
20739,8022,Vítkov,34,146,72,74
20740,8022,Vítkov,35,142,77,65
20741,8022,Vítkov,36,171,95,76
20742,8022,Vítkov,37,180,90,90
20743,8022,Vítkov,38,160,74,86
20744,8022,Vítkov,39,169,87,82
20745,8022,Vítkov,40,194,110,84
20746,8022,Vítkov,41,198,107,91
20747,8022,Vítkov,42,221,120,101
20748,8022,Vítkov,43,203,114,89
20749,8022,Vítkov,44,206,118,88
20750,8022,Vítkov,45,211,106,105
20751,8022,Vítkov,46,245,123,122
20752,8022,Vítkov,47,199,106,93
20753,8022,Vítkov,48,172,105,67
20754,8022,Vítkov,49,172,87,85
20755,8022,Vítkov,50,171,87,84
20756,8022,Vítkov,51,183,95,88
20757,8022,Vítkov,52,136,78,58
20758,8022,Vítkov,53,170,86,84
20759,8022,Vítkov,54,164,79,85
20760,8022,Vítkov,55,178,99,79
20761,8022,Vítkov,56,185,96,89
20762,8022,Vítkov,57,172,85,87
20763,8022,Vítkov,58,172,81,91
20764,8022,Vítkov,59,159,80,79
20765,8022,Vítkov,60,192,90,102
20766,8022,Vítkov,61,147,77,70
20767,8022,Vítkov,62,189,93,96
20768,8022,Vítkov,63,184,97,87
20769,8022,Vítkov,64,214,111,103
20770,8022,Vítkov,65,196,95,101
20771,8022,Vítkov,66,211,89,122
20772,8022,Vítkov,67,198,98,100
20773,8022,Vítkov,68,206,85,121
20774,8022,Vítkov,69,182,98,84
20775,8022,Vítkov,70,170,91,79
20776,8022,Vítkov,71,149,62,87
20777,8022,Vítkov,72,148,61,87
20778,8022,Vítkov,73,169,64,105
20779,8022,Vítkov,74,126,59,67
20780,8022,Vítkov,75,91,35,56
20781,8022,Vítkov,76,100,44,56
20782,8022,Vítkov,77,134,49,85
20783,8022,Vítkov,78,102,39,63
20784,8022,Vítkov,79,96,37,59
20785,8022,Vítkov,80,85,32,53
20786,8022,Vítkov,81,61,21,40
20787,8022,Vítkov,82,52,18,34
20788,8022,Vítkov,83,50,19,31
20789,8022,Vítkov,84,50,21,29
20790,8022,Vítkov,85,45,13,32
20791,8022,Vítkov,86,34,11,23
20792,8022,Vítkov,87,41,12,29
20793,8022,Vítkov,88,27,11,16
20794,8022,Vítkov,89,21,1,20
20795,8022,Vítkov,90,13,3,10
20796,8022,Vítkov,91,18,4,14
20797,8022,Vítkov,92,10,5,5
20798,8022,Vítkov,93,5,0,5
20799,8022,Vítkov,94,6,2,4
20800,8022,Vítkov,95,6,0,6
20801,8022,Vítkov,96,1,0,1
20802,8022,Vítkov,97,1,1,0
20803,8022,Vítkov,98,1,1,0
20804,8022,Vítkov,99,0,0,0
20805,8022,Vítkov,100,1,0,1
